Sequence,Frequency Very Active,Frequency Mod. Active,Frequency Inactive - Exp,Frequency Inactive - Virtual,Frequency Total,Sequence Length
AAWK,0,1,1,0,2,4
AWKW,0,3,0,0,3,4
WKWA,0,3,0,0,3,4
KWAW,0,1,0,0,1,4
WAWA,0,1,0,0,1,4
AWAK,0,1,0,0,1,4
WAKK,0,3,0,0,3,4
AKKW,0,4,3,0,7,4
KKWA,0,4,3,0,7,4
KWAK,0,6,3,2,11,4
WAKA,0,5,3,1,9,4
AKAK,0,3,1,1,5,4
KAKK,0,2,1,0,3,4
AKAA,0,6,3,0,9,4
AIGK,0,1,0,1,2,4
IGKF,0,5,0,0,5,4
GKFL,0,5,0,0,5,4
KFLH,4,12,5,0,21,4
FLHS,0,4,1,0,5,4
LHSA,0,4,1,0,5,4
HSAK,0,4,1,0,5,4
SAKK,0,6,3,0,9,4
AKKF,2,15,10,1,28,4
KKFG,0,2,0,0,2,4
KFGK,0,2,0,0,2,4
FGKA,0,2,0,0,2,4
GKAF,0,2,0,0,2,4
KAFV,0,4,0,0,4,4
AFVG,0,1,0,0,1,4
FVGE,0,1,0,0,1,4
VGEI,0,1,0,0,1,4
GEIM,0,1,0,0,1,4
EIMN,0,3,0,0,3,4
IMNS,0,3,0,0,3,4
AWKK,0,1,5,0,6,4
WKKW,0,1,0,0,1,4
AKAW,0,1,3,0,4,4
KAWK,0,4,6,0,10,4
KAKW,0,1,0,0,1,4
AKWW,0,1,1,0,2,4
KWWA,0,1,0,0,1,4
WWAK,0,1,0,0,1,4
ESFS,0,1,0,0,1,4
SFSD,0,1,0,0,1,4
FSDW,0,3,0,0,3,4
SDWW,0,3,0,0,3,4
DWWK,0,4,0,0,4,4
WWKL,0,4,0,0,4,4
WKLL,0,4,0,0,4,4
KLLA,0,18,13,0,31,4
LLAE,0,4,0,1,5,4
ETFA,0,1,0,0,1,4
TFAD,0,1,0,0,1,4
FADW,0,1,0,0,1,4
ADWW,0,1,0,0,1,4
ETFS,0,1,0,0,1,4
TFSD,0,2,0,0,2,4
FAKA,0,3,1,0,4,4
AKAL,0,11,5,1,17,4
KALA,0,3,2,1,6,4
ALAK,0,3,3,2,8,4
LAKL,4,16,23,1,44,4
AKLA,4,16,23,3,46,4
KLAK,8,41,42,0,91,4
LAKK,6,38,29,1,74,4
AKKL,5,33,29,2,69,4
KKLL,0,9,4,2,15,4
KALK,3,19,19,4,45,4
ALKA,2,10,13,0,25,4
LKAL,1,9,13,1,24,4
KALL,0,0,2,0,2,4
ALLK,0,0,5,2,7,4
LLKA,0,2,3,0,5,4
FAKF,0,2,1,0,3,4
AKFL,0,3,3,1,7,4
KFLA,0,1,1,0,2,4
FLAK,0,1,1,0,2,4
LAKF,0,1,2,0,3,4
KFLK,0,2,2,1,5,4
FLKK,0,2,2,1,5,4
LKKA,2,13,11,1,27,4
KKAL,4,17,18,0,39,4
FAKI,0,0,1,0,1,4
AKII,0,0,1,0,1,4
KIIA,0,0,1,1,2,4
IIAK,0,0,1,0,1,4
IAKI,0,0,2,0,2,4
AKIA,0,0,2,1,3,4
KIAK,0,0,3,1,4,4
IAKK,0,1,1,0,2,4
AKKI,0,0,2,0,2,4
KKIL,1,0,2,3,6,4
FAKK,2,12,15,1,30,4
AKKA,1,13,10,0,24,4
ALKK,3,18,14,2,37,4
LKKL,4,20,12,4,40,4
KKFA,0,7,6,0,13,4
KFAK,0,6,4,1,11,4
KKFK,0,1,1,0,2,4
KFKK,0,2,1,1,4,4
FKKF,0,2,2,0,4,4
AKFA,0,1,1,0,2,4
KFAF,0,1,1,0,2,4
FAFA,0,1,1,0,2,4
AFAF,0,1,1,0,2,4
KKLA,7,28,22,0,57,4
LAKA,0,7,6,1,14,4
KAAL,0,1,1,0,2,4
KLAL,2,3,7,0,12,4
AKLL,0,13,15,1,29,4
KKLK,2,12,5,1,20,4
KLKK,2,13,6,1,22,4
KKWK,0,1,0,0,1,4
KWKL,3,8,10,0,21,4
LALA,1,3,3,4,11,4
ALAL,2,9,13,4,28,4
LALK,1,8,12,0,21,4
KKLI,1,1,0,2,4,4
KLIG,0,1,0,1,2,4
LIGA,0,1,0,0,1,4
IGAV,1,2,1,0,4,4
GAVL,1,2,1,0,4,4
AVLK,1,2,1,0,4,4
VLKV,1,2,1,0,4,4
LLAL,0,2,1,1,4,4
ALKL,0,1,7,1,9,4
LKLA,0,0,5,1,6,4
LLAK,0,11,12,0,23,4
FAKL,0,11,17,0,28,4
AKLF,1,0,1,0,2,4
KLFA,0,0,1,0,1,4
LFAK,0,0,1,0,1,4
KFAL,0,1,2,0,3,4
AKAF,0,2,1,1,4,4
KAFK,2,0,1,2,5,4
AFKK,0,0,1,0,1,4
FKKA,1,0,1,0,2,4
LKKF,2,2,1,0,5,4
KKFL,0,1,0,2,3,4
LKLK,0,1,2,0,3,4
KLKL,0,1,2,1,4,4
KAKL,0,1,1,0,2,4
AKKG,0,0,1,0,1,4
KKGL,0,0,1,0,1,4
AKKS,0,0,1,0,1,4
KKSL,0,0,1,2,3,4
AKKV,0,2,1,1,4,4
KKVL,0,1,1,1,3,4
AKLK,0,1,1,1,3,4
KLLF,0,0,1,0,1,4
LLFK,0,0,1,0,1,4
LFKA,1,0,1,0,2,4
FKAL,1,0,1,1,3,4
KLLK,1,2,3,4,10,4
LLKL,0,1,5,0,6,4
KLAA,1,1,1,0,3,4
LAAK,1,2,1,1,5,4
AAKK,0,7,7,0,14,4
AKLW,0,1,1,0,2,4
KLWA,0,1,1,0,2,4
LWAK,0,1,1,0,2,4
WAKL,0,1,1,0,2,4
KLAF,0,1,1,0,2,4
LAFG,0,1,0,0,1,4
AFGK,0,1,0,0,1,4
FGKG,0,1,0,0,1,4
GKGI,0,1,0,0,1,4
KGIG,0,1,0,0,1,4
GIGK,0,5,0,0,5,4
IGKV,0,1,0,1,2,4
GKVG,0,1,0,0,1,4
KVGK,0,1,0,0,1,4
VGKK,0,1,0,0,1,4
GKKL,0,1,0,0,1,4
FALA,1,6,8,0,15,4
ALAA,0,1,0,2,3,4
AAKA,0,5,3,2,10,4
KKAK,0,2,1,0,3,4
KAKA,0,1,0,1,2,4
LLKK,3,2,1,3,9,4
FALK,0,1,1,0,2,4
FALL,0,0,3,0,3,4
FAVG,0,0,1,0,1,4
AVGL,0,0,1,0,1,4
VGLR,0,0,1,0,1,4
GLRA,0,0,1,0,1,4
LRAI,0,0,1,0,1,4
RAIK,0,0,1,0,1,4
AIKR,0,0,1,0,1,4
IKRA,0,0,1,0,1,4
KRAL,0,0,1,1,2,4
RALK,0,0,1,0,1,4
KKLR,0,0,1,0,1,4
KLRR,0,0,1,0,1,4
LRRG,0,0,1,0,1,4
RRGV,0,0,1,0,1,4
RGVR,0,0,1,0,1,4
GVRK,0,0,1,0,1,4
VRKV,0,0,1,1,2,4
RKVA,0,0,1,0,1,4
KVAK,0,2,1,0,3,4
VAKD,0,0,1,0,1,4
AKDL,0,0,1,0,1,4
FKLA,0,0,2,0,2,4
LAFK,0,0,1,0,1,4
AFKL,0,0,1,0,1,4
KKAF,0,0,1,0,1,4
KAFL,0,0,1,1,2,4
FKLF,0,1,0,0,1,4
KLFK,3,9,10,0,22,4
LFKK,3,9,10,0,22,4
FKKI,3,13,9,0,25,4
KKIP,2,9,8,0,19,4
KIPK,2,8,4,0,14,4
IPKF,2,8,4,0,14,4
PKFL,2,8,4,0,14,4
FLHL,4,8,3,0,15,4
LHLA,2,8,3,0,13,4
HLAK,2,7,4,2,15,4
FKRL,0,0,1,1,2,4
KRLA,0,0,1,0,1,4
RLAK,0,0,2,2,4,4
LAKI,0,0,2,0,2,4
AKIK,0,0,2,0,2,4
KIKV,0,0,1,0,1,4
IKVL,0,0,1,1,2,4
KVLR,0,0,1,1,2,4
VLRL,0,0,1,4,5,4
LRLA,0,0,1,1,2,4
KIKR,0,0,1,0,1,4
FKVK,0,0,3,0,3,4
KVKF,0,0,2,0,2,4
VKFK,0,0,2,0,2,4
KFKV,0,0,1,0,1,4
KVKV,0,0,1,0,1,4
VKVK,0,0,1,0,1,4
FLGA,1,0,0,0,1,4
LGAL,1,0,0,0,1,4
GALF,1,0,0,0,1,4
ALFK,1,0,0,1,2,4
KALS,1,0,0,0,1,4
ALSK,1,0,0,0,1,4
LSKL,1,0,0,1,2,4
SKLL,1,0,0,0,1,4
FLGM,1,1,0,0,2,4
LGMI,1,1,0,0,2,4
GMIP,1,1,0,0,2,4
MIPG,0,1,0,0,1,4
IPGL,0,1,0,0,1,4
PGLI,0,1,0,0,1,4
GLIG,0,1,0,0,1,4
LIGG,0,1,0,0,1,4
IGGL,1,5,0,0,6,4
GGLI,0,1,0,0,1,4
GLIS,0,1,0,0,1,4
LISA,0,1,0,1,2,4
ISAF,0,1,0,0,1,4
SAFK,0,1,0,0,1,4
MIPK,1,0,0,0,1,4
IPKL,2,0,0,1,3,4
PKLI,1,0,0,0,1,4
KLIK,2,0,0,2,4,4
LIKK,1,0,0,1,2,4
IKKL,1,6,0,2,9,4
LIKA,1,0,0,0,1,4
IKAF,2,0,0,1,3,4
FLKL,1,2,0,2,5,4
LKLL,1,2,2,0,5,4
LLAG,0,1,0,0,1,4
LAGL,0,1,0,0,1,4
AGLL,0,1,0,1,2,4
GLLK,0,1,0,2,3,4
LLKN,0,1,0,1,2,4
LKNF,0,1,0,1,2,4
KNFA,0,1,0,0,1,4
AAKF,0,1,0,0,1,4
KFLP,0,1,0,0,1,4
FLPT,0,1,0,0,1,4
LPTI,0,1,0,0,1,4
PTII,0,1,0,0,1,4
TIIC,0,1,0,0,1,4
IICK,0,1,0,0,1,4
ICKI,0,1,0,0,1,4
CKIS,0,1,0,0,1,4
KISY,0,1,0,0,1,4
ISYK,0,1,0,0,1,4
SYKC,0,1,0,0,1,4
AAKL,1,0,1,1,3,4
FLSL,1,0,0,0,1,4
LSLI,1,0,0,1,2,4
SLIP,1,0,0,0,1,4
LIPK,1,0,0,0,1,4
PKLV,1,0,0,0,1,4
KLVK,1,0,0,2,3,4
LVKK,1,0,0,1,2,4
VKKI,1,2,1,1,5,4
KKII,1,0,0,0,1,4
KIIK,1,0,0,2,3,4
IIKA,1,0,0,1,2,4
GIGA,1,0,1,0,2,4
LKVL,1,1,1,3,6,4
KVLT,1,0,1,0,2,4
VLTT,1,0,1,0,2,4
LTTG,1,0,1,0,2,4
TTGL,1,0,1,0,2,4
TGLP,1,0,0,0,1,4
GLPA,1,0,0,0,1,4
LPAL,1,0,0,1,2,4
PALI,1,0,0,1,2,4
ALIS,1,0,0,0,1,4
LISW,1,0,0,0,1,4
ISWI,1,0,0,0,1,4
SWIK,1,0,0,0,1,4
WIKR,1,0,0,1,2,4
IKRK,1,0,0,0,1,4
KRKR,1,0,0,1,2,4
RKRQ,1,0,0,0,1,4
KRQQ,1,0,0,1,2,4
FLHA,0,1,0,0,1,4
LHAA,0,1,0,0,1,4
HAAK,0,1,0,0,1,4
AFVA,0,2,0,0,2,4
FVAE,0,2,0,0,2,4
VAEI,0,2,0,1,3,4
AEIM,0,2,0,0,2,4
AFVK,0,1,0,0,1,4
FVKI,0,1,0,0,1,4
VKIL,0,1,0,0,1,4
KILK,1,1,0,1,3,4
ILKK,0,1,0,2,3,4
GLFA,1,5,0,0,6,4
LFAV,1,5,0,0,6,4
FAVI,1,5,0,0,6,4
AVIK,1,6,0,0,7,4
VIKK,1,17,0,3,21,4
IKKV,1,11,0,1,13,4
KKVA,1,11,0,2,14,4
KVAA,0,3,0,0,3,4
VAAV,0,3,0,2,5,4
AAVI,0,3,0,1,4,4
AVIR,0,1,0,0,1,4
VIRR,0,1,0,0,1,4
IRRL,0,1,0,0,1,4
VAKV,0,2,0,0,2,4
AKVI,0,2,0,0,2,4
KVIK,0,4,0,1,5,4
KVAS,1,7,0,0,8,4
VASV,1,8,0,0,9,4
ASVI,1,8,0,0,9,4
SVIG,1,3,0,0,4,4
VIGG,1,4,0,0,5,4
SVIK,0,5,0,0,5,4
VIKG,0,2,0,0,2,4
IKGL,0,2,0,0,2,4
GLFD,0,11,1,2,14,4
LFDI,0,5,1,0,6,4
FDIA,0,1,0,0,1,4
DIAK,0,1,0,1,2,4
KKVI,0,1,0,1,2,4
KVIG,0,1,0,0,1,4
VIGV,0,1,0,0,1,4
IGVI,0,1,0,0,1,4
GVIG,0,1,0,0,1,4
VIGS,0,1,0,1,2,4
IGSL,0,1,0,0,1,4
FDII,0,1,0,0,1,4
DIIK,0,1,0,0,1,4
IIKK,0,1,0,2,3,4
IKKI,0,1,0,1,2,4
KKIA,0,3,1,1,5,4
KIAE,0,1,0,0,1,4
IAES,0,1,0,1,2,4
AESF,0,1,0,1,2,4
FDIV,0,3,1,0,4,4
DIVK,0,3,1,2,6,4
IVKK,0,3,1,0,4,4
KIAG,0,2,1,0,3,4
IAGH,0,2,1,0,3,4
AGHI,0,2,1,0,3,4
GHIA,0,1,1,0,2,4
HIAG,0,0,1,0,1,4
IAGS,0,0,1,0,1,4
AGSI,0,0,1,0,1,4
HIAS,0,1,0,0,1,4
IASS,0,1,0,0,1,4
ASSI,0,1,0,0,1,4
GHIV,0,1,0,0,1,4
HIVS,0,1,0,0,1,4
IVSS,0,1,0,0,1,4
VSSI,0,1,0,1,2,4
VKKV,0,1,0,1,2,4
KKVV,0,1,1,1,3,4
KVVG,0,1,0,0,1,4
VVGA,0,1,0,0,1,4
VGAF,0,1,0,0,1,4
GAFG,0,1,0,0,1,4
AFGS,0,1,0,0,1,4
FGSL,0,1,0,1,2,4
LFDV,0,6,0,1,7,4
FDVI,0,6,0,1,7,4
DVIA,0,1,0,1,2,4
VIAK,0,1,0,1,2,4
IAKV,0,1,1,0,2,4
AKVA,0,1,1,0,2,4
DVIK,0,5,0,0,5,4
VIKA,0,1,0,0,1,4
IKAV,0,1,0,0,1,4
KAVA,0,1,0,1,2,4
AVAS,0,1,0,2,3,4
AVIG,0,1,0,0,1,4
GLFK,0,2,0,1,3,4
LFKV,0,2,0,0,2,4
FKVI,0,2,0,1,3,4
GLWS,0,1,0,0,1,4
LWSK,0,1,0,0,1,4
WSKI,0,1,0,0,1,4
SKIK,0,1,0,0,1,4
KIKE,0,1,0,2,3,4
IKEV,0,1,0,0,1,4
KEVG,0,1,0,0,1,4
EVGK,0,1,0,1,2,4
VGKE,0,1,0,0,1,4
GKEA,0,1,0,1,2,4
KEAA,0,1,0,0,1,4
EAAK,0,1,0,1,2,4
KAAA,0,1,0,0,1,4
AAAK,0,1,0,0,1,4
KAAG,0,1,0,2,3,4
AAGK,0,1,0,0,1,4
AGKA,0,1,0,1,2,4
GKAA,0,1,0,0,1,4
AALG,0,1,0,1,2,4
ALGA,0,1,0,0,1,4
LGAV,0,1,0,1,2,4
GAVS,0,1,0,0,1,4
AVSE,0,1,0,1,2,4
VSEA,0,1,0,0,1,4
SEAV,0,1,0,0,1,4
ILPW,0,1,0,0,1,4
LPWK,0,1,0,0,1,4
PWKW,0,1,0,0,1,4
WKWP,0,1,0,0,1,4
KWPW,0,1,0,0,1,4
WPWW,0,1,0,0,1,4
PWWP,0,1,0,0,1,4
WWPW,0,1,0,0,1,4
WPWR,0,1,0,0,1,4
PWRR,0,1,0,0,1,4
KAAK,0,9,10,0,19,4
KKAW,0,3,2,0,5,4
AWKA,0,2,2,0,4,4
WKAA,0,2,1,0,3,4
KKAA,0,5,7,0,12,4
AAKW,0,1,1,0,2,4
KWWK,0,1,1,0,2,4
WWKK,0,1,1,0,2,4
WKKA,0,1,6,0,7,4
WKAW,0,0,1,0,1,4
KAAW,0,0,1,0,1,4
AKWA,0,1,0,0,1,4
KVAL,0,0,1,0,1,4
VALA,0,1,3,2,6,4
AKLG,0,0,1,0,1,4
KLGI,0,0,1,0,1,4
LGIG,0,0,1,1,2,4
KKKF,4,1,0,0,5,4
KKFP,4,1,0,0,5,4
KFPW,4,1,0,0,5,4
FPWW,4,1,1,0,6,4
PWWW,4,1,1,0,6,4
WWWP,4,1,1,0,6,4
WWPF,4,1,1,0,6,4
WPFK,4,1,0,0,5,4
PFKK,4,1,0,0,5,4
FKKK,4,1,1,0,6,4
KKKC,2,0,0,0,2,4
KKCK,1,0,0,0,1,4
KCKK,1,0,0,0,1,4
CKKK,1,0,0,0,1,4
KKKK,4,0,0,0,4,4
KVVF,0,0,1,0,1,4
VVFK,0,0,1,0,1,4
VFKV,0,0,1,0,1,4
LKAA,0,0,1,2,3,4
KLLL,0,0,1,1,2,4
LLLK,0,0,1,1,2,4
LKLY,0,0,1,1,2,4
KLYK,0,0,1,0,1,4
LYKK,0,0,1,0,1,4
YKKL,0,0,1,0,1,4
KLlL,0,2,0,0,2,4
LlLK,0,2,0,0,2,4
lLKl,0,2,0,0,2,4
LKlL,0,4,0,0,4,4
KlLk,0,2,0,0,2,4
lLkk,0,2,0,0,2,4
LkkL,0,2,0,0,2,4
kkLL,0,2,0,0,2,4
kLLK,0,2,0,0,2,4
LLKl,0,2,0,0,2,4
KlLK,0,2,0,0,2,4
lLKK,0,2,0,0,2,4
LKKK,0,2,0,2,4,4
KQLI,0,1,0,0,1,4
QLIR,0,1,0,1,2,4
LIRF,0,1,0,0,1,4
IRFL,0,1,0,1,2,4
RFLK,0,1,0,1,2,4
FLKR,0,1,0,1,2,4
LKRL,0,1,0,1,2,4
KRLD,0,1,0,1,2,4
RLDR,0,1,0,1,2,4
LDRN,0,1,0,0,1,4
DRNG,0,1,0,0,1,4
RNGG,0,1,0,0,1,4
NGGG,0,1,0,0,1,4
GGGK,0,1,0,0,1,4
GGKL,0,1,0,0,1,4
GKLl,0,1,0,0,1,4
KTKL,0,1,1,0,2,4
TKLF,0,1,1,0,2,4
KWFK,0,1,0,1,2,4
WFKK,1,2,0,0,3,4
KWKF,0,1,0,0,1,4
WKFK,0,1,0,0,1,4
WKLA,0,1,0,0,1,4
LALL,0,1,0,2,3,4
WKLF,3,7,10,0,20,4
KKIG,0,2,0,0,2,4
KIGA,0,1,0,0,1,4
KIGI,0,1,0,0,1,4
IGIG,0,1,0,0,1,4
KKIK,0,0,1,0,1,4
KIKF,0,0,1,0,1,4
IKFL,0,0,1,0,1,4
ILKF,1,0,0,0,1,4
LKFL,1,0,0,0,1,4
KIPF,0,1,0,0,1,4
IPFL,0,1,0,0,1,4
PFLH,0,1,0,0,1,4
KIPH,0,0,1,0,1,4
IPHL,0,0,1,1,2,4
PHLA,0,0,1,1,2,4
KIPL,0,0,3,0,3,4
IPLA,0,0,1,0,1,4
PLAK,0,0,1,0,1,4
IPLH,0,0,1,0,1,4
PLHL,0,0,1,0,1,4
IPLK,0,0,1,0,1,4
PLKK,0,0,1,0,1,4
KKIS,1,0,0,0,1,4
KISK,1,0,0,0,1,4
ISKF,1,0,0,0,1,4
SKFL,1,0,0,0,1,4
KKKT,0,0,1,0,1,4
KKTK,0,0,1,0,1,4
KWKS,1,4,2,0,7,4
WKSF,1,4,2,0,7,4
KSFA,0,0,1,0,1,4
SFAK,0,0,1,0,1,4
FAKT,0,0,1,0,1,4
AKTF,0,0,1,0,1,4
KTFK,1,4,2,0,7,4
TFKS,1,4,2,0,7,4
FKSA,0,2,2,0,4,4
KSAK,0,2,2,0,4,4
AKKT,0,2,2,0,4,4
KKTV,1,4,2,0,7,4
KTVL,1,4,1,0,6,4
TVLH,1,4,1,0,6,4
VLHT,1,4,1,0,6,4
LHTA,1,1,1,0,3,4
HTAL,1,1,1,0,3,4
TALK,1,1,1,0,3,4
LKAI,1,3,1,0,5,4
KAIS,1,3,2,0,6,4
AISS,1,3,2,1,7,4
KSFL,1,4,1,1,7,4
SFLK,1,4,1,0,6,4
FLKT,1,4,1,1,7,4
LKTF,1,4,1,0,6,4
KTVA,0,0,1,1,2,4
TVAH,0,0,1,0,1,4
VAHT,0,0,1,0,1,4
AHTA,0,0,1,0,1,4
HTAA,0,0,1,0,1,4
TAAK,0,0,1,1,2,4
AKAI,0,0,1,0,1,4
LHTL,0,3,0,0,3,4
HTLL,0,3,0,0,3,4
TLLK,0,3,0,0,3,4
FKSL,1,2,0,0,3,4
KSLK,1,2,0,0,3,4
SLKK,1,2,0,1,4,4
LKKT,1,2,0,0,3,4
LKLI,0,1,0,1,2,4
KLIS,0,1,0,0,1,4
LISS,0,1,0,0,1,4
KWKV,0,2,1,0,3,4
WKVF,0,2,1,0,3,4
KVFK,0,2,1,0,3,4
VFKK,0,2,1,0,3,4
KKIE,0,2,1,0,3,4
KIEK,0,2,1,0,3,4
IEKM,0,1,0,0,1,4
EKMG,0,1,0,1,2,4
KMGR,0,1,0,0,1,4
MGRN,0,1,0,0,1,4
GRNI,0,2,1,0,3,4
RNIR,0,2,1,0,3,4
NIRN,0,2,1,0,3,4
IRNG,0,2,1,0,3,4
RNGI,0,2,1,0,3,4
NGIV,0,2,1,0,3,4
GIVK,0,2,1,0,3,4
IVKA,0,2,1,2,5,4
VKAG,0,2,1,2,5,4
KAGP,0,2,1,0,3,4
AGPA,0,2,2,0,4,4
GPAI,0,2,2,0,4,4
PAIA,0,2,2,0,4,4
AIAV,0,2,1,1,4,4
IAVL,0,2,1,0,3,4
AVLG,0,2,1,0,3,4
VLGE,0,2,1,1,4,4
LGEA,0,2,1,2,5,4
GEAK,0,2,1,0,3,4
EAKA,0,2,1,0,3,4
KWLR,0,0,1,0,1,4
WLRR,0,0,1,0,1,4
LRRV,0,0,1,2,3,4
RRVW,0,0,1,0,1,4
RVWR,0,0,1,2,3,4
VWRW,0,0,1,2,3,4
WRWW,0,0,1,0,1,4
RWWR,0,0,1,0,1,4
KYKK,0,0,1,0,1,4
YKKA,0,0,1,0,1,4
ALAF,0,0,1,0,1,4
LLGD,0,1,0,0,1,4
LGDF,0,1,0,1,2,4
GDFF,0,1,0,0,1,4
DFFR,0,1,0,0,1,4
FFRK,0,1,0,0,1,4
FRKS,0,1,0,0,1,4
RKSK,0,1,0,0,1,4
KSKE,0,1,0,0,1,4
SKEK,0,1,0,1,2,4
KEKI,0,1,0,0,1,4
EKIG,0,1,0,0,1,4
KIGK,0,1,0,0,1,4
IGKE,0,1,0,0,1,4
GKEF,0,1,0,0,1,4
KEFK,0,1,0,0,1,4
EFKR,0,1,0,0,1,4
FKRI,0,1,0,0,1,4
KRIV,0,1,0,0,1,4
RIVQ,0,1,0,0,1,4
IVQR,0,1,0,0,1,4
VQRI,0,1,0,0,1,4
QRIK,0,1,0,0,1,4
RIKD,0,1,0,0,1,4
IKDF,0,1,0,0,1,4
KDFL,0,1,0,1,2,4
DFLR,0,1,0,1,2,4
FLRN,0,1,0,1,2,4
LRNL,0,1,0,2,3,4
RNLV,0,1,0,0,1,4
NLVP,0,1,0,0,1,4
LVPR,0,1,0,0,1,4
VPRT,0,1,0,0,1,4
PRTE,0,1,0,0,1,4
RTES,0,1,0,0,1,4
LPKW,0,1,0,1,2,4
PKWK,0,1,1,0,2,4
IEKV,0,1,1,0,2,4
EKVG,0,1,1,0,2,4
KVGR,0,1,1,0,2,4
VGRN,0,1,1,0,2,4
KALG,0,1,1,1,3,4
LTFS,0,1,0,0,1,4
MPKW,0,0,1,0,1,4
MPRW,0,0,1,0,1,4
PRWR,0,0,1,1,2,4
RWRL,0,0,1,0,1,4
WRLF,0,0,1,0,1,4
RLFR,0,0,1,2,3,4
LFRR,0,0,1,1,2,4
FRRI,0,0,1,0,1,4
RRID,0,0,1,0,1,4
RIDR,0,0,1,0,1,4
IDRV,0,0,1,0,1,4
DRVG,0,0,1,0,1,4
RVGK,0,0,1,0,1,4
VGKQ,0,0,1,0,1,4
GKQI,0,0,1,0,1,4
KQIK,0,0,1,0,1,4
QIKQ,0,0,1,1,2,4
IKQG,0,0,1,0,1,4
KQGI,0,0,1,0,1,4
QGIL,0,0,1,0,1,4
GILR,0,0,1,1,2,4
ILRA,0,0,1,0,1,4
LRAG,0,0,1,0,1,4
RAGP,0,0,1,0,1,4
AIAL,0,0,1,0,1,4
IALV,0,0,1,0,1,4
ALVG,0,0,1,1,2,4
LVGD,0,0,1,0,1,4
VGDA,0,0,1,0,1,4
GDAR,0,0,1,0,1,4
DARA,0,0,1,1,2,4
ARAV,0,0,1,1,2,4
RAVG,0,0,1,1,2,4
MRKW,0,1,0,0,1,4
RKWF,0,1,0,0,1,4
KWFH,0,2,1,0,3,4
WFHN,0,2,1,0,3,4
FHNV,0,3,1,0,4,4
HNVL,0,3,1,1,5,4
NVLS,0,3,1,0,4,4
VLSS,0,2,1,0,3,4
LSSG,0,2,0,0,2,4
SSGQ,0,2,0,0,2,4
SGQL,0,2,0,0,2,4
GQLL,0,2,0,0,2,4
QLLA,0,2,1,0,3,4
LLAD,0,3,1,1,5,4
LADK,0,3,1,0,4,4
ADKW,0,1,0,0,1,4
DKWP,0,1,0,0,1,4
KWPA,0,1,0,0,1,4
WPAW,0,1,0,0,1,4
PAWD,0,1,0,0,1,4
AWDY,0,1,0,0,1,4
WDYN,0,1,0,0,1,4
DYNR,0,2,1,0,3,4
YNRK,0,2,1,0,3,4
MWKE,0,1,0,0,1,4
WKEF,0,1,0,1,2,4
KEFH,0,1,0,0,1,4
EFHN,0,1,0,0,1,4
ADKR,0,2,1,0,3,4
DKRW,0,1,0,0,1,4
KRWA,0,1,0,0,1,4
RWAR,0,1,0,0,1,4
WARW,0,1,0,0,1,4
ARWY,0,1,0,0,1,4
RWYN,0,1,0,0,1,4
WYNR,0,1,0,0,1,4
YNRW,0,1,0,0,1,4
MWKW,0,1,1,0,2,4
WKWF,0,1,1,0,2,4
LSSW,0,0,1,0,1,4
SSWQ,0,0,1,0,1,4
SWQL,0,0,1,0,1,4
WQLL,0,0,1,0,1,4
DKRP,0,1,1,0,2,4
KRPA,0,1,1,0,2,4
RPAR,0,1,1,0,2,4
PARD,0,1,1,0,2,4
ARDY,0,1,1,0,2,4
RDYN,0,1,1,1,3,4
VLSW,0,1,0,0,1,4
LSWW,0,1,0,0,1,4
SWWW,0,1,0,0,1,4
WWWL,0,1,0,0,1,4
WWLL,0,1,0,1,2,4
WLLA,0,1,0,1,2,4
RAGL,1,0,0,0,1,4
AGLQ,1,0,0,0,1,4
GLQF,1,0,0,0,1,4
LQFP,1,0,0,0,1,4
QFPV,1,0,0,0,1,4
FPVG,1,0,0,0,1,4
PVGR,1,0,0,0,1,4
VGRL,1,0,0,0,1,4
GRLL,1,0,0,0,1,4
RLLR,3,0,0,0,3,4
LLRR,2,0,0,0,2,4
LRRL,2,0,0,0,2,4
RRLL,2,0,0,1,3,4
RRRR,0,4,0,1,5,4
RRRN,0,1,0,0,1,4
RRNW,0,1,0,0,1,4
RNWM,0,1,0,0,1,4
NWMW,0,1,0,0,1,4
WMWC,0,1,0,0,1,4
RRRW,0,1,0,0,1,4
RRWC,0,1,0,0,1,4
RWCM,0,1,0,0,1,4
WCMN,0,1,0,0,1,4
CMNW,0,1,0,0,1,4
VAKF,0,0,1,0,1,4
VAKK,0,1,3,0,4,4
VAKL,0,2,1,2,5,4
VRRF,0,0,1,0,1,4
RRFP,0,0,1,1,2,4
RFPW,0,0,1,0,1,4
WPFL,0,0,1,0,1,4
PFLR,0,0,1,0,1,4
FLRR,0,0,1,0,1,4
WALA,0,0,1,1,2,4
LHLL,2,0,0,0,2,4
HLLK,2,0,0,0,2,4
WKKI,1,0,1,0,2,4
AADI,0,0,0,1,1,4
ADIF,0,0,0,1,1,4
DIFS,0,0,0,1,1,4
IFSK,0,0,0,1,1,4
FSKF,0,0,0,1,1,4
SKFK,0,0,0,1,1,4
FKKD,0,0,0,1,1,4
KKDM,0,0,0,1,1,4
KDME,0,0,0,1,1,4
DMEV,0,0,0,1,1,4
MEVK,0,0,0,1,1,4
EVKF,0,0,0,1,1,4
VKFA,0,0,0,1,1,4
AAQK,0,0,0,1,1,4
AQKD,0,0,0,1,1,4
QKDN,0,0,0,1,1,4
KDNV,0,0,0,1,1,4
DNVK,0,0,0,1,1,4
NVKS,0,0,0,1,1,4
VKSS,0,0,0,1,1,4
KSSW,0,0,0,1,1,4
SSWA,0,0,0,1,1,4
SWAK,0,0,0,1,1,4
AKAS,0,0,0,3,3,4
KASA,0,0,0,1,1,4
AASQ,0,0,0,1,1,4
ASQR,0,0,0,1,1,4
SQRK,0,0,0,1,1,4
QRKL,0,0,0,1,1,4
RKLI,0,0,0,1,1,4
KLIA,0,0,0,1,1,4
LIAE,0,0,0,1,1,4
IAEK,0,0,0,2,2,4
AEKF,0,0,0,1,1,4
EKFA,0,0,0,1,1,4
KFAQ,0,0,0,1,1,4
FAQA,0,0,0,1,1,4
AQAL,0,0,0,2,2,4
QALM,0,0,0,1,1,4
ALMS,0,0,0,1,1,4
LMSS,0,0,0,1,1,4
MSSL,0,0,0,1,1,4
AAYA,0,0,0,2,2,4
AYAT,0,0,0,1,1,4
YATL,0,0,0,1,1,4
ATLY,0,0,0,1,1,4
TLYE,0,0,0,1,1,4
LYEA,0,0,0,1,1,4
YEAL,0,0,0,1,1,4
EALV,0,0,0,2,2,4
ALVL,0,0,0,1,1,4
LVLV,0,0,0,1,1,4
VLVA,0,0,0,1,1,4
LVAT,0,0,0,1,1,4
VATL,0,0,0,2,2,4
ATLA,0,0,0,2,2,4
TLAA,0,0,0,2,2,4
LAAP,0,0,0,1,1,4
AEAH,0,0,0,1,1,4
EAHE,0,0,0,1,1,4
AHES,0,0,0,1,1,4
HESI,0,0,0,1,1,4
ESIR,0,0,0,2,2,4
SIRL,0,0,0,1,1,4
IRLV,0,0,0,1,1,4
RLVF,0,0,0,1,1,4
LVFH,0,0,0,1,1,4
VFHD,0,0,0,2,2,4
FHDS,0,0,0,1,1,4
AEGE,0,0,0,1,1,4
EGER,0,0,0,2,2,4
GERE,0,0,0,2,2,4
EREA,0,0,0,2,2,4
REAR,0,0,0,2,2,4
EARV,0,0,0,1,1,4
ARVF,0,0,0,2,2,4
RVFT,0,0,0,1,1,4
VFTL,0,0,0,2,2,4
FTLW,0,0,0,1,1,4
TLWL,0,0,0,1,1,4
LWLN,0,0,0,1,1,4
WLNS,0,0,0,1,1,4
LNSL,0,0,0,2,2,4
AEGV,0,0,0,1,1,4
EGVA,0,0,0,2,2,4
GVAT,0,0,0,1,1,4
VATA,0,0,0,1,1,4
ATAD,0,0,0,2,2,4
TADP,0,0,0,1,1,4
ADPL,0,0,0,1,1,4
DPLM,0,0,0,1,1,4
PLMR,0,0,0,1,1,4
LMRL,0,0,0,2,2,4
MRLA,0,0,0,1,1,4
LAKQ,0,0,0,3,3,4
AKQL,0,0,0,2,2,4
KQLK,0,0,0,1,1,4
AEHA,0,0,0,1,1,4
EHAK,0,0,0,1,1,4
HAKV,0,0,0,1,1,4
AKVL,0,0,0,1,1,4
KVLM,0,0,0,1,1,4
VLMD,0,0,0,1,1,4
LMDS,0,0,0,1,1,4
MDSL,0,0,0,1,1,4
DSLT,0,0,0,1,1,4
SLTG,0,0,0,1,1,4
LTGV,0,0,0,1,1,4
TGVW,0,0,0,1,1,4
GVWD,0,0,0,1,1,4
VWDN,0,0,0,1,1,4
WDNF,0,0,0,1,1,4
DNFL,0,0,0,1,1,4
NFLT,0,0,0,1,1,4
AEHL,0,0,0,1,1,4
EHLA,0,0,0,1,1,4
AKAE,0,0,0,1,1,4
KAEL,0,0,0,1,1,4
AELT,0,0,0,2,2,4
ELTT,0,0,0,1,1,4
LTTV,0,0,0,1,1,4
TTVF,0,0,0,1,1,4
TVFS,0,0,0,1,1,4
VFST,0,0,0,1,1,4
FSTL,0,0,0,2,2,4
STLY,0,0,0,2,2,4
TLYQ,0,0,0,1,1,4
LYQK,0,0,0,1,1,4
YQKF,0,0,0,1,1,4
AEKA,0,0,0,1,1,4
EKAK,0,0,0,1,1,4
KAKY,0,0,0,1,1,4
AKYD,0,0,0,1,1,4
KYDE,0,0,0,1,1,4
YDEI,0,0,0,1,1,4
DEIF,0,0,0,2,2,4
EIFL,0,0,0,1,1,4
IFLK,0,0,0,1,1,4
AFFT,0,0,0,1,1,4
FFTI,0,0,0,1,1,4
FTIA,0,0,0,1,1,4
TIAA,0,0,0,1,1,4
IAAV,0,0,0,1,1,4
AAVA,0,0,0,1,1,4
AVAR,0,0,0,1,1,4
VARV,0,0,0,1,1,4
ARVL,0,0,0,1,1,4
RVLD,0,0,0,1,1,4
AFRH,0,0,0,1,1,4
FRHS,0,0,0,1,1,4
RHSV,0,0,0,1,1,4
HSVK,0,0,0,1,1,4
SVKE,0,0,0,1,1,4
VKEE,0,0,0,1,1,4
KEEL,0,0,0,3,3,4
EELN,0,0,0,3,3,4
ELNY,0,0,0,1,1,4
LNYI,0,0,0,2,2,4
NYIR,0,0,0,1,1,4
YIRR,0,0,0,1,1,4
IRRR,0,0,0,2,2,4
RRRL,0,0,0,2,2,4
RRLE,0,0,0,1,1,4
RLER,0,0,0,2,2,4
LERF,0,0,0,1,1,4
ERFP,0,0,0,1,1,4
RFPN,0,0,0,1,1,4
FPNR,0,0,0,1,1,4
PNRL,0,0,0,1,1,4
AGDV,0,0,0,1,1,4
GDVL,0,0,0,1,1,4
DVLH,0,0,0,1,1,4
VLHN,0,0,0,1,1,4
LHNV,0,0,0,1,1,4
NVLQ,0,0,0,1,1,4
VLQM,0,0,0,1,1,4
LQML,0,0,0,2,2,4
QMLI,0,0,0,1,1,4
MLII,0,0,0,1,1,4
LIIE,0,0,0,2,2,4
IIES,0,0,0,1,1,4
IESH,0,0,0,1,1,4
ESHS,0,0,0,1,1,4
AGEM,0,0,0,1,1,4
GEMV,0,0,0,1,1,4
EMVR,0,0,0,3,3,4
MVRQ,0,0,0,1,1,4
VRQA,0,0,0,1,1,4
RQAR,0,0,0,1,1,4
QARI,0,0,0,1,1,4
ARIL,0,0,0,1,1,4
RILA,0,0,0,1,1,4
ILAQ,0,0,0,1,1,4
LAQA,0,0,0,2,2,4
AQAT,0,0,0,1,1,4
QATS,0,0,0,1,1,4
ATSD,0,0,0,1,1,4
TSDL,0,0,0,1,1,4
SDLV,0,0,0,1,1,4
DLVN,0,0,0,1,1,4
LVNA,0,0,0,1,1,4
VNAI,0,0,0,1,1,4
NAIK,0,0,0,1,1,4
AIKA,0,0,0,1,1,4
IKAD,0,0,0,1,1,4
KADA,0,0,0,2,2,4
AGNL,0,0,0,2,2,4
GNLD,0,0,0,1,1,4
NLDI,0,0,0,1,1,4
LDIM,0,0,0,1,1,4
DIMT,0,0,0,1,1,4
IMTS,0,0,0,1,1,4
MTSA,0,0,0,1,1,4
TSAA,0,0,0,2,2,4
SAAL,0,0,0,2,2,4
AALA,0,0,0,6,6,4
ALAT,0,0,0,1,1,4
LATA,0,0,0,1,1,4
ATAE,0,0,0,1,1,4
TAER,0,0,0,2,2,4
AERM,0,0,0,1,1,4
ERMA,0,0,0,1,1,4
RMAQ,0,0,0,1,1,4
MAQS,0,0,0,1,1,4
AQSM,0,0,0,1,1,4
QSML,0,0,0,1,1,4
SMLN,0,0,0,1,1,4
AHAI,0,0,0,1,1,4
HAIG,0,0,0,1,1,4
AIGV,0,0,0,1,1,4
IGVL,0,0,0,1,1,4
GVLL,0,0,0,2,2,4
VLLD,0,0,0,2,2,4
LLDN,0,0,0,1,1,4
LDNL,0,0,0,1,1,4
AIEK,0,0,0,2,2,4
IEKE,0,0,0,2,2,4
EKEI,0,0,0,1,1,4
KEIL,0,0,0,1,1,4
EILI,0,0,0,1,1,4
ILIE,0,0,0,1,1,4
LIEA,0,0,0,1,1,4
IEAI,0,0,0,3,3,4
EAIS,0,0,0,1,1,4
AKQE,0,0,0,1,1,4
KQEK,0,0,0,1,1,4
QEKI,0,0,0,1,1,4
EKII,0,0,0,2,2,4
KIII,0,0,0,1,1,4
IIIQ,0,0,0,1,1,4
IIQV,0,0,0,1,1,4
IQVA,0,0,0,1,1,4
QVAL,0,0,0,1,1,4
VALN,0,0,0,1,1,4
ALND,0,0,0,1,1,4
LNDI,0,0,0,1,1,4
NDIT,0,0,0,1,1,4
DITH,0,0,0,1,1,4
ITHV,0,0,0,1,1,4
THVV,0,0,0,1,1,4
HVVE,0,0,0,1,1,4
VVEL,0,0,0,1,1,4
VELL,0,0,0,1,1,4
AKVV,0,0,0,2,2,4
KVVR,0,0,0,1,1,4
VVRT,0,0,0,1,1,4
VRTA,0,0,0,1,1,4
RTAL,0,0,0,2,2,4
TALE,0,0,0,2,2,4
ALED,0,0,0,1,1,4
LEDA,0,0,0,2,2,4
EDAA,0,0,0,1,1,4
DAAS,0,0,0,1,1,4
AASV,0,0,0,1,1,4
ASVA,0,0,0,1,1,4
SVAG,0,0,0,1,1,4
VAGL,0,0,0,2,2,4
GLLI,0,0,0,2,2,4
LLIT,0,0,0,1,1,4
ALAV,0,0,0,1,1,4
LAVA,0,0,0,1,1,4
AVAA,0,0,0,2,2,4
VAAK,0,0,0,1,1,4
AAKP,0,0,0,1,1,4
AKPF,0,0,0,1,1,4
KPFL,0,0,0,1,1,4
ALGK,0,0,0,1,1,4
LGKV,0,0,0,1,1,4
GKVI,0,0,0,3,3,4
IKKW,0,0,0,1,1,4
KKWG,0,0,0,1,1,4
KWGT,0,0,0,1,1,4
WGTT,0,0,0,1,1,4
GTTV,0,0,0,2,2,4
TTVA,0,0,0,1,1,4
TVAK,0,0,0,1,1,4
ALYG,0,0,0,1,1,4
LYGL,0,0,0,1,1,4
YGLL,0,0,0,1,1,4
LLKE,0,0,0,1,1,4
LKEE,0,0,0,1,1,4
KEEM,0,0,0,2,2,4
EEMG,0,0,0,1,1,4
EMGE,0,0,0,1,1,4
MGEI,0,0,0,1,1,4
GEIL,0,0,0,3,3,4
EILA,0,0,0,2,2,4
ILAK,0,0,0,1,1,4
AMFE,0,0,0,1,1,4
MFEQ,0,0,0,1,1,4
FEQM,0,0,0,1,1,4
EQMR,0,0,0,1,1,4
QMRA,0,0,0,1,1,4
MRAN,0,0,0,1,1,4
RANV,0,0,0,1,1,4
ANVG,0,0,0,1,1,4
NVGK,0,0,0,2,2,4
VGKL,0,0,0,2,2,4
GKLL,0,0,0,1,1,4
LLKG,0,0,0,2,2,4
APDA,0,0,0,1,1,4
PDAE,0,0,0,1,1,4
DAEG,0,0,0,1,1,4
AEGR,0,0,0,1,1,4
EGRA,0,0,0,1,1,4
GRAI,0,0,0,2,2,4
RAIQ,0,0,0,2,2,4
AIQA,0,0,0,1,1,4
IQAV,0,0,0,2,2,4
QAVY,0,0,0,1,1,4
AVYW,0,0,0,1,1,4
VYWA,0,0,0,1,1,4
YWAN,0,0,0,1,1,4
WANK,0,0,0,1,1,4
ANKW,0,0,0,1,1,4
NKWA,0,0,0,1,1,4
WAKE,0,0,0,1,1,4
AKEQ,0,0,0,1,1,4
KEQG,0,0,0,1,1,4
APDL,0,0,0,1,1,4
PDLL,0,0,0,1,1,4
DLLI,0,0,0,1,1,4
LLIS,0,0,0,2,2,4
LISL,0,0,0,2,2,4
ISLA,0,0,0,1,1,4
SLAT,0,0,0,1,1,4
LATV,0,0,0,1,1,4
ATVL,0,0,0,1,1,4
TVLY,0,0,0,1,1,4
VLYH,0,0,0,1,1,4
LYHL,0,0,0,1,1,4
YHLQ,0,0,0,1,1,4
HLQQ,0,0,0,1,1,4
APED,0,0,0,1,1,4
PEDV,0,0,0,1,1,4
EDVR,0,0,0,1,1,4
DVRK,0,0,0,1,1,4
VRKS,0,0,0,1,1,4
RKSS,0,0,0,1,1,4
KSSK,0,0,0,1,1,4
SSKE,0,0,0,2,2,4
SKEV,0,0,0,1,1,4
KEVL,0,0,0,3,3,4
APLL,0,0,0,1,1,4
PLLN,0,0,0,1,1,4
LLNF,0,0,0,1,1,4
LNFV,0,0,0,1,1,4
NFVR,0,0,0,1,1,4
FVRD,0,0,0,1,1,4
VRDF,0,0,0,1,1,4
RDFV,0,0,0,1,1,4
DFVR,0,0,0,1,1,4
FVRE,0,0,0,1,1,4
VRED,0,0,0,2,2,4
REDA,0,0,0,1,1,4
EDAK,0,0,0,1,1,4
DAKY,0,0,0,1,1,4
AKYL,0,0,0,1,1,4
KYLY,0,0,0,1,1,4
YLYS,0,0,0,1,1,4
LYSS,0,0,0,1,1,4
YSSL,0,0,0,1,1,4
SSLV,0,0,0,1,1,4
AQTS,0,0,0,2,2,4
QTSR,0,0,0,1,1,4
TSRW,0,0,0,1,1,4
SRWA,0,0,0,1,1,4
RWAA,0,0,0,1,1,4
WAAM,0,0,0,1,1,4
AAMQ,0,0,0,2,2,4
AMQI,0,0,0,1,1,4
MQIG,0,0,0,1,1,4
QIGM,0,0,0,1,1,4
IGMS,0,0,0,1,1,4
GMSF,0,0,0,1,1,4
MSFI,0,0,0,1,1,4
SFIS,0,0,0,1,1,4
FISA,0,0,0,1,1,4
ISAY,0,0,0,1,1,4
ARDE,0,0,0,1,1,4
RDEA,0,0,0,1,1,4
DEAE,0,0,0,2,2,4
EAEM,0,0,0,1,1,4
AEME,0,0,0,1,1,4
EMEY,0,0,0,1,1,4
MEYL,0,0,0,1,1,4
EYLK,0,0,0,1,1,4
YLKI,0,0,0,1,1,4
LKIA,0,0,0,2,2,4
KIAQ,0,0,0,1,1,4
ASLP,0,0,0,1,1,4
SLPE,0,0,0,2,2,4
LPEA,0,0,0,1,1,4
PEAI,0,0,0,1,1,4
EAIE,0,0,0,4,4,4
AIEA,0,0,0,3,3,4
IEAL,0,0,0,2,2,4
EALT,0,0,0,4,4,4
ALTK,0,0,0,3,3,4
LTKG,0,0,0,2,2,4
ATLK,0,0,0,1,1,4
TLKN,0,0,0,1,1,4
LKNL,0,0,0,1,1,4
KNLG,0,0,0,1,1,4
NLGS,0,0,0,1,1,4
LGSV,0,0,0,1,1,4
GSVH,0,0,0,1,1,4
SVHV,0,0,0,1,1,4
VHVS,0,0,0,1,1,4
HVSK,0,0,0,1,1,4
VSKG,0,0,0,1,1,4
AVDT,0,0,0,1,1,4
VDTL,0,0,0,2,2,4
DTLV,0,0,0,1,1,4
TLVL,0,0,0,1,1,4
LVLA,0,0,0,1,1,4
VLAL,0,0,0,2,2,4
ALAE,0,0,0,4,4,4
LAEA,0,0,0,3,3,4
AEAT,0,0,0,3,3,4
DAAA,0,0,0,2,2,4
AAAL,0,0,0,2,2,4
AALF,0,0,0,2,2,4
ALFR,0,0,0,2,2,4
LFRL,0,0,0,1,1,4
FRLH,0,0,0,2,2,4
RLHK,0,0,0,2,2,4
LHKF,0,0,0,1,1,4
HKFL,0,0,0,1,1,4
KFLT,0,0,0,2,2,4
FLTK,0,0,0,2,2,4
LTKW,0,0,0,1,1,4
DAAG,0,0,0,1,1,4
AAGL,0,0,0,1,1,4
AGLA,0,0,0,1,1,4
GLAS,0,0,0,1,1,4
LASR,0,0,0,2,2,4
ASRH,0,0,0,1,1,4
SRHK,0,0,0,1,1,4
RHKG,0,0,0,1,1,4
DAEN,0,0,0,2,2,4
AENR,0,0,0,1,1,4
ENRD,0,0,0,1,1,4
NRDL,0,0,0,1,1,4
RDLF,0,0,0,1,1,4
DLFL,0,0,0,3,3,4
LFLA,0,0,0,4,4,4
FLAL,0,0,0,1,1,4
ALLS,0,0,0,1,1,4
LLSV,0,0,0,1,1,4
DAHA,0,0,0,1,1,4
AHAW,0,0,0,1,1,4
HAWM,0,0,0,1,1,4
AWMI,0,0,0,1,1,4
WMIG,0,0,0,1,1,4
MIGQ,0,0,0,1,1,4
IGQL,0,0,0,1,1,4
GQLK,0,0,0,1,1,4
QLKG,0,0,0,1,1,4
LKGL,0,0,0,1,1,4
DALE,0,0,0,1,1,4
ALEI,0,0,0,1,1,4
LEIF,0,0,0,1,1,4
EIFK,0,0,0,3,3,4
IFKT,0,0,0,1,1,4
FKTL,0,0,0,2,2,4
KTLF,0,0,0,1,1,4
TLFS,0,0,0,1,1,4
LFSL,0,0,0,2,2,4
FSLV,0,0,0,1,1,4
SLVM,0,0,0,1,1,4
LVMR,0,0,0,1,1,4
VMRF,0,0,0,1,1,4
MRFS,0,0,0,1,1,4
RFSS,0,0,0,1,1,4
FSSY,0,0,0,1,1,4
SSYL,0,0,0,2,2,4
DAML,0,0,0,1,1,4
AMLR,0,0,0,1,1,4
MLRT,0,0,0,1,1,4
LRTS,0,0,0,1,1,4
RTSM,0,0,0,1,1,4
TSMV,0,0,0,1,1,4
SMVA,0,0,0,1,1,4
MVAT,0,0,0,1,1,4
VATQ,0,0,0,1,1,4
ATQL,0,0,0,1,1,4
TQLV,0,0,0,1,1,4
QLVG,0,0,0,1,1,4
LVGL,0,0,0,1,1,4
VGLA,0,0,0,1,1,4
GLAM,0,0,0,1,1,4
LAMM,0,0,0,1,1,4
AMMR,0,0,0,1,1,4
MMRY,0,0,0,1,1,4
MRYV,0,0,0,1,1,4
ARAK,0,0,0,1,1,4
RAKK,0,0,0,1,1,4
KLLD,0,0,0,2,2,4
LLDK,0,0,0,1,1,4
LDKW,0,0,0,1,1,4
DKWA,0,0,0,1,1,4
WAKW,0,0,0,1,1,4
AKWI,0,0,0,1,1,4
KWIN,0,0,0,1,1,4
WING,0,0,0,1,1,4
DATA,0,0,0,1,1,4
ATAA,0,0,0,1,1,4
TAAL,0,0,0,2,2,4
LALT,0,0,0,1,1,4
ALTM,0,0,0,1,1,4
LTMA,0,0,0,1,1,4
DATL,0,0,0,1,1,4
ATLI,0,0,0,1,1,4
TLIS,0,0,0,2,2,4
LISE,0,0,0,1,1,4
ISEL,0,0,0,2,2,4
SELQ,0,0,0,1,1,4
ELQQ,0,0,0,1,1,4
LQQM,0,0,0,1,1,4
DDAD,0,0,0,1,1,4
DADL,0,0,0,1,1,4
ADLE,0,0,0,1,1,4
DLEK,0,0,0,1,1,4
LEKF,0,0,0,2,2,4
EKFV,0,0,0,1,1,4
KFVI,0,0,0,1,1,4
FVIE,0,0,0,1,1,4
VIEY,0,0,0,1,1,4
DDET,0,0,0,2,2,4
DETL,0,0,0,1,1,4
ETLG,0,0,0,1,1,4
TLGV,0,0,0,1,1,4
LGVL,0,0,0,2,2,4
GVLM,0,0,0,2,2,4
VLMW,0,0,0,1,1,4
LMWI,0,0,0,1,1,4
MWIL,0,0,0,1,1,4
WILD,0,0,0,1,1,4
ILDR,0,0,0,1,1,4
LDRS,0,0,0,1,1,4
DRSI,0,0,0,1,1,4
RSIH,0,0,0,1,1,4
DETR,0,0,0,1,1,4
ETRE,0,0,0,2,2,4
TREE,0,0,0,1,1,4
REEL,0,0,0,3,3,4
EELE,0,0,0,2,2,4
ELEE,0,0,0,4,4,4
LEEL,0,0,0,3,3,4
EELL,0,0,0,2,2,4
ELLI,0,0,0,1,1,4
LLIQ,0,0,0,2,2,4
LIQA,0,0,0,1,1,4
DDRV,0,0,0,1,1,4
DRVQ,0,0,0,1,1,4
RVQS,0,0,0,1,1,4
VQSH,0,0,0,1,1,4
QSHI,0,0,0,1,1,4
SHIL,0,0,0,1,1,4
HILH,0,0,0,2,2,4
ILHL,0,0,0,1,1,4
LHLE,0,0,0,1,1,4
HLEH,0,0,0,1,1,4
LEHD,0,0,0,1,1,4
EHDL,0,0,0,1,1,4
HDLV,0,0,0,2,2,4
DLVH,0,0,0,1,1,4
LVHV,0,0,0,1,1,4
VHVT,0,0,0,1,1,4
HVTR,0,0,0,1,1,4
VTRK,0,0,0,1,1,4
TRKN,0,0,0,1,1,4
DDYL,0,0,0,1,1,4
DYLK,0,0,0,1,1,4
YLKE,0,0,0,2,2,4
LKEQ,0,0,0,1,1,4
KEQV,0,0,0,1,1,4
EQVL,0,0,0,2,2,4
QVLH,0,0,0,1,1,4
VLHM,0,0,0,1,1,4
LHMK,0,0,0,1,1,4
HMKQ,0,0,0,1,1,4
MKQY,0,0,0,1,1,4
KQYV,0,0,0,1,1,4
QYVS,0,0,0,1,1,4
YVSD,0,0,0,1,1,4
VSDN,0,0,0,1,1,4
DEAA,0,0,0,2,2,4
EAAF,0,0,0,1,1,4
AAFQ,0,0,0,1,1,4
AFQK,0,0,0,1,1,4
FQKL,0,0,0,1,1,4
QKLM,0,0,0,1,1,4
KLMS,0,0,0,1,1,4
LMSN,0,0,0,1,1,4
MSNL,0,0,0,1,1,4
SNLD,0,0,0,1,1,4
DEAG,0,0,0,1,1,4
EAGL,0,0,0,1,1,4
AGLM,0,0,0,1,1,4
GLMR,0,0,0,1,1,4
LMRE,0,0,0,1,1,4
MREL,0,0,0,2,2,4
RELR,0,0,0,1,1,4
ELRL,0,0,0,1,1,4
LRLF,0,0,0,2,2,4
FRRR,0,0,0,1,1,4
RRRI,0,0,0,1,1,4
RRIM,0,0,0,1,1,4
RIMV,0,0,0,1,1,4
IMVR,0,0,0,1,1,4
MVRI,0,0,0,1,1,4
VRIA,0,0,0,2,2,4
RIAW,0,0,0,1,1,4
IAWA,0,0,0,1,1,4
AWAQ,0,0,0,1,1,4
WAQT,0,0,0,1,1,4
AQTL,0,0,0,2,2,4
DEET,0,0,0,2,2,4
EETM,0,0,0,1,1,4
ETME,0,0,0,1,1,4
TMER,0,0,0,1,1,4
MERI,0,0,0,1,1,4
ERIM,0,0,0,1,1,4
RIMR,0,0,0,1,1,4
IMRE,0,0,0,1,1,4
RELK,0,0,0,1,1,4
ELKK,0,0,0,2,2,4
DEFT,0,0,0,1,1,4
EFTK,0,0,0,1,1,4
FTKQ,0,0,0,1,1,4
TKQH,0,0,0,1,1,4
KQHI,0,0,0,2,2,4
QHIV,0,0,0,1,1,4
HIVG,0,0,0,1,1,4
IVGK,0,0,0,1,1,4
DEKA,0,0,0,2,2,4
EKAF,0,0,0,1,1,4
AFKN,0,0,0,1,1,4
FKNT,0,0,0,1,1,4
KNTY,0,0,0,1,1,4
NTYR,0,0,0,1,1,4
TYRQ,0,0,0,1,1,4
YRQA,0,0,0,1,1,4
RQAM,0,0,0,1,1,4
QAMN,0,0,0,1,1,4
AMND,0,0,0,1,1,4
DEKK,0,0,0,1,1,4
EKKI,0,0,0,1,1,4
ILKD,0,0,0,2,2,4
LKDF,0,0,0,1,1,4
DFLI,0,0,0,2,2,4
FLIQ,0,0,0,2,2,4
DEKS,0,0,0,1,1,4
EKSI,0,0,0,1,1,4
KSII,0,0,0,1,1,4
SIIT,0,0,0,1,1,4
IITY,0,0,0,1,1,4
ITYV,0,0,0,1,1,4
TYVS,0,0,0,1,1,4
YVSS,0,0,0,1,1,4
VSSL,0,0,0,1,1,4
SSLY,0,0,0,1,1,4
SLYD,0,0,0,2,2,4
LYDA,0,0,0,1,1,4
YDAM,0,0,0,1,1,4
DELL,0,0,0,2,2,4
ELLS,0,0,0,2,2,4
LLSK,0,0,0,2,2,4
LSKM,0,0,0,1,1,4
SKMR,0,0,0,1,1,4
KMRF,0,0,0,1,1,4
MRFA,0,0,0,1,1,4
RFAL,0,0,0,1,1,4
DEPQ,0,0,0,1,1,4
EPQV,0,0,0,1,1,4
PQVQ,0,0,0,1,1,4
QVQA,0,0,0,1,1,4
VQAK,0,0,0,1,1,4
QAKI,0,0,0,1,1,4
AKIM,0,0,0,1,1,4
KIMA,0,0,0,1,1,4
IMAY,0,0,0,1,1,4
MAYL,0,0,0,1,1,4
AYLQ,0,0,0,1,1,4
YLQQ,0,0,0,1,1,4
LQQE,0,0,0,1,1,4
QQEQ,0,0,0,1,1,4
QEQS,0,0,0,1,1,4
EQSN,0,0,0,1,1,4
QSNR,0,0,0,1,1,4
DEQY,0,0,0,1,1,4
EQYR,0,0,0,1,1,4
QYRE,0,0,0,1,1,4
YREG,0,0,0,1,1,4
REGA,0,0,0,1,1,4
EGAV,0,0,0,2,2,4
GAVR,0,0,0,2,2,4
AVRT,0,0,0,1,1,4
VRTV,0,0,0,1,1,4
RTVA,0,0,0,1,1,4
TVAS,0,0,0,1,1,4
VASF,0,0,0,1,1,4
ASFR,0,0,0,1,1,4
SFRE,0,0,0,1,1,4
FRER,0,0,0,2,2,4
RERL,0,0,0,2,2,4
ERLD,0,0,0,1,1,4
DERL,0,0,0,1,1,4
ERLL,0,0,0,5,5,4
RLLQ,0,0,0,1,1,4
LLQK,0,0,0,1,1,4
LQKY,0,0,0,1,1,4
QKYR,0,0,0,1,1,4
KYRA,0,0,0,1,1,4
YRAQ,0,0,0,1,1,4
RAQV,0,0,0,1,1,4
AQVF,0,0,0,1,1,4
QVFE,0,0,0,1,1,4
VFEW,0,0,0,1,1,4
FEWG,0,0,0,1,1,4
DEVL,0,0,0,1,1,4
EVLL,0,0,0,1,1,4
VLLA,0,0,0,1,1,4
LAEQ,0,0,0,2,2,4
AEQL,0,0,0,1,1,4
EQLG,0,0,0,1,1,4
QLGT,0,0,0,1,1,4
DFAA,0,0,0,1,1,4
FAAL,0,0,0,1,1,4
ALAQ,0,0,0,2,2,4
LAQT,0,0,0,2,2,4
AQTA,0,0,0,1,1,4
QTAH,0,0,0,1,1,4
TAHR,0,0,0,1,1,4
AHRL,0,0,0,2,2,4
HRLK,0,0,0,1,1,4
RLKG,0,0,0,1,1,4
LKGV,0,0,0,1,1,4
KGVF,0,0,0,1,1,4
GVFA,0,0,0,1,1,4
VFAM,0,0,0,1,1,4
FAML,0,0,0,1,1,4
AMLN,0,0,0,1,1,4
DFLE,0,0,0,1,1,4
FLEE,0,0,0,1,1,4
LEEQ,0,0,0,1,1,4
EEQY,0,0,0,1,1,4
EQYK,0,0,0,1,1,4
QYKG,0,0,0,1,1,4
YKGQ,0,0,0,1,1,4
KGQR,0,0,0,1,1,4
GQRD,0,0,0,1,1,4
QRDL,0,0,0,1,1,4
RDLA,0,0,0,1,1,4
DLAG,0,0,0,1,1,4
LAGK,0,0,0,1,1,4
GKAS,0,0,0,2,2,4
KAST,0,0,0,1,1,4
ASTL,0,0,0,1,1,4
STLK,0,0,0,1,1,4
TLKK,0,0,0,2,2,4
DFPA,0,0,0,1,1,4
FPAL,0,0,0,1,1,4
ALIK,0,0,0,1,1,4
LIKQ,0,0,0,1,1,4
IKQA,0,0,0,2,2,4
KQAS,0,0,0,1,1,4
QASL,0,0,0,2,2,4
ASLD,0,0,0,1,1,4
SLDA,0,0,0,2,2,4
LDAL,0,0,0,4,4,4
DALF,0,0,0,1,1,4
DFSE,0,0,0,1,1,4
FSET,0,0,0,2,2,4
SETI,0,0,0,1,1,4
ETIN,0,0,0,2,2,4
TINA,0,0,0,1,1,4
INAY,0,0,0,1,1,4
NAYF,0,0,0,1,1,4
AYFV,0,0,0,1,1,4
YFVA,0,0,0,1,1,4
FVAK,0,0,0,1,1,4
DGAL,0,0,0,1,1,4
GALK,0,0,0,1,1,4
ALKR,0,0,0,1,1,4
LKRA,0,0,0,4,4,4
KRAE,0,0,0,4,4,4
RAEE,0,0,0,2,2,4
AEEL,0,0,0,2,2,4
EELK,0,0,0,2,2,4
ELKT,0,0,0,1,1,4
LKTQ,0,0,0,1,1,4
KTQA,0,0,0,1,1,4
TQAN,0,0,0,1,1,4
QAND,0,0,0,1,1,4
ANDY,0,0,0,1,1,4
NDYF,0,0,0,1,1,4
DYFK,0,0,0,1,1,4
DGFS,0,0,0,1,1,4
GFSV,0,0,0,2,2,4
FSVL,0,0,0,1,1,4
SVLM,0,0,0,1,1,4
VLMR,0,0,0,1,1,4
LMRA,0,0,0,1,1,4
MRAM,0,0,0,1,1,4
RAMQ,0,0,0,1,1,4
AMQQ,0,0,0,1,1,4
DGGG,0,0,0,1,1,4
GGGF,0,0,0,1,1,4
GGFV,0,0,0,1,1,4
GFVI,0,0,0,1,1,4
FVIS,0,0,0,1,1,4
VISK,0,0,0,1,1,4
ISKH,0,0,0,1,1,4
SKHP,0,0,0,1,1,4
KHPV,0,0,0,1,1,4
HPVR,0,0,0,1,1,4
PVRL,0,0,0,1,1,4
VRLA,0,0,0,1,1,4
KKLN,0,0,0,1,1,4
KLNR,0,0,0,1,1,4
DHAV,0,0,0,1,1,4
HAVL,0,0,0,2,2,4
AVLE,0,0,0,1,1,4
VLEV,0,0,0,1,1,4
LEVL,0,0,0,2,2,4
EVLA,0,0,0,3,3,4
VLAT,0,0,0,1,1,4
LATP,0,0,0,1,1,4
ATPV,0,0,0,1,1,4
TPVR,0,0,0,1,1,4
PVRE,0,0,0,2,2,4
VREA,0,0,0,2,2,4
REAL,0,0,0,1,1,4
EALL,0,0,0,2,2,4
ALLA,0,0,0,1,1,4
LLAR,0,0,0,4,4,4
LARF,0,0,0,1,1,4
ARFG,0,0,0,1,1,4
DIFD,0,0,0,1,1,4
IFDF,0,0,0,1,1,4
FDFM,0,0,0,1,1,4
DFME,0,0,0,1,1,4
FMER,0,0,0,2,2,4
MERW,0,0,0,1,1,4
ERWI,0,0,0,1,1,4
RWIE,0,0,0,1,1,4
WIEK,0,0,0,2,2,4
IEKK,0,0,0,1,1,4
EKKL,0,0,0,1,1,4
KKLE,0,0,0,1,1,4
KLEY,0,0,0,1,1,4
LEYS,0,0,0,1,1,4
EYSA,0,0,0,1,1,4
YSAS,0,0,0,1,1,4
SASH,0,0,0,1,1,4
DIHA,0,0,0,1,1,4
IHAA,0,0,0,1,1,4
HAAI,0,0,0,1,1,4
AAIE,0,0,0,2,2,4
AIEM,0,0,0,1,1,4
IEML,0,0,0,1,1,4
EMLL,0,0,0,1,1,4
MLLG,0,0,0,1,1,4
DIIG,0,0,0,1,1,4
IIGT,0,0,0,1,1,4
IGTE,0,0,0,1,1,4
GTEI,0,0,0,1,1,4
TEIT,0,0,0,1,1,4
EITS,0,0,0,1,1,4
ITSA,0,0,0,3,3,4
TSAL,0,0,0,2,2,4
SALK,0,0,0,2,2,4
ALKN,0,0,0,2,2,4
LKNV,0,0,0,3,3,4
KNVY,0,0,0,1,1,4
NVYS,0,0,0,1,1,4
VYSI,0,0,0,1,1,4
YSIA,0,0,0,1,1,4
SIAI,0,0,0,1,1,4
IAIA,0,0,0,1,1,4
AIAW,0,0,0,1,1,4
IAWI,0,0,0,1,1,4
AWIR,0,0,0,1,1,4
WIRG,0,0,0,1,1,4
IRGY,0,0,0,1,1,4
RGYE,0,0,0,1,1,4
GYES,0,0,0,1,1,4
YESR,0,0,0,1,1,4
ESRK,0,0,0,1,1,4
SRKN,0,0,0,1,1,4
DILR,0,0,0,1,1,4
ILRE,0,0,0,1,1,4
LREI,0,0,0,2,2,4
REIG,0,0,0,1,1,4
EIGM,0,0,0,1,1,4
IGMI,0,0,0,1,1,4
GMIA,0,0,0,1,1,4
MIAR,0,0,0,1,1,4
IARA,0,0,0,1,1,4
ARAL,0,0,0,4,4,4
RALD,0,0,0,2,2,4
ALDS,0,0,0,1,1,4
LDSI,0,0,0,3,3,4
DSIS,0,0,0,1,1,4
SISN,0,0,0,1,1,4
ISNI,0,0,0,1,1,4
SNIE,0,0,0,1,1,4
NIEF,0,0,0,1,1,4
DIRA,0,0,0,1,1,4
IRAV,0,0,0,1,1,4
RAVL,0,0,0,1,1,4
AVLR,0,0,0,2,2,4
VLRD,0,0,0,1,1,4
LRDL,0,0,0,1,1,4
RDLS,0,0,0,1,1,4
DLSF,0,0,0,1,1,4
LSFH,0,0,0,1,1,4
SFHL,0,0,0,1,1,4
FHLN,0,0,0,1,1,4
HLNG,0,0,0,1,1,4
LNGH,0,0,0,1,1,4
NGHI,0,0,0,1,1,4
GHIL,0,0,0,1,1,4
ILHS,0,0,0,1,1,4
LHSI,0,0,0,1,1,4
HSIF,0,0,0,1,1,4
SIFW,0,0,0,1,1,4
IFWP,0,0,0,1,1,4
FWPN,0,0,0,1,1,4
WPNM,0,0,0,1,1,4
DIRT,0,0,0,1,1,4
IRTS,0,0,0,1,1,4
RTSL,0,0,0,1,1,4
TSLA,0,0,0,1,1,4
SLAN,0,0,0,1,1,4
LAND,0,0,0,1,1,4
ANDM,0,0,0,1,1,4
NDMA,0,0,0,1,1,4
DMAI,0,0,0,1,1,4
MAIY,0,0,0,1,1,4
AIYG,0,0,0,1,1,4
IYGD,0,0,0,1,1,4
YGDI,0,0,0,1,1,4
GDII,0,0,0,1,1,4
DIIE,0,0,0,2,2,4
IIEA,0,0,0,2,2,4
IEAT,0,0,0,1,1,4
EATR,0,0,0,1,1,4
ATRE,0,0,0,1,1,4
TREH,0,0,0,2,2,4
REHT,0,0,0,1,1,4
EHTE,0,0,0,1,1,4
HTEL,0,0,0,1,1,4
TELA,0,0,0,1,1,4
ELAE,0,0,0,2,2,4
LAEN,0,0,0,2,2,4
AENL,0,0,0,1,1,4
DIYQ,0,0,0,1,1,4
IYQQ,0,0,0,1,1,4
YQQV,0,0,0,1,1,4
QQVR,0,0,0,1,1,4
QVRD,0,0,0,1,1,4
VRDE,0,0,0,1,1,4
RDEL,0,0,0,2,2,4
DELK,0,0,0,1,1,4
ELKR,0,0,0,1,1,4
KRAS,0,0,0,1,1,4
DKET,0,0,0,1,1,4
KETM,0,0,0,1,1,4
ETMN,0,0,0,1,1,4
TMNI,0,0,0,1,1,4
MNIH,0,0,0,1,1,4
NIHH,0,0,0,1,1,4
IHHT,0,0,0,1,1,4
HHTK,0,0,0,1,1,4
DLAA,0,0,0,2,2,4
LAAN,0,0,0,3,3,4
AANN,0,0,0,1,1,4
ANNG,0,0,0,1,1,4
NNGG,0,0,0,1,1,4
NGGW,0,0,0,1,1,4
GGWQ,0,0,0,1,1,4
GWQW,0,0,0,1,1,4
WQWS,0,0,0,1,1,4
DLAR,0,0,0,1,1,4
LARI,0,0,0,1,1,4
ARIE,0,0,0,1,1,4
RIEQ,0,0,0,1,1,4
IEQF,0,0,0,1,1,4
EQFL,0,0,0,1,1,4
QFLD,0,0,0,2,2,4
FLDA,0,0,0,1,1,4
DALW,0,0,0,1,1,4
ALWL,0,0,0,1,1,4
LWLE,0,0,0,1,1,4
DLEA,0,0,0,2,2,4
LEAK,0,0,0,2,2,4
EAKK,0,0,0,2,2,4
AKKM,0,0,0,1,1,4
KKMY,0,0,0,1,1,4
KMYF,0,0,0,1,1,4
MYFD,0,0,0,1,1,4
YFDA,0,0,0,2,2,4
FDAV,0,0,0,1,1,4
DAVQ,0,0,0,1,1,4
AVQA,0,0,0,2,2,4
VQAI,0,0,0,3,3,4
QAIE,0,0,0,1,1,4
AIET,0,0,0,1,1,4
IETH,0,0,0,1,1,4
ETHL,0,0,0,1,1,4
DLES,0,0,0,1,1,4
LESD,0,0,0,1,1,4
ESDA,0,0,0,1,1,4
SDAL,0,0,0,1,1,4
DALG,0,0,0,1,1,4
ALGW,0,0,0,2,2,4
LGWQ,0,0,0,1,1,4
GWQY,0,0,0,1,1,4
WQYI,0,0,0,1,1,4
QYIT,0,0,0,1,1,4
YITG,0,0,0,1,1,4
DLGR,0,0,0,1,1,4
LGRK,0,0,0,1,1,4
GRKI,0,0,0,1,1,4
RKIT,0,0,0,1,1,4
KITS,0,0,0,1,1,4
SALR,0,0,0,2,2,4
ALRS,0,0,0,1,1,4
LRSL,0,0,0,2,2,4
RSLS,0,0,0,1,1,4
SLSN,0,0,0,1,1,4
DLKQ,0,0,0,1,1,4
LKQA,0,0,0,1,1,4
KQAE,0,0,0,2,2,4
QAES,0,0,0,1,1,4
AESW,0,0,0,1,1,4
ESWL,0,0,0,1,1,4
SWLH,0,0,0,1,1,4
WLHK,0,0,0,1,1,4
LHKQ,0,0,0,1,1,4
HKQA,0,0,0,1,1,4
KQAQ,0,0,0,1,1,4
QAQK,0,0,0,1,1,4
AQKE,0,0,0,1,1,4
QKEG,0,0,0,1,1,4
KEGW,0,0,0,1,1,4
EGWS,0,0,0,1,1,4
GWSK,0,0,0,1,1,4
WSKA,0,0,0,1,1,4
SKAA,0,0,0,1,1,4
KAAR,0,0,0,1,1,4
AARL,0,0,0,2,2,4
ARLH,0,0,0,1,1,4
DLKR,0,0,0,1,1,4
RAES,0,0,0,1,1,4
AESM,0,0,0,1,1,4
ESML,0,0,0,2,2,4
SMLQ,0,0,0,1,1,4
MLQQ,0,0,0,1,1,4
LQQA,0,0,0,2,2,4
DLKT,0,0,0,1,1,4
LKTM,0,0,0,1,1,4
KTMT,0,0,0,1,1,4
TMTE,0,0,0,2,2,4
MTER,0,0,0,1,1,4
TERL,0,0,0,1,1,4
ERLR,0,0,0,2,2,4
RLRS,0,0,0,1,1,4
DLQL,0,0,0,1,1,4
LQLN,0,0,0,1,1,4
QLNA,0,0,0,1,1,4
LNAN,0,0,0,1,1,4
NANA,0,0,0,1,1,4
ANAE,0,0,0,1,1,4
NAER,0,0,0,1,1,4
AERI,0,0,0,1,1,4
ERIN,0,0,0,2,2,4
RINV,0,0,0,1,1,4
INVY,0,0,0,1,1,4
NVYY,0,0,0,1,1,4
DLRE,0,0,0,1,1,4
LREL,0,0,0,1,1,4
RELI,0,0,0,3,3,4
ELIA,0,0,0,1,1,4
LIAR,0,0,0,2,2,4
IARV,0,0,0,2,2,4
ARVR,0,0,0,2,2,4
RVRA,0,0,0,2,2,4
VRAL,0,0,0,1,1,4
RALI,0,0,0,1,1,4
ALIR,0,0,0,1,1,4
LIRR,0,0,0,1,1,4
IRRK,0,0,0,1,1,4
RRKS,0,0,0,1,1,4
DLSA,0,0,0,2,2,4
LSAS,0,0,0,2,2,4
SASR,0,0,0,1,1,4
ASRS,0,0,0,1,1,4
SRSA,0,0,0,1,1,4
RSAI,0,0,0,3,3,4
SAID,0,0,0,1,1,4
AIDS,0,0,0,1,1,4
IDSL,0,0,0,1,1,4
DSLN,0,0,0,1,1,4
SLNN,0,0,0,1,1,4
LNNR,0,0,0,1,1,4
NNRM,0,0,0,1,1,4
NRML,0,0,0,1,1,4
RMLS,0,0,0,1,1,4
MLSQ,0,0,0,1,1,4
LSQI,0,0,0,1,1,4
SQIW,0,0,0,1,1,4
QIWS,0,0,0,1,1,4
IWSH,0,0,0,1,1,4
DLVD,0,0,0,1,1,4
LVDF,0,0,0,1,1,4
VDFA,0,0,0,1,1,4
DFAV,0,0,0,1,1,4
FAVE,0,0,0,1,1,4
AVEY,0,0,0,1,1,4
VEYF,0,0,0,1,1,4
EYFT,0,0,0,1,1,4
YFTR,0,0,0,1,1,4
FTRL,0,0,0,1,1,4
TRLR,0,0,0,1,1,4
RLRE,0,0,0,1,1,4
LREA,0,0,0,1,1,4
EARR,0,0,0,1,1,4
ARRG,0,0,0,1,1,4
RRGL,0,0,0,2,2,4
RGLE,0,0,0,1,1,4
GLEH,0,0,0,1,1,4
LEHH,0,0,0,1,1,4
EHHH,0,0,0,1,1,4
DMAS,0,0,0,1,1,4
MASL,0,0,0,1,1,4
ASLQ,0,0,0,2,2,4
SLQQ,0,0,0,1,1,4
LQQQ,0,0,0,1,1,4
QQQR,0,0,0,1,1,4
QQRQ,0,0,0,1,1,4
QRQE,0,0,0,1,1,4
DMNQ,0,0,0,1,1,4
MNQV,0,0,0,1,1,4
NQVL,0,0,0,1,1,4
QVLD,0,0,0,3,3,4
VLDA,0,0,0,1,1,4
LDAY,0,0,0,2,2,4
DAYE,0,0,0,1,1,4
AYEN,0,0,0,2,2,4
DNAM,0,0,0,1,1,4
NAMA,0,0,0,1,1,4
AMAN,0,0,0,1,1,4
MANQ,0,0,0,1,1,4
ANQY,0,0,0,1,1,4
NQYE,0,0,0,1,1,4
QYET,0,0,0,1,1,4
YETL,0,0,0,2,2,4
ETLA,0,0,0,2,2,4
TLAN,0,0,0,1,1,4
LANA,0,0,0,2,2,4
ANAR,0,0,0,1,1,4
NARQ,0,0,0,1,1,4
ARQK,0,0,0,1,1,4
RQKG,0,0,0,1,1,4
QKGI,0,0,0,1,1,4
KGIE,0,0,0,1,1,4
GIEK,0,0,0,1,1,4
IEKY,0,0,0,2,2,4
EKYL,0,0,0,2,2,4
DNKT,0,0,0,1,1,4
NKTR,0,0,0,1,1,4
KTRF,0,0,0,1,1,4
TRFK,0,0,0,1,1,4
RFKI,0,0,0,1,1,4
FKII,0,0,0,2,2,4
IIKE,0,0,0,1,1,4
IKEK,0,0,0,1,1,4
KEKL,0,0,0,2,2,4
EKLK,0,0,0,1,1,4
KLKE,0,0,0,2,2,4
LKEF,0,0,0,1,1,4
DNTY,0,0,0,1,1,4
NTYL,0,0,0,1,1,4
TYLN,0,0,0,1,1,4
YLNT,0,0,0,1,1,4
LNTA,0,0,0,1,1,4
NTAE,0,0,0,1,1,4
TAES,0,0,0,2,2,4
AESL,0,0,0,1,1,4
ESLY,0,0,0,2,2,4
LYDE,0,0,0,1,1,4
YDEF,0,0,0,1,1,4
DNVV,0,0,0,1,1,4
NVVL,0,0,0,1,1,4
VVLQ,0,0,0,2,2,4
VLQL,0,0,0,1,1,4
LQLQ,0,0,0,1,1,4
QLQV,0,0,0,1,1,4
LQVA,0,0,0,2,2,4
QVAR,0,0,0,2,2,4
VARF,0,0,0,1,1,4
ARFL,0,0,0,1,1,4
RFLM,0,0,0,1,1,4
FLMK,0,0,0,1,1,4
LMKT,0,0,0,1,1,4
MKTV,0,0,0,2,2,4
TVAQ,0,0,0,1,1,4
DPAR,0,0,0,1,1,4
PARA,0,0,0,2,2,4
RALF,0,0,0,1,1,4
ALFA,0,0,0,1,1,4
LFAA,0,0,0,1,1,4
FAAM,0,0,0,1,1,4
AAMS,0,0,0,1,1,4
AMSQ,0,0,0,1,1,4
DPAT,0,0,0,1,1,4
PATV,0,0,0,1,1,4
ATVK,0,0,0,1,1,4
TVKK,0,0,0,1,1,4
KVVN,0,0,0,1,1,4
VVNF,0,0,0,1,1,4
VNFL,0,0,0,2,2,4
DPAW,0,0,0,1,1,4
PAWQ,0,0,0,1,1,4
AWQG,0,0,0,1,1,4
WQGF,0,0,0,1,1,4
QGFR,0,0,0,1,1,4
GFRE,0,0,0,1,1,4
FREL,0,0,0,1,1,4
ELIE,0,0,0,3,3,4
LIEK,0,0,0,1,1,4
IEKA,0,0,0,1,1,4
EKAL,0,0,0,1,1,4
DPEK,0,0,0,1,1,4
PEKV,0,0,0,2,2,4
EKVL,0,0,0,1,1,4
KVLF,0,0,0,1,1,4
VLFL,0,0,0,1,1,4
FLAG,0,0,0,2,2,4
LAGN,0,0,0,1,1,4
GNLL,0,0,0,1,1,4
NLLA,0,0,0,1,1,4
LARL,0,0,0,2,2,4
ARLT,0,0,0,2,2,4
RLTE,0,0,0,1,1,4
DPET,0,0,0,2,2,4
PETL,0,0,0,1,1,4
ETLE,0,0,0,2,2,4
TLEA,0,0,0,1,1,4
LEAI,0,0,0,1,1,4
EAIA,0,0,0,2,2,4
AIAE,0,0,0,3,3,4
IAEN,0,0,0,1,1,4
PETN,0,0,0,1,1,4
ETNI,0,0,0,2,2,4
TNIN,0,0,0,1,1,4
NINI,0,0,0,1,1,4
INIG,0,0,0,1,1,4
NIGT,0,0,0,1,1,4
IGTS,0,0,0,1,1,4
GTSY,0,0,0,1,1,4
TSYL,0,0,0,1,1,4
SYLQ,0,0,0,1,1,4
YLQY,0,0,0,1,1,4
LQYV,0,0,0,1,1,4
QYVY,0,0,0,1,1,4
YVYQ,0,0,0,1,1,4
VYQQ,0,0,0,1,1,4
YQQF,0,0,0,1,1,4
DPKR,0,0,0,1,1,4
PKRL,0,0,0,1,1,4
KRLQ,0,0,0,4,4,4
RLQA,0,0,0,1,1,4
LQAS,0,0,0,1,1,4
SLQT,0,0,0,1,1,4
LQTI,0,0,0,1,1,4
QTIV,0,0,0,1,1,4
TIVG,0,0,0,1,1,4
IVGM,0,0,0,1,1,4
VGMV,0,0,0,2,2,4
GMVV,0,0,0,1,1,4
MVVY,0,0,0,1,1,4
VVYS,0,0,0,1,1,4
VYSW,0,0,0,1,1,4
DPLR,0,0,0,1,1,4
PLRE,0,0,0,1,1,4
LRER,0,0,0,1,1,4
RERQ,0,0,0,1,1,4
ERQV,0,0,0,1,1,4
RQVA,0,0,0,2,2,4
QVAE,0,0,0,2,2,4
VAEK,0,0,0,2,2,4
AEKQ,0,0,0,1,1,4
EKQL,0,0,0,1,1,4
KQLA,0,0,0,2,2,4
QLAA,0,0,0,1,1,4
LAAL,0,0,0,3,3,4
ALGD,0,0,0,2,2,4
LGDI,0,0,0,1,1,4
GDIL,0,0,0,1,1,4
DILS,0,0,0,1,1,4
ILSA,0,0,0,1,1,4
DPLW,0,0,0,1,1,4
PLWK,0,0,0,1,1,4
LWKK,0,0,0,1,1,4
WKKE,0,0,0,1,1,4
KKEM,0,0,0,2,2,4
KEMF,0,0,0,1,1,4
EMFE,0,0,0,1,1,4
MFEK,0,0,0,3,3,4
FEKY,0,0,0,1,1,4
KYLS,0,0,0,1,1,4
YLSN,0,0,0,1,1,4
DPQK,0,0,0,2,2,4
PQKA,0,0,0,1,1,4
QKAD,0,0,0,1,1,4
ADAV,0,0,0,1,1,4
DAVA,0,0,0,1,1,4
AVAV,0,0,0,1,1,4
VAVN,0,0,0,1,1,4
PQKR,0,0,0,1,1,4
QKRA,0,0,0,1,1,4
KRAV,0,0,0,3,3,4
RAVV,0,0,0,1,1,4
AVVN,0,0,0,1,1,4
VVNQ,0,0,0,1,1,4
VNQR,0,0,0,1,1,4
NQRL,0,0,0,1,1,4
QRLY,0,0,0,1,1,4
RLYF,0,0,0,1,1,4
LYFD,0,0,0,1,1,4
YFDM,0,0,0,1,1,4
FDMG,0,0,0,1,1,4
DMGT,0,0,0,1,1,4
DPTK,0,0,0,1,1,4
PTKL,0,0,0,2,2,4
TKLN,0,0,0,1,1,4
KLNH,0,0,0,1,1,4
LNHA,0,0,0,1,1,4
NHAV,0,0,0,1,1,4
HAVA,0,0,0,1,1,4
AVAG,0,0,0,1,1,4
DPYV,0,0,0,1,1,4
PYVI,0,0,0,1,1,4
YVIL,0,0,0,1,1,4
VILI,0,0,0,1,1,4
ILIT,0,0,0,1,1,4
LITE,0,0,0,1,1,4
ITEI,0,0,0,1,1,4
TEIL,0,0,0,1,1,4
EILL,0,0,0,2,2,4
DQDK,0,0,0,1,1,4
QDKI,0,0,0,1,1,4
DKIQ,0,0,0,1,1,4
KIQK,0,0,0,2,2,4
IQKA,0,0,0,1,1,4
QKAI,0,0,0,1,1,4
KAIA,0,0,0,1,1,4
AIAA,0,0,0,4,4,4
IAAG,0,0,0,1,1,4
DQED,0,0,0,1,1,4
QEDV,0,0,0,1,1,4
EDVA,0,0,0,2,2,4
DVAQ,0,0,0,2,2,4
VAQT,0,0,0,1,1,4
AQTI,0,0,0,1,1,4
QTIR,0,0,0,1,1,4
TIRD,0,0,0,1,1,4
IRDY,0,0,0,1,1,4
RDYD,0,0,0,1,1,4
DQGT,0,0,0,1,1,4
QGTL,0,0,0,1,1,4
GTLF,0,0,0,1,1,4
TLFE,0,0,0,1,1,4
LFEL,0,0,0,1,1,4
FELI,0,0,0,1,1,4
ELIL,0,0,0,1,1,4
LILA,0,0,0,1,1,4
ILAA,0,0,0,1,1,4
AANY,0,0,0,1,1,4
ANYL,0,0,0,1,1,4
NYLD,0,0,0,1,1,4
DQHL,0,0,0,1,1,4
QHLM,0,0,0,1,1,4
HLMA,0,0,0,1,1,4
LMAE,0,0,0,1,1,4
MAEY,0,0,0,1,1,4
AEYR,0,0,0,1,1,4
EYRE,0,0,0,1,1,4
YREL,0,0,0,2,2,4
RELP,0,0,0,1,1,4
ELPR,0,0,0,1,1,4
LPRV,0,0,0,1,1,4
PRVF,0,0,0,1,1,4
RVFG,0,0,0,1,1,4
VFGA,0,0,0,1,1,4
FGAV,0,0,0,1,1,4
AVRK,0,0,0,1,1,4
VRKH,0,0,0,2,2,4
RKHV,0,0,0,2,2,4
KHVA,0,0,0,2,2,4
HVAN,0,0,0,1,1,4
VANG,0,0,0,1,1,4
DQNG,0,0,0,1,1,4
QNGE,0,0,0,1,1,4
NGEI,0,0,0,1,1,4
GEIY,0,0,0,1,1,4
EIYM,0,0,0,1,1,4
IYMW,0,0,0,1,1,4
YMWP,0,0,0,1,1,4
MWPV,0,0,0,1,1,4
WPVA,0,0,0,1,1,4
PVAQ,0,0,0,1,1,4
VAQA,0,0,0,1,1,4
DQQG,0,0,0,1,1,4
QQGV,0,0,0,1,1,4
QGVF,0,0,0,2,2,4
GVFV,0,0,0,1,1,4
VFVK,0,0,0,1,1,4
FVKG,0,0,0,1,1,4
VKGY,0,0,0,2,2,4
KGYA,0,0,0,1,1,4
GYAM,0,0,0,1,1,4
DRAS,0,0,0,1,1,4
RASY,0,0,0,1,1,4
ASYE,0,0,0,1,1,4
SYEA,0,0,0,1,1,4
YEAR,0,0,0,1,1,4
EARE,0,0,0,1,1,4
ARER,0,0,0,1,1,4
RERH,0,0,0,1,1,4
ERHV,0,0,0,1,1,4
RHVA,0,0,0,1,1,4
HVAE,0,0,0,2,2,4
VAER,0,0,0,2,2,4
AERL,0,0,0,2,2,4
RLLM,0,0,0,1,1,4
LLMH,0,0,0,1,1,4
LMHL,0,0,0,1,1,4
MHLE,0,0,0,1,1,4
HLEE,0,0,0,2,2,4
LEEM,0,0,0,1,1,4
DRAV,0,0,0,1,1,4
RAVI,0,0,0,1,1,4
AVIE,0,0,0,1,1,4
VIEH,0,0,0,1,1,4
IEHN,0,0,0,1,1,4
EHNL,0,0,0,1,1,4
HNLL,0,0,0,1,1,4
NLLS,0,0,0,1,1,4
LLSA,0,0,0,1,1,4
SASK,0,0,0,1,1,4
ASKL,0,0,0,1,1,4
DRQL,0,0,0,1,1,4
RQLR,0,0,0,1,1,4
QLRS,0,0,0,2,2,4
LRSS,0,0,0,1,1,4
RSSI,0,0,0,1,1,4
SSIE,0,0,0,1,1,4
SIER,0,0,0,2,2,4
IERV,0,0,0,1,1,4
ERVI,0,0,0,1,1,4
RVIS,0,0,0,1,1,4
VISI,0,0,0,1,1,4
ISIF,0,0,0,1,1,4
SIFQ,0,0,0,1,1,4
IFQS,0,0,0,2,2,4
DRTS,0,0,0,1,1,4
RTSF,0,0,0,1,1,4
TSFD,0,0,0,2,2,4
SFDK,0,0,0,1,1,4
FDKL,0,0,0,1,1,4
DKLA,0,0,0,4,4,4
KLAN,0,0,0,1,1,4
LANS,0,0,0,1,1,4
DSEQ,0,0,0,1,1,4
SEQV,0,0,0,1,1,4
EQVV,0,0,0,1,1,4
QVVH,0,0,0,1,1,4
VVHQ,0,0,0,1,1,4
VHQL,0,0,0,1,1,4
HQLE,0,0,0,1,1,4
QLER,0,0,0,2,2,4
LERL,0,0,0,2,2,4
ERLI,0,0,0,4,4,4
RLIA,0,0,0,2,2,4
DSGY,0,0,0,1,1,4
SGYR,0,0,0,1,1,4
GYRS,0,0,0,1,1,4
YRSA,0,0,0,2,2,4
RSAM,0,0,0,1,1,4
SAMS,0,0,0,1,1,4
AMSV,0,0,0,1,1,4
MSVQ,0,0,0,1,1,4
SVQS,0,0,0,1,1,4
VQSS,0,0,0,1,1,4
QSSL,0,0,0,1,1,4
DSMV,0,0,0,1,1,4
SMVV,0,0,0,1,1,4
MVVL,0,0,0,1,1,4
VLQQ,0,0,0,2,2,4
LQQR,0,0,0,1,1,4
QQRA,0,0,0,1,1,4
QRAY,0,0,0,1,1,4
RAYE,0,0,0,1,1,4
AYEI,0,0,0,1,1,4
YEIL,0,0,0,2,2,4
EILM,0,0,0,1,1,4
ILMT,0,0,0,2,2,4
LMTI,0,0,0,1,1,4
MTIM,0,0,0,1,1,4
TIME,0,0,0,1,1,4
DSSV,0,0,0,1,1,4
SSVI,0,0,0,1,1,4
SVII,0,0,0,1,1,4
VIIS,0,0,0,1,1,4
IISA,0,0,0,1,1,4
ISAL,0,0,0,1,1,4
ALKT,0,0,0,1,1,4
LKTY,0,0,0,1,1,4
KTYL,0,0,0,1,1,4
TYLV,0,0,0,1,1,4
YLVS,0,0,0,1,1,4
LVSG,0,0,0,1,1,4
DSVA,0,0,0,1,1,4
SVAS,0,0,0,1,1,4
VASL,0,0,0,2,2,4
ASLL,0,0,0,1,1,4
SLLD,0,0,0,1,1,4
LLDV,0,0,0,1,1,4
LDVV,0,0,0,1,1,4
DVVK,0,0,0,1,1,4
VVKS,0,0,0,1,1,4
VKST,0,0,0,1,1,4
KSTG,0,0,0,1,1,4
DSVT,0,0,0,1,1,4
SVTN,0,0,0,1,1,4
VTND,0,0,0,1,1,4
TNDI,0,0,0,1,1,4
NDIF,0,0,0,1,1,4
DIFN,0,0,0,2,2,4
IFNV,0,0,0,1,1,4
FNVA,0,0,0,1,1,4
NVAK,0,0,0,1,1,4
VAKA,0,0,0,1,1,4
KASI,0,0,0,2,2,4
ASIE,0,0,0,1,1,4
SIEK,0,0,0,1,1,4
IEKH,0,0,0,1,1,4
EKHI,0,0,0,1,1,4
KHIW,0,0,0,1,1,4
HIWM,0,0,0,1,1,4
IWML,0,0,0,1,1,4
WMLQ,0,0,0,1,1,4
MLQA,0,0,0,2,2,4
LQAE,0,0,0,1,1,4
QAEL,0,0,0,1,1,4
DTAF,0,0,0,1,1,4
TAFL,0,0,0,1,1,4
AFLM,0,0,0,1,1,4
FLME,0,0,0,1,1,4
LMEQ,0,0,0,1,1,4
MEQL,0,0,0,1,1,4
EQLE,0,0,0,2,2,4
QLEL,0,0,0,1,1,4
LELR,0,0,0,1,1,4
ELRE,0,0,0,2,2,4
LREE,0,0,0,1,1,4
EELD,0,0,0,1,1,4
ELDE,0,0,0,2,2,4
LDEI,0,0,0,1,1,4
DEIE,0,0,0,2,2,4
EIEQ,0,0,0,1,1,4
IEQA,0,0,0,3,3,4
EQAK,0,0,0,2,2,4
DTMK,0,0,0,1,1,4
TMKD,0,0,0,1,1,4
MKDA,0,0,0,1,1,4
KDAG,0,0,0,1,1,4
DAGM,0,0,0,1,1,4
AGMQ,0,0,0,1,1,4
GMQM,0,0,0,1,1,4
MQMK,0,0,0,1,1,4
QMKK,0,0,0,1,1,4
MKKV,0,0,0,1,1,4
KVLD,0,0,0,1,1,4
VLDS,0,0,0,1,1,4
DTRA,0,0,0,1,1,4
TRAW,0,0,0,1,1,4
RAWA,0,0,0,1,1,4
AWAL,0,0,0,2,2,4
LAEK,0,0,0,2,2,4
AEKL,0,0,0,3,3,4
EKLF,0,0,0,2,2,4
KLFG,0,0,0,1,1,4
DVAL,0,0,0,1,1,4
ALAD,0,0,0,1,1,4
LADS,0,0,0,1,1,4
ADSF,0,0,0,1,1,4
DSFD,0,0,0,1,1,4
SFDA,0,0,0,1,1,4
FDAL,0,0,0,1,1,4
DVEA,0,0,0,1,1,4
VEAV,0,0,0,1,1,4
EAVE,0,0,0,3,3,4
AVEI,0,0,0,3,3,4
VEIM,0,0,0,1,1,4
EIMQ,0,0,0,1,1,4
IMQR,0,0,0,1,1,4
MQRI,0,0,0,1,1,4
QRIH,0,0,0,1,1,4
RIHV,0,0,0,1,1,4
IHVL,0,0,0,1,1,4
HVLR,0,0,0,1,1,4
VLRS,0,0,0,1,1,4
LRSQ,0,0,0,1,1,4
RSQG,0,0,0,1,1,4
SQGG,0,0,0,1,1,4
QGGF,0,0,0,1,1,4
GGFN,0,0,0,1,1,4
DVLA,0,0,0,2,2,4
VLAE,0,0,0,2,2,4
LAED,0,0,0,2,2,4
AEDT,0,0,0,1,1,4
EDTI,0,0,0,1,1,4
DTIT,0,0,0,1,1,4
TITA,0,0,0,1,1,4
ITAL,0,0,0,1,1,4
TALL,0,0,0,1,1,4
ALLH,0,0,0,1,1,4
DVRV,0,0,0,1,1,4
VRVK,0,0,0,1,1,4
RVKE,0,0,0,2,2,4
VKEY,0,0,0,1,1,4
KEYF,0,0,0,1,1,4
EYFD,0,0,0,1,1,4
YFDD,0,0,0,1,1,4
FDDI,0,0,0,1,1,4
DDIA,0,0,0,1,1,4
DIAR,0,0,0,1,1,4
IARY,0,0,0,1,1,4
ARYF,0,0,0,1,1,4
RYFS,0,0,0,1,1,4
YFSI,0,0,0,1,1,4
FSIG,0,0,0,1,1,4
SIGL,0,0,0,2,2,4
IGLL,0,0,0,1,1,4
GLLN,0,0,0,1,1,4
LLNL,0,0,0,1,1,4
LNLI,0,0,0,1,1,4
NLIH,0,0,0,1,1,4
LIHL,0,0,0,2,2,4
IHLF,0,0,0,1,1,4
HLFG,0,0,0,1,1,4
DWGE,0,0,0,1,1,4
WGEA,0,0,0,1,1,4
GEAF,0,0,0,1,1,4
EAFT,0,0,0,1,1,4
AFTA,0,0,0,1,1,4
FTAI,0,0,0,1,1,4
TAIN,0,0,0,1,1,4
AINL,0,0,0,1,1,4
DWLK,0,0,0,1,1,4
WLKR,0,0,0,1,1,4
RLQK,0,0,0,1,1,4
LQKI,0,0,0,1,1,4
QKIF,0,0,0,1,1,4
KIFP,0,0,0,1,1,4
IFPP,0,0,0,1,1,4
FPPI,0,0,0,1,1,4
PPIL,0,0,0,1,1,4
PILS,0,0,0,1,1,4
ILSI,0,0,0,1,1,4
DWYR,0,0,0,1,1,4
WYRT,0,0,0,1,1,4
YRTY,0,0,0,1,1,4
RTYA,0,0,0,1,1,4
TYAE,0,0,0,1,1,4
YAEL,0,0,0,1,1,4
AELR,0,0,0,1,1,4
LRET,0,0,0,1,1,4
RETA,0,0,0,1,1,4
DYER,0,0,0,1,1,4
YERF,0,0,0,1,1,4
ERFK,0,0,0,1,1,4
RFKS,0,0,0,1,1,4
FKSY,0,0,0,1,1,4
KSYI,0,0,0,2,2,4
SYIQ,0,0,0,1,1,4
YIQT,0,0,0,1,1,4
IQTL,0,0,0,2,2,4
ALVH,0,0,0,1,1,4
LVHK,0,0,0,2,2,4
VHKL,0,0,0,2,2,4
HKLT,0,0,0,1,1,4
KLTE,0,0,0,1,1,4
LTER,0,0,0,1,1,4
TERM,0,0,0,1,1,4
EAQK,0,0,0,1,1,4
AQKI,0,0,0,1,1,4
QKID,0,0,0,1,1,4
KIDR,0,0,0,1,1,4
IDRL,0,0,0,1,1,4
DRLV,0,0,0,1,1,4
RLVQ,0,0,0,1,1,4
LVQS,0,0,0,1,1,4
VQSF,0,0,0,1,1,4
QSFS,0,0,0,1,1,4
SFSG,0,0,0,1,1,4
FSGA,0,0,0,1,1,4
SGAY,0,0,0,1,1,4
GAYF,0,0,0,1,1,4
AYFQ,0,0,0,1,1,4
YFQQ,0,0,0,1,1,4
FQQN,0,0,0,1,1,4
EDDI,0,0,0,1,1,4
DDIM,0,0,0,1,1,4
DIMY,0,0,0,1,1,4
IMYL,0,0,0,1,1,4
MYLM,0,0,0,1,1,4
EDDS,0,0,0,1,1,4
DDSK,0,0,0,1,1,4
DSKL,0,0,0,1,1,4
SKLA,0,0,0,1,1,4
KLAS,0,0,0,1,1,4
ASRK,0,0,0,2,2,4
SRKY,0,0,0,1,1,4
RKYA,0,0,0,1,1,4
KYAR,0,0,0,1,1,4
YARI,0,0,0,1,1,4
ARII,0,0,0,1,1,4
RIIQ,0,0,0,1,1,4
IIQK,0,0,0,1,1,4
IQKI,0,0,0,1,1,4
EDKE,0,0,0,1,1,4
DKEA,0,0,0,1,1,4
KEAV,0,0,0,2,2,4
EAVF,0,0,0,1,1,4
AVFD,0,0,0,2,2,4
VFDV,0,0,0,1,1,4
FDVV,0,0,0,1,1,4
DVVD,0,0,0,1,1,4
VVDT,0,0,0,1,1,4
DTLT,0,0,0,1,1,4
TLTA,0,0,0,1,1,4
LTAV,0,0,0,1,1,4
TAVL,0,0,0,1,1,4
AVLQ,0,0,0,1,1,4
VLQV,0,0,0,2,2,4
QVAT,0,0,0,1,1,4
VATG,0,0,0,2,2,4
ATGV,0,0,0,1,1,4
TGVI,0,0,0,1,1,4
GVIS,0,0,0,1,1,4
VIST,0,0,0,2,2,4
ISTL,0,0,0,1,1,4
EDLP,0,0,0,1,1,4
DLPK,0,0,0,1,1,4
PKWS,0,0,0,1,1,4
KWSG,0,0,0,1,1,4
WSGY,0,0,0,1,1,4
SGYF,0,0,0,1,1,4
GYFE,0,0,0,1,1,4
YFEK,0,0,0,1,1,4
FEKL,0,0,0,2,2,4
EKLL,0,0,0,3,3,4
LKKN,0,0,0,1,1,4
EDMI,0,0,0,1,1,4
DMIF,0,0,0,1,1,4
MIFE,0,0,0,1,1,4
IFEI,0,0,0,1,1,4
FEIF,0,0,0,1,1,4
IFKN,0,0,0,1,1,4
FKNY,0,0,0,1,1,4
KNYL,0,0,0,1,1,4
NYLT,0,0,0,1,1,4
YLTK,0,0,0,1,1,4
LTKV,0,0,0,1,1,4
TKVA,0,0,0,1,1,4
KVAY,0,0,0,1,1,4
VAYY,0,0,0,2,2,4
AYYA,0,0,0,1,1,4
YYAR,0,0,0,1,1,4
YARQ,0,0,0,1,1,4
ARQV,0,0,0,1,1,4
VAEM,0,0,0,1,1,4
AEMN,0,0,0,1,1,4
EDNL,0,0,0,1,1,4
DNLL,0,0,0,1,1,4
NLLR,0,0,0,1,1,4
LLRQ,0,0,0,1,1,4
LRQL,0,0,0,2,2,4
RQLA,0,0,0,1,1,4
QLAQ,0,0,0,2,2,4
LAQK,0,0,0,1,1,4
AQKV,0,0,0,1,1,4
EELH,0,0,0,1,1,4
ELHT,0,0,0,1,1,4
LHTS,0,0,0,1,1,4
HTSL,0,0,0,1,1,4
TSLV,0,0,0,1,1,4
SLVE,0,0,0,2,2,4
LVEE,0,0,0,2,2,4
VEEL,0,0,0,2,2,4
EEMI,0,0,0,1,1,4
EMIA,0,0,0,1,1,4
MIAE,0,0,0,1,1,4
IAEF,0,0,0,1,1,4
AEFK,0,0,0,1,1,4
EFKA,0,0,0,1,1,4
FKAA,0,0,0,1,1,4
KAAF,0,0,0,1,1,4
AAFD,0,0,0,1,1,4
AFDM,0,0,0,1,1,4
FDMF,0,0,0,1,1,4
EERV,0,0,0,1,1,4
ERVK,0,0,0,2,2,4
RVKN,0,0,0,1,1,4
VKNG,0,0,0,1,1,4
KNGL,0,0,0,1,1,4
NGLE,0,0,0,2,2,4
GLER,0,0,0,1,1,4
ERLK,0,0,0,1,1,4
RLKK,0,0,0,1,1,4
KKAI,0,0,0,1,1,4
KAIK,0,0,0,1,1,4
AIKS,0,0,0,1,1,4
IKSG,0,0,0,1,1,4
KSGK,0,0,0,1,1,4
SGKQ,0,0,0,1,1,4
GKQS,0,0,0,1,1,4
KQST,0,0,0,1,1,4
EESD,0,0,0,1,1,4
ESDI,0,0,0,1,1,4
SDIK,0,0,0,3,3,4
DIKY,0,0,0,2,2,4
IKYK,0,0,0,1,1,4
KYKT,0,0,0,1,1,4
YKTS,0,0,0,1,1,4
KTSK,0,0,0,1,1,4
TSKN,0,0,0,1,1,4
SKNF,0,0,0,1,1,4
KNFI,0,0,0,1,1,4
NFIN,0,0,0,1,1,4
FINK,0,0,0,1,1,4
INKV,0,0,0,1,1,4
NKVY,0,0,0,1,1,4
EEVK,0,0,0,2,2,4
EVKK,0,0,0,4,4,4
VKKH,0,0,0,2,2,4
KKHG,0,0,0,1,1,4
KHGT,0,0,0,1,1,4
HGTT,0,0,0,1,1,4
TTVL,0,0,0,1,1,4
TVLT,0,0,0,1,1,4
VLTA,0,0,0,1,1,4
LTAL,0,0,0,1,1,4
TALG,0,0,0,1,1,4
ALGR,0,0,0,1,1,4
LGRI,0,0,0,1,1,4
GRIL,0,0,0,1,1,4
RILK,0,0,0,2,2,4
ILKQ,0,0,0,3,3,4
EFPE,0,0,0,1,1,4
FPEM,0,0,0,1,1,4
PEML,0,0,0,2,2,4
EMLA,0,0,0,1,1,4
MLAE,0,0,0,1,1,4
LAEI,0,0,0,1,1,4
AEII,0,0,0,1,1,4
EIIT,0,0,0,1,1,4
EFRD,0,0,0,1,1,4
FRDL,0,0,0,1,1,4
RDLH,0,0,0,1,1,4
DLHL,0,0,0,1,1,4
LHLF,0,0,0,1,1,4
HLFL,0,0,0,1,1,4
LFLG,0,0,0,1,1,4
FLGE,0,0,0,2,2,4
GEAA,0,0,0,1,1,4
EAAE,0,0,0,4,4,4
AAET,0,0,0,3,3,4
AETA,0,0,0,1,1,4
ETAE,0,0,0,1,1,4
TAEE,0,0,0,1,1,4
AEEV,0,0,0,1,1,4
EEVA,0,0,0,1,1,4
EVAD,0,0,0,1,1,4
VADE,0,0,0,1,1,4
ADEL,0,0,0,2,2,4
DELA,0,0,0,3,3,4
LAER,0,0,0,1,1,4
AERV,0,0,0,1,1,4
ERVQ,0,0,0,1,1,4
RVQA,0,0,0,1,1,4
VQAL,0,0,0,1,1,4
EGDQ,0,0,0,1,1,4
GDQQ,0,0,0,1,1,4
DQQL,0,0,0,1,1,4
QQLL,0,0,0,2,2,4
QLLK,0,0,0,2,2,4
LLKR,0,0,0,1,1,4
LKRV,0,0,0,2,2,4
KRVL,0,0,0,1,1,4
RVLV,0,0,0,1,1,4
VLVR,0,0,0,1,1,4
LVRK,0,0,0,1,1,4
VRKL,0,0,0,1,1,4
EGHV,0,0,0,1,1,4
GHVA,0,0,0,1,1,4
HVAA,0,0,0,1,1,4
AAVE,0,0,0,2,2,4
AVEV,0,0,0,1,1,4
VEVL,0,0,0,1,1,4
EVLR,0,0,0,2,2,4
VLRG,0,0,0,2,2,4
LRGI,0,0,0,1,1,4
RGIH,0,0,0,1,1,4
GIHR,0,0,0,1,1,4
IHRI,0,0,0,1,1,4
HRIA,0,0,0,1,1,4
RIAD,0,0,0,1,1,4
IADM,0,0,0,1,1,4
ADMS,0,0,0,1,1,4
EGKD,0,0,0,1,1,4
GKDR,0,0,0,1,1,4
KDRE,0,0,0,1,1,4
DREL,0,0,0,1,1,4
RELY,0,0,0,1,1,4
ELYG,0,0,0,2,2,4
LYGK,0,0,0,2,2,4
YGKL,0,0,0,1,1,4
GKLH,0,0,0,1,1,4
KLHE,0,0,0,1,1,4
LHET,0,0,0,1,1,4
HETL,0,0,0,1,1,4
ETLK,0,0,0,2,2,4
LKKV,0,0,0,3,3,4
KKVT,0,0,0,1,1,4
KVTE,0,0,0,1,1,4
VTED,0,0,0,1,1,4
TEDL,0,0,0,1,1,4
EDLE,0,0,0,1,1,4
EGNK,0,0,0,1,1,4
GNKR,0,0,0,1,1,4
NKRL,0,0,0,1,1,4
RLDS,0,0,0,1,1,4
LDSV,0,0,0,1,1,4
DSVN,0,0,0,2,2,4
SVNS,0,0,0,2,2,4
VNSI,0,0,0,1,1,4
NSIV,0,0,0,1,1,4
SIVS,0,0,0,1,1,4
EGQQ,0,0,0,1,1,4
GQQR,0,0,0,1,1,4
QQRR,0,0,0,1,1,4
QRRI,0,0,0,4,4,4
RRIR,0,0,0,2,2,4
RIRQ,0,0,0,1,1,4
IRQQ,0,0,0,1,1,4
RQQR,0,0,0,1,1,4
QQRL,0,0,0,1,1,4
QRLI,0,0,0,1,1,4
RLIS,0,0,0,1,1,4
LISI,0,0,0,1,1,4
ISIG,0,0,0,1,1,4
SIGK,0,0,0,1,1,4
IGKW,0,0,0,1,1,4
GKWI,0,0,0,1,1,4
KWIA,0,0,0,2,2,4
WIAD,0,0,0,1,1,4
IADN,0,0,0,1,1,4
ADNQ,0,0,0,1,1,4
GVAW,0,0,0,1,1,4
VAWL,0,0,0,1,1,4
AWLE,0,0,0,1,1,4
WLEA,0,0,0,1,1,4
LEAV,0,0,0,1,1,4
EAVL,0,0,0,2,2,4
LRLL,0,0,0,1,1,4
RLLA,0,0,0,2,2,4
LLAQ,0,0,0,2,2,4
EHEI,0,0,0,1,1,4
HEIQ,0,0,0,1,1,4
EIQE,0,0,0,1,1,4
IQEW,0,0,0,1,1,4
QEWY,0,0,0,1,1,4
EWYK,0,0,0,1,1,4
WYKG,0,0,0,1,1,4
YKGF,0,0,0,1,1,4
KGFL,0,0,0,2,2,4
GFLR,0,0,0,1,1,4
FLRD,0,0,0,1,1,4
EIEK,0,0,0,1,1,4
IEKF,0,0,0,1,1,4
EKFR,0,0,0,1,1,4
KFRV,0,0,0,1,1,4
FRVW,0,0,0,1,1,4
RVWI,0,0,0,1,1,4
VWIS,0,0,0,1,1,4
WISI,0,0,0,1,1,4
ISIL,0,0,0,1,1,4
EISE,0,0,0,1,1,4
ISEM,0,0,0,1,1,4
SEMV,0,0,0,1,1,4
MVRM,0,0,0,1,1,4
VRMR,0,0,0,1,1,4
RMRE,0,0,0,1,1,4
MRER,0,0,0,1,1,4
RERI,0,0,0,2,2,4
ERIL,0,0,0,1,1,4
RILD,0,0,0,1,1,4
ILDS,0,0,0,1,1,4
DSIH,0,0,0,1,1,4
SIHL,0,0,0,1,1,4
IHLG,0,0,0,1,1,4
EISK,0,0,0,1,1,4
ISKL,0,0,0,2,2,4
SKLV,0,0,0,1,1,4
VKKM,0,0,0,1,1,4
KKMI,0,0,0,1,1,4
KMIS,0,0,0,1,1,4
MISS,0,0,0,1,1,4
ISSW,0,0,0,1,1,4
SSWK,0,0,0,1,1,4
SWKD,0,0,0,1,1,4
WKDA,0,0,0,1,1,4
KDAI,0,0,0,1,1,4
DAIN,0,0,0,1,1,4
EKET,0,0,0,1,1,4
KETF,0,0,0,1,1,4
ETFR,0,0,0,1,1,4
TFRE,0,0,0,1,1,4
FREK,0,0,0,1,1,4
REKF,0,0,0,1,1,4
EKFM,0,0,0,1,1,4
KFMQ,0,0,0,1,1,4
FMQH,0,0,0,1,1,4
EKNS,0,0,0,1,1,4
KNSY,0,0,0,1,1,4
NSYR,0,0,0,1,1,4
SYRK,0,0,0,1,1,4
YRKL,0,0,0,1,1,4
RKLV,0,0,0,1,1,4
KLVG,0,0,0,1,1,4
LVGN,0,0,0,1,1,4
VGNL,0,0,0,1,1,4
GNLY,0,0,0,1,1,4
NLYF,0,0,0,1,1,4
LYFV,0,0,0,1,1,4
YFVY,0,0,0,1,1,4
FVYS,0,0,0,1,1,4
VYSA,0,0,0,1,1,4
YSAM,0,0,0,1,1,4
SAME,0,0,0,1,1,4
AMEE,0,0,0,1,1,4
MEEE,0,0,0,1,1,4
EEEM,0,0,0,2,2,4
EEMA,0,0,0,1,1,4
EMAK,0,0,0,2,2,4
MAKF,0,0,0,1,1,4
EKVQ,0,0,0,1,1,4
KVQY,0,0,0,1,1,4
VQYL,0,0,0,1,1,4
QYLT,0,0,0,1,1,4
YLTR,0,0,0,1,1,4
LTRS,0,0,0,1,1,4
TRSA,0,0,0,1,1,4
SAIR,0,0,0,2,2,4
AIRR,0,0,0,1,1,4
EMNY,0,0,0,1,1,4
MNYY,0,0,0,1,1,4
NYYT,0,0,0,1,1,4
YYTV,0,0,0,1,1,4
YTVL,0,0,0,1,1,4
TVLF,0,0,0,1,1,4
VLFG,0,0,0,1,1,4
LFGV,0,0,0,1,1,4
FGVS,0,0,0,1,1,4
GVSR,0,0,0,1,1,4
VSRA,0,0,0,2,2,4
SRAL,0,0,0,2,2,4
RALG,0,0,0,3,3,4
ALGV,0,0,0,2,2,4
GVLA,0,0,0,1,1,4
VLAQ,0,0,0,1,1,4
LAQL,0,0,0,2,2,4
AQLI,0,0,0,2,2,4
QLIW,0,0,0,1,1,4
LIWS,0,0,0,1,1,4
IWSR,0,0,0,1,1,4
WSRA,0,0,0,1,1,4
EPEE,0,0,0,1,1,4
PEEV,0,0,0,3,3,4
EEVF,0,0,0,1,1,4
EVFK,0,0,0,1,1,4
VFKS,0,0,0,1,1,4
FKSV,0,0,0,2,2,4
KSVL,0,0,0,2,2,4
SVLK,0,0,0,1,1,4
VLKE,0,0,0,2,2,4
LKEM,0,0,0,1,1,4
KEME,0,0,0,1,1,4
EMEG,0,0,0,1,1,4
EPEK,0,0,0,1,1,4
EKVD,0,0,0,1,1,4
KVDK,0,0,0,1,1,4
VDKL,0,0,0,2,2,4
DKLQ,0,0,0,1,1,4
KLQE,0,0,0,3,3,4
LQEP,0,0,0,1,1,4
QEPL,0,0,0,1,1,4
EPLL,0,0,0,1,1,4
PLLE,0,0,0,1,1,4
LLEA,0,0,0,2,2,4
LEAL,0,0,0,5,5,4
EALR,0,0,0,3,3,4
ALRL,0,0,0,3,3,4
LRLY,0,0,0,1,1,4
RLYA,0,0,0,1,1,4
LYAR,0,0,0,1,1,4
YARR,0,0,0,1,1,4
ARRR,0,0,0,1,1,4
EPGQ,0,0,0,1,1,4
PGQR,0,0,0,1,1,4
GQRK,0,0,0,2,2,4
QRKI,0,0,0,1,1,4
RKIV,0,0,0,1,1,4
KIVM,0,0,0,1,1,4
IVMH,0,0,0,1,1,4
VMHK,0,0,0,1,1,4
EQEI,0,0,0,1,1,4
QEIL,0,0,0,1,1,4
EILR,0,0,0,2,2,4
ILRQ,0,0,0,1,1,4
LRQV,0,0,0,1,1,4
RQVK,0,0,0,1,1,4
QVKK,0,0,0,1,1,4
VKKA,0,0,0,1,1,4
KKAY,0,0,0,1,1,4
KAYD,0,0,0,1,1,4
AYDR,0,0,0,1,1,4
YDRA,0,0,0,1,1,4
DRAA,0,0,0,1,1,4
RAAR,0,0,0,1,1,4
ARLG,0,0,0,1,1,4
EQEV,0,0,0,1,1,4
QEVY,0,0,0,1,1,4
EVYA,0,0,0,2,2,4
VYAQ,0,0,0,1,1,4
YAQV,0,0,0,1,1,4
AQVA,0,0,0,2,2,4
VARL,0,0,0,1,1,4
EQPS,0,0,0,1,1,4
QPSL,0,0,0,1,1,4
PSLV,0,0,0,1,1,4
SLVR,0,0,0,1,1,4
LVRT,0,0,0,1,1,4
VRTL,0,0,0,2,2,4
RTLD,0,0,0,1,1,4
TLDQ,0,0,0,2,2,4
LDQL,0,0,0,3,3,4
DQLE,0,0,0,1,1,4
QLED,0,0,0,2,2,4
LEDK,0,0,0,1,1,4
ERQE,0,0,0,1,1,4
RQEV,0,0,0,1,1,4
QEVK,0,0,0,1,1,4
EVKQ,0,0,0,1,1,4
VKQM,0,0,0,1,1,4
KQMV,0,0,0,1,1,4
QMVV,0,0,0,1,1,4
MVVA,0,0,0,1,1,4
VVAT,0,0,0,2,2,4
TLAE,0,0,0,1,1,4
LAES,0,0,0,1,1,4
ERVR,0,0,0,1,1,4
VRAA,0,0,0,1,1,4
RAAM,0,0,0,3,3,4
AAME,0,0,0,1,1,4
AMEK,0,0,0,1,1,4
MEKL,0,0,0,3,3,4
EKLA,0,0,0,1,1,4
SLYE,0,0,0,1,1,4
LYES,0,0,0,1,1,4
YESI,0,0,0,1,1,4
SIRR,0,0,0,1,1,4
RRRY,0,0,0,1,1,4
RRYE,0,0,0,1,1,4
RYEE,0,0,0,1,1,4
YEEL,0,0,0,1,1,4
ESPV,0,0,0,1,1,4
SPVR,0,0,0,1,1,4
PVRK,0,0,0,1,1,4
VRKI,0,0,0,1,1,4
RKIL,0,0,0,1,1,4
KILR,0,0,0,1,1,4
ILRI,0,0,0,1,1,4
LRIV,0,0,0,1,1,4
RIVF,0,0,0,2,2,4
IVFH,0,0,0,1,1,4
FHDA,0,0,0,1,1,4
HDAI,0,0,0,2,2,4
TNIR,0,0,0,1,1,4
NIRV,0,0,0,1,1,4
IRVA,0,0,0,1,1,4
RVAL,0,0,0,1,1,4
VALE,0,0,0,1,1,4
ALEK,0,0,0,3,3,4
LEKS,0,0,0,1,1,4
EKSF,0,0,0,1,1,4
EVKR,0,0,0,2,2,4
VKRR,0,0,0,1,1,4
KRRF,0,0,0,1,1,4
RFPT,0,0,0,1,1,4
FPTK,0,0,0,1,1,4
TKLG,0,0,0,1,1,4
KLGA,0,0,0,2,2,4
LGAW,0,0,0,1,1,4
GAWA,0,0,0,1,1,4
WALI,0,0,0,1,1,4
ALIW,0,0,0,1,1,4
LIWW,0,0,0,1,1,4
IWWL,0,0,0,1,1,4
VKRS,0,0,0,1,1,4
KRSV,0,0,0,1,1,4
RSVN,0,0,0,1,1,4
SVNR,0,0,0,1,1,4
VNRD,0,0,0,1,1,4
NRDF,0,0,0,1,1,4
RDFA,0,0,0,1,1,4
DFAK,0,0,0,1,1,4
FAKW,0,0,0,1,1,4
AKWF,0,0,0,1,1,4
KWFL,0,0,0,1,1,4
WFLI,0,0,0,1,1,4
FLIV,0,0,0,1,1,4
LIVF,0,0,0,2,2,4
IVFI,0,0,0,2,2,4
EVNR,0,0,0,3,3,4
VNRN,0,0,0,1,1,4
NRNF,0,0,0,1,1,4
RNFG,0,0,0,1,1,4
NFGE,0,0,0,1,1,4
FGER,0,0,0,1,1,4
GERI,0,0,0,1,1,4
RIND,0,0,0,1,1,4
INDL,0,0,0,1,1,4
NDLR,0,0,0,1,1,4
DLRI,0,0,0,1,1,4
LRIL,0,0,0,2,2,4
RILI,0,0,0,2,2,4
ILIL,0,0,0,1,1,4
LILL,0,0,0,1,1,4
ILLL,0,0,0,2,2,4
EVVG,0,0,0,1,1,4
VVGR,0,0,0,1,1,4
VGRV,0,0,0,1,1,4
GRVS,0,0,0,1,1,4
RVSK,0,0,0,1,1,4
VSKL,0,0,0,1,1,4
SKLW,0,0,0,1,1,4
KLWN,0,0,0,1,1,4
LWNE,0,0,0,1,1,4
WNEW,0,0,0,1,1,4
NEWW,0,0,0,1,1,4
EWWL,0,0,0,1,1,4
WWLI,0,0,0,1,1,4
WLIV,0,0,0,1,1,4
EWQT,0,0,0,1,1,4
WQTM,0,0,0,1,1,4
QTMV,0,0,0,1,1,4
TMVA,0,0,0,1,1,4
MVAA,0,0,0,2,2,4
VAAL,0,0,0,2,2,4
AALQ,0,0,0,1,1,4
ALQA,0,0,0,1,1,4
EYKY,0,0,0,1,1,4
YKYY,0,0,0,1,1,4
KYYK,0,0,0,1,1,4
YYKL,0,0,0,1,1,4
YKLK,0,0,0,1,1,4
KLAE,0,0,0,3,3,4
LAEM,0,0,0,1,1,4
AEMQ,0,0,0,1,1,4
EMQR,0,0,0,1,1,4
FADL,0,0,0,2,2,4
ADLF,0,0,0,2,2,4
DLFD,0,0,0,1,1,4
LFDP,0,0,0,1,1,4
FDPV,0,0,0,1,1,4
DPVI,0,0,0,1,1,4
PVIQ,0,0,0,1,1,4
VIQE,0,0,0,1,1,4
IQER,0,0,0,1,1,4
QERH,0,0,0,1,1,4
FALR,0,0,0,1,1,4
LRLR,0,0,0,1,1,4
RLRR,0,0,0,1,1,4
RRVI,0,0,0,1,1,4
RVIN,0,0,0,1,1,4
VINR,0,0,0,1,1,4
INRI,0,0,0,1,1,4
NRIG,0,0,0,1,1,4
RIGQ,0,0,0,1,1,4
IGQA,0,0,0,1,1,4
GQAW,0,0,0,1,1,4
QAWR,0,0,0,1,1,4
FEVI,0,0,0,1,1,4
EVID,0,0,0,1,1,4
VIDT,0,0,0,1,1,4
IDTI,0,0,0,1,1,4
DTIK,0,0,0,1,1,4
TIKA,0,0,0,2,2,4
IKAA,0,0,0,3,3,4
KAAV,0,0,0,1,1,4
AVEN,0,0,0,1,1,4
VENA,0,0,0,1,1,4
FFSF,0,0,0,1,1,4
FSFE,0,0,0,1,1,4
SFEL,0,0,0,1,1,4
FELV,0,0,0,1,1,4
ELVE,0,0,0,1,1,4
LVES,0,0,0,1,1,4
VESI,0,0,0,1,1,4
ESIN,0,0,0,2,2,4
SIND,0,0,0,1,1,4
INDV,0,0,0,1,1,4
NDVK,0,0,0,1,1,4
DVKK,0,0,0,1,1,4
VKKS,0,0,0,3,3,4
KSLR,0,0,0,1,1,4
FGLK,0,0,0,1,1,4
GLKV,0,0,0,1,1,4
KVLG,0,0,0,3,3,4
VLGW,0,0,0,1,1,4
LGWY,0,0,0,1,1,4
GWYS,0,0,0,1,1,4
WYSE,0,0,0,1,1,4
YSEM,0,0,0,1,1,4
SEMK,0,0,0,1,1,4
EMKR,0,0,0,1,1,4
MKRN,0,0,0,1,1,4
KRNV,0,0,0,2,2,4
RNVQ,0,0,0,1,1,4
NVQR,0,0,0,1,1,4
VQRL,0,0,0,1,1,4
QRLE,0,0,0,1,1,4
LERA,0,0,0,3,3,4
ERAI,0,0,0,2,2,4
RAIE,0,0,0,1,1,4
AIEE,0,0,0,2,2,4
IEEV,0,0,0,1,1,4
FHSV,0,0,0,1,1,4
HSVA,0,0,0,1,1,4
SVAE,0,0,0,1,1,4
VAEQ,0,0,0,1,1,4
AEQF,0,0,0,1,1,4
FIAV,0,0,0,1,1,4
IAVH,0,0,0,2,2,4
AVHE,0,0,0,2,2,4
VHEM,0,0,0,1,1,4
HEML,0,0,0,1,1,4
EMLD,0,0,0,1,1,4
MLDG,0,0,0,1,1,4
LDGF,0,0,0,1,1,4
DGFR,0,0,0,1,1,4
GFRT,0,0,0,1,1,4
FRTA,0,0,0,1,1,4
TALI,0,0,0,1,1,4
ALID,0,0,0,2,2,4
LIDH,0,0,0,1,1,4
IDHL,0,0,0,1,1,4
DHLD,0,0,0,1,1,4
HLDT,0,0,0,1,1,4
LDTM,0,0,0,1,1,4
DTMA,0,0,0,1,1,4
TMAE,0,0,0,1,1,4
MAER,0,0,0,1,1,4
AERA,0,0,0,2,2,4
ERAV,0,0,0,1,1,4
RAVQ,0,0,0,1,1,4
FKAT,0,0,0,1,1,4
KATI,0,0,0,1,1,4
ATIA,0,0,0,1,1,4
TIAD,0,0,0,1,1,4
IADL,0,0,0,1,1,4
ADLS,0,0,0,1,1,4
DLSK,0,0,0,1,1,4
LSKK,0,0,0,1,1,4
SKKR,0,0,0,2,2,4
FKEA,0,0,0,1,1,4
KEAI,0,0,0,2,2,4
AESA,0,0,0,1,1,4
FKGK,0,0,0,1,1,4
KGKI,0,0,0,1,1,4
GKII,0,0,0,2,2,4
KVIS,0,0,0,1,1,4
ISTG,0,0,0,1,1,4
STGA,0,0,0,1,1,4
TGAK,0,0,0,1,1,4
GAKL,0,0,0,1,1,4
AKLI,0,0,0,1,1,4
FKSI,0,0,0,1,1,4
KSIY,0,0,0,1,1,4
SIYR,0,0,0,3,3,4
IYRF,0,0,0,1,1,4
YRFF,0,0,0,1,1,4
RFFE,0,0,0,2,2,4
FFEH,0,0,0,1,1,4
FEHG,0,0,0,1,1,4
EHGL,0,0,0,1,1,4
HGLK,0,0,0,1,1,4
KSVQ,0,0,0,1,1,4
SVQN,0,0,0,1,1,4
VQNS,0,0,0,1,1,4
QNSL,0,0,0,1,1,4
NSLQ,0,0,0,1,1,4
SLQR,0,0,0,1,1,4
LQRI,0,0,0,1,1,4
QRIL,0,0,0,1,1,4
RILY,0,0,0,1,1,4
ILYL,0,0,0,2,2,4
LYLW,0,0,0,1,1,4
YLWA,0,0,0,1,1,4
LWAI,0,0,0,2,2,4
WAIR,0,0,0,1,1,4
AIRH,0,0,0,1,1,4
FLDQ,0,0,0,1,1,4
LDQN,0,0,0,1,1,4
DQNM,0,0,0,1,1,4
QNML,0,0,0,1,1,4
NMLA,0,0,0,2,2,4
MLAV,0,0,0,1,1,4
LAVI,0,0,0,1,1,4
AVID,0,0,0,3,3,4
VIDE,0,0,0,1,1,4
IDEL,0,0,0,1,1,4
DELM,0,0,0,1,1,4
ELMQ,0,0,0,1,1,4
LMQA,0,0,0,2,2,4
MQAL,0,0,0,1,1,4
FLLK,0,0,0,1,1,4
KVAT,0,0,0,1,1,4
ATGF,0,0,0,1,1,4
TGFA,0,0,0,2,2,4
GFAK,0,0,0,1,1,4
FAKG,0,0,0,1,1,4
FLLS,0,0,0,1,1,4
LSKA,0,0,0,1,1,4
SKAK,0,0,0,1,1,4
KAKD,0,0,0,1,1,4
AKDA,0,0,0,1,1,4
KDAK,0,0,0,1,1,4
DAKS,0,0,0,1,1,4
AKSS,0,0,0,1,1,4
KSSA,0,0,0,1,1,4
SSAE,0,0,0,1,1,4
SAEG,0,0,0,1,1,4
AEGA,0,0,0,1,1,4
FNQR,0,0,0,1,1,4
NQRR,0,0,0,1,1,4
RRIS,0,0,0,1,1,4
RISS,0,0,0,1,1,4
ISSA,0,0,0,1,1,4
SSAK,0,0,0,1,1,4
SAKF,0,0,0,1,1,4
KFLG,0,0,0,1,1,4
LGEL,0,0,0,1,1,4
GELY,0,0,0,1,1,4
ELYN,0,0,0,1,1,4
LYNY,0,0,0,1,1,4
FNRM,0,0,0,2,2,4
NRMF,0,0,0,2,2,4
RMFE,0,0,0,2,2,4
FEKS,0,0,0,3,3,4
EKST,0,0,0,2,2,4
KSTH,0,0,0,2,2,4
STHH,0,0,0,2,2,4
THHY,0,0,0,2,2,4
HHYT,0,0,0,2,2,4
HYTD,0,0,0,2,2,4
YTDS,0,0,0,2,2,4
TDSV,0,0,0,2,2,4
DSVG,0,0,0,2,2,4
SVGG,0,0,0,2,2,4
VGGI,0,0,0,2,2,4
GGIL,0,0,0,1,1,4
FPLL,0,0,0,1,1,4
PLLV,0,0,0,1,1,4
LLVD,0,0,0,1,1,4
LVDH,0,0,0,1,1,4
VDHT,0,0,0,1,1,4
DHTS,0,0,0,1,1,4
HTSR,0,0,0,1,1,4
TSRE,0,0,0,1,1,4
SREA,0,0,0,1,1,4
READ,0,0,0,1,1,4
EADY,0,0,0,1,1,4
ADYF,0,0,0,1,1,4
DYFR,0,0,0,1,1,4
YFRK,0,0,0,1,1,4
FRKR,0,0,0,1,1,4
RKRL,0,0,0,2,2,4
KRLI,0,0,0,1,1,4
RLIQ,0,0,0,1,1,4
LIQL,0,0,0,1,1,4
IQLN,0,0,0,1,1,4
QLNE,0,0,0,1,1,4
LNEG,0,0,0,1,1,4
FPNL,0,0,0,1,1,4
PNLA,0,0,0,1,1,4
NLAS,0,0,0,1,1,4
LASA,0,0,0,2,2,4
ASAA,0,0,0,1,1,4
SAAF,0,0,0,1,1,4
AAFY,0,0,0,1,1,4
AFYW,0,0,0,1,1,4
FYWS,0,0,0,1,1,4
YWSK,0,0,0,1,1,4
WSKK,0,0,0,1,1,4
SKKE,0,0,0,1,1,4
KKEN,0,0,0,1,1,4
FPQL,0,0,0,1,1,4
PQLT,0,0,0,1,1,4
QLTQ,0,0,0,1,1,4
LTQN,0,0,0,1,1,4
TQNN,0,0,0,1,1,4
QNNS,0,0,0,1,1,4
NNSR,0,0,0,1,1,4
NSRE,0,0,0,2,2,4
FSAL,0,0,0,1,1,4
SALN,0,0,0,1,1,4
ALNI,0,0,0,1,1,4
LNIA,0,0,0,1,1,4
NIAV,0,0,0,1,1,4
VHEL,0,0,0,1,1,4
HELS,0,0,0,1,1,4
ELSD,0,0,0,1,1,4
LSDV,0,0,0,2,2,4
SDVG,0,0,0,1,1,4
DVGR,0,0,0,1,1,4
VGRA,0,0,0,1,1,4
RAIV,0,0,0,1,1,4
AIVR,0,0,0,1,1,4
IVRN,0,0,0,1,1,4
FSEF,0,0,0,1,1,4
SEFI,0,0,0,1,1,4
EFIQ,0,0,0,1,1,4
FIQA,0,0,0,2,2,4
IQAL,0,0,0,1,1,4
QALS,0,0,0,1,1,4
ALSV,0,0,0,1,1,4
LSVT,0,0,0,1,1,4
SVTS,0,0,0,1,1,4
VTSR,0,0,0,1,1,4
TSRG,0,0,0,1,1,4
FTEL,0,0,0,1,1,4
TELQ,0,0,0,2,2,4
ELQR,0,0,0,2,2,4
LQRD,0,0,0,1,1,4
QRDF,0,0,0,1,1,4
RDFL,0,0,0,1,1,4
FTRI,0,0,0,1,1,4
TRII,0,0,0,1,1,4
RIIK,0,0,0,1,1,4
FVPV,0,0,0,1,1,4
VPVF,0,0,0,1,1,4
PVFF,0,0,0,1,1,4
VFFV,0,0,0,2,2,4
FFVV,0,0,0,2,2,4
FVVV,0,0,0,1,1,4
VVVR,0,0,0,1,1,4
VVRR,0,0,0,1,1,4
VRRR,0,0,0,1,1,4
FYQT,0,0,0,1,1,4
YQTF,0,0,0,1,1,4
QTFF,0,0,0,1,1,4
TFFD,0,0,0,1,1,4
FFDE,0,0,0,1,1,4
FDEA,0,0,0,1,1,4
DEAD,0,0,0,1,1,4
EADE,0,0,0,1,1,4
ELLA,0,0,0,1,1,4
LADM,0,0,0,1,1,4
ADME,0,0,0,1,1,4
DMEQ,0,0,0,1,1,4
MEQH,0,0,0,1,1,4
EQHL,0,0,0,1,1,4
QHLL,0,0,0,1,1,4
HLLD,0,0,0,1,1,4
LLDL,0,0,0,2,2,4
GAFR,0,0,0,1,1,4
AFRK,0,0,0,1,1,4
FRKL,0,0,0,1,1,4
RKLL,0,0,0,2,2,4
KLLQ,0,0,0,2,2,4
LLQS,0,0,0,1,1,4
LQSA,0,0,0,1,1,4
QSAK,0,0,0,1,1,4
SAKD,0,0,0,1,1,4
AKDN,0,0,0,1,1,4
GAGT,0,0,0,1,1,4
AGTS,0,0,0,1,1,4
GTSV,0,0,0,1,1,4
TSVN,0,0,0,1,1,4
SVNM,0,0,0,1,1,4
VNMN,0,0,0,1,1,4
NMNT,0,0,0,1,1,4
MNTN,0,0,0,1,1,4
NTNE,0,0,0,1,1,4
TNEV,0,0,0,1,1,4
NEVL,0,0,0,1,1,4
VLAN,0,0,0,1,1,4
LANI,0,0,0,1,1,4
ANIG,0,0,0,1,1,4
NIGL,0,0,0,1,1,4
IGLE,0,0,0,1,1,4
GLEL,0,0,0,1,1,4
LELM,0,0,0,1,1,4
GAPL,0,0,0,1,1,4
APLA,0,0,0,1,1,4
PLAR,0,0,0,1,1,4
LARM,0,0,0,1,1,4
ARME,0,0,0,1,1,4
RMEV,0,0,0,1,1,4
MEVT,0,0,0,1,1,4
EVTL,0,0,0,1,1,4
VTLA,0,0,0,1,1,4
TLAL,0,0,0,1,1,4
LALE,0,0,0,1,1,4
ALES,0,0,0,1,1,4
LESL,0,0,0,2,2,4
ESLF,0,0,0,1,1,4
SLFG,0,0,0,1,1,4
LFGR,0,0,0,1,1,4
FGRF,0,0,0,1,1,4
GAQY,0,0,0,1,1,4
AQYI,0,0,0,1,1,4
QYIQ,0,0,0,1,1,4
YIQA,0,0,0,1,1,4
IQAA,0,0,0,2,2,4
QAAG,0,0,0,2,2,4
AAGV,0,0,0,1,1,4
AGVA,0,0,0,1,1,4
GVAL,0,0,0,1,1,4
VALG,0,0,0,1,1,4
ALGL,0,0,0,1,1,4
LGLK,0,0,0,1,1,4
GLKM,0,0,0,1,1,4
LKMR,0,0,0,1,1,4
GAVA,0,0,0,1,1,4
AVAI,0,0,0,1,1,4
VAIA,0,0,0,1,1,4
AIAR,0,0,0,3,3,4
RVFS,0,0,0,1,1,4
VFSY,0,0,0,1,1,4
GEAE,0,0,0,1,1,4
EAEI,0,0,0,2,2,4
AEIA,0,0,0,1,1,4
EIAS,0,0,0,2,2,4
IASL,0,0,0,1,1,4
ASLK,0,0,0,2,2,4
SLKS,0,0,0,1,1,4
LKSQ,0,0,0,1,1,4
KSQI,0,0,0,1,1,4
SQIR,0,0,0,1,1,4
QIRA,0,0,0,1,1,4
GEAY,0,0,0,1,1,4
EAYL,0,0,0,2,2,4
AYLL,0,0,0,2,2,4
YLLL,0,0,0,1,1,4
LLLE,0,0,0,1,1,4
LLER,0,0,0,2,2,4
LERY,0,0,0,1,1,4
ERYV,0,0,0,1,1,4
RYVA,0,0,0,1,1,4
YVAF,0,0,0,1,1,4
VAFL,0,0,0,1,1,4
AFLR,0,0,0,2,2,4
FLRA,0,0,0,1,1,4
GEDA,0,0,0,1,1,4
EDAI,0,0,0,1,1,4
DAIL,0,0,0,1,1,4
AILK,0,0,0,2,2,4
KVAE,0,0,0,2,2,4
VAEE,0,0,0,1,1,4
AEEA,0,0,0,1,1,4
EEAA,0,0,0,3,3,4
AETL,0,0,0,2,2,4
ETLM,0,0,0,1,1,4
TLMA,0,0,0,1,1,4
LMAS,0,0,0,1,1,4
MASK,0,0,0,1,1,4
ASKD,0,0,0,1,1,4
GEGW,0,0,0,1,1,4
EGWA,0,0,0,1,1,4
GWAK,0,0,0,1,1,4
WAKS,0,0,0,1,1,4
AKSI,0,0,0,1,1,4
KSIL,0,0,0,1,1,4
SILF,0,0,0,1,1,4
ILFN,0,0,0,1,1,4
GEKR,0,0,0,1,1,4
EKRA,0,0,0,1,1,4
AEEI,0,0,0,2,2,4
EEIK,0,0,0,2,2,4
EIKK,0,0,0,1,1,4
KILM,0,0,0,1,1,4
GFFG,0,0,0,1,1,4
FFGW,0,0,0,1,1,4
FGWF,0,0,0,1,1,4
GWFN,0,0,0,1,1,4
WFNR,0,0,0,1,1,4
GFKN,0,0,0,1,1,4
FKNE,0,0,0,1,1,4
KNEV,0,0,0,1,1,4
NEVR,0,0,0,1,1,4
EVRT,0,0,0,2,2,4
VRTP,0,0,0,1,1,4
RTPV,0,0,0,1,1,4
TPVT,0,0,0,1,1,4
PVTK,0,0,0,1,1,4
VTKF,0,0,0,1,1,4
TKFR,0,0,0,1,1,4
KFRI,0,0,0,1,1,4
FRIV,0,0,0,1,1,4
IVFF,0,0,0,2,2,4
GFMI,0,0,0,1,1,4
FMIW,0,0,0,1,1,4
MIWH,0,0,0,1,1,4
IWHP,0,0,0,1,1,4
WHPK,0,0,0,1,1,4
HPKM,0,0,0,1,1,4
PKMD,0,0,0,1,1,4
KMDE,0,0,0,1,1,4
MDEY,0,0,0,1,1,4
DEYM,0,0,0,1,1,4
EYME,0,0,0,1,1,4
YMEE,0,0,0,1,1,4
MEEI,0,0,0,1,1,4
EEID,0,0,0,1,1,4
EIDG,0,0,0,1,1,4
IDGY,0,0,0,1,1,4
DGYL,0,0,0,1,1,4
GYLD,0,0,0,2,2,4
YLDE,0,0,0,3,3,4
LDEM,0,0,0,2,2,4
DEMS,0,0,0,1,1,4
EMSE,0,0,0,1,1,4
MSER,0,0,0,1,1,4
SERL,0,0,0,1,1,4
RLIT,0,0,0,1,1,4
LITL,0,0,0,3,3,4
FSVQ,0,0,0,1,1,4
SVQR,0,0,0,1,1,4
VQRR,0,0,0,1,1,4
QRRL,0,0,0,1,1,4
RRLW,0,0,0,1,1,4
RLWL,0,0,0,1,1,4
LWLA,0,0,0,1,1,4
WLAS,0,0,0,2,2,4
GFYP,0,0,0,1,1,4
FYPM,0,0,0,1,1,4
YPMV,0,0,0,1,1,4
PMVA,0,0,0,1,1,4
VAAQ,0,0,0,2,2,4
AAQR,0,0,0,2,2,4
AQRI,0,0,0,1,1,4
GGFA,0,0,0,1,1,4
GFAA,0,0,0,1,1,4
FAAA,0,0,0,1,1,4
AAAI,0,0,0,3,3,4
AAIA,0,0,0,1,1,4
IARR,0,0,0,1,1,4
ARRA,0,0,0,1,1,4
GGKE,0,0,0,1,1,4
KEAL,0,0,0,2,2,4
EALA,0,0,0,4,4,4
ALAI,0,0,0,2,2,4
LAIE,0,0,0,1,1,4
AIEN,0,0,0,1,1,4
IENF,0,0,0,1,1,4
ENFA,0,0,0,1,1,4
NFAD,0,0,0,2,2,4
FADA,0,0,0,1,1,4
ADAL,0,0,0,2,2,4
GGSS,0,0,0,1,1,4
GSSG,0,0,0,1,1,4
SSGV,0,0,0,1,1,4
SGVL,0,0,0,1,1,4
VLMS,0,0,0,1,1,4
LMSI,0,0,0,1,1,4
MSIF,0,0,0,1,1,4
SIFF,0,0,0,1,1,4
IFFT,0,0,0,1,1,4
FFTA,0,0,0,1,1,4
FTAA,0,0,0,1,1,4
TAAG,0,0,0,1,1,4
AAGQ,0,0,0,1,1,4
AGQK,0,0,0,1,1,4
GQKL,0,0,0,1,1,4
QKLE,0,0,0,1,1,4
KLEQ,0,0,0,1,1,4
GHNL,0,0,0,1,1,4
HNLI,0,0,0,1,1,4
NLIS,0,0,0,1,1,4
ISLL,0,0,0,1,1,4
SLLE,0,0,0,1,1,4
LLEV,0,0,0,1,1,4
EVLS,0,0,0,1,1,4
VLSG,0,0,0,1,1,4
GIHE,0,0,0,1,1,4
IHEL,0,0,0,2,2,4
HELA,0,0,0,1,1,4
ELAV,0,0,0,1,1,4
LAVF,0,0,0,1,1,4
AVFA,0,0,0,1,1,4
VFAE,0,0,0,1,1,4
FAEE,0,0,0,1,1,4
AEEH,0,0,0,1,1,4
KASL,0,0,0,1,1,4
ASLR,0,0,0,1,1,4
SLRA,0,0,0,1,1,4
LRAA,0,0,0,1,1,4
RAAE,0,0,0,2,2,4
AAEL,0,0,0,3,3,4
AELY,0,0,0,1,1,4
ELYS,0,0,0,2,2,4
LYSK,0,0,0,1,1,4
YSKY,0,0,0,1,1,4
GKDA,0,0,0,1,1,4
KDAA,0,0,0,1,1,4
AAAE,0,0,0,2,2,4
AAEE,0,0,0,1,1,4
EEIS,0,0,0,1,1,4
EISQ,0,0,0,1,1,4
ISQL,0,0,0,1,1,4
SQLL,0,0,0,2,2,4
QLLY,0,0,0,1,1,4
LLYH,0,0,0,1,1,4
LYHV,0,0,0,1,1,4
YHVQ,0,0,0,1,1,4
HVQV,0,0,0,1,1,4
VQVM,0,0,0,1,1,4
QVMM,0,0,0,1,1,4
VMMV,0,0,0,1,1,4
MMVA,0,0,0,1,1,4
MVAR,0,0,0,1,1,4
VARG,0,0,0,3,3,4
GKKG,0,0,0,1,1,4
KKGP,0,0,0,1,1,4
KGPK,0,0,0,1,1,4
GPKF,0,0,0,1,1,4
PKFI,0,0,0,1,1,4
KFIQ,0,0,0,1,1,4
QAVA,0,0,0,1,1,4
SLKA,0,0,0,1,1,4
GKSN,0,0,0,1,1,4
KSNM,0,0,0,1,1,4
SNMM,0,0,0,1,1,4
NMMD,0,0,0,1,1,4
MMDA,0,0,0,1,1,4
MDAI,0,0,0,1,1,4
DAIS,0,0,0,1,1,4
AISF,0,0,0,1,1,4
ISFV,0,0,0,1,1,4
SFVL,0,0,0,1,1,4
GKTT,0,0,0,3,3,4
KTTA,0,0,0,1,1,4
TTAA,0,0,0,1,1,4
ALAR,0,0,0,2,2,4
LARE,0,0,0,3,3,4
AREL,0,0,0,1,1,4
RELF,0,0,0,1,1,4
ELFG,0,0,0,1,1,4
KTTF,0,0,0,1,1,4
TTFV,0,0,0,1,1,4
TFVK,0,0,0,1,1,4
FVKR,0,0,0,1,1,4
VKRH,0,0,0,1,1,4
KRHL,0,0,0,1,1,4
RHLT,0,0,0,1,1,4
HLTG,0,0,0,1,1,4
KTTI,0,0,0,1,1,4
TTIL,0,0,0,1,1,4
TILY,0,0,0,1,1,4
ILYR,0,0,0,2,2,4
LYRL,0,0,0,3,3,4
YRLQ,0,0,0,1,1,4
RLQV,0,0,0,2,2,4
LQVG,0,0,0,1,1,4
GLEK,0,0,0,1,1,4
LEKL,0,0,0,4,4,4
EKLE,0,0,0,1,1,4
KLEE,0,0,0,2,2,4
LEES,0,0,0,2,2,4
EESI,0,0,0,1,1,4
ESIY,0,0,0,1,1,4
IYRE,0,0,0,1,1,4
LFDK,0,0,0,1,1,4
FDKV,0,0,0,2,2,4
DKVK,0,0,0,1,1,4
KVKS,0,0,0,1,1,4
VKSL,0,0,0,1,1,4
KSLV,0,0,0,1,1,4
SLVP,0,0,0,1,1,4
LVPK,0,0,0,1,1,4
VPKI,0,0,0,1,1,4
PKIA,0,0,0,1,1,4
IAKA,0,0,0,2,2,4
AKAV,0,0,0,1,1,4
DVIG,0,0,0,1,1,4
IGSQ,0,0,0,1,1,4
GSQA,0,0,0,1,1,4
SQAG,0,0,0,1,1,4
QAGG,0,0,0,1,1,4
AGGA,0,0,0,1,1,4
GGAA,0,0,0,1,1,4
GAAP,0,0,0,1,1,4
AAPH,0,0,0,1,1,4
APHF,0,0,0,1,1,4
PHFL,0,0,0,1,1,4
HFLG,0,0,0,1,1,4
LFKL,0,0,0,1,1,4
FKLI,0,0,0,1,1,4
LIKF,0,0,0,1,1,4
IKFA,0,0,0,1,1,4
AKKK,0,0,0,1,1,4
KKKS,0,0,0,1,1,4
KKSP,0,0,0,1,1,4
KSPG,0,0,0,1,1,4
SPGA,0,0,0,1,1,4
PGAF,0,0,0,1,1,4
GLGK,0,0,0,1,1,4
LGKI,0,0,0,1,1,4
KIIG,0,0,0,2,2,4
IIGK,0,0,0,1,1,4
GKVK,0,0,0,1,1,4
KVKK,0,0,0,1,1,4
KSLL,0,0,0,2,2,4
SLLK,0,0,0,2,2,4
LLKS,0,0,0,3,3,4
LKSI,0,0,0,1,1,4
GLGL,0,0,0,1,1,4
LGLV,0,0,0,1,1,4
GLVL,0,0,0,1,1,4
LVLK,0,0,0,1,1,4
VLKI,0,0,0,1,1,4
KIAV,0,0,0,1,1,4
IAVN,0,0,0,1,1,4
AVNA,0,0,0,1,1,4
VNAF,0,0,0,1,1,4
NAFL,0,0,0,1,1,4
AFLK,0,0,0,3,3,4
LKLV,0,0,0,1,1,4
KLVA,0,0,0,2,2,4
GLLD,0,0,0,1,1,4
LLDI,0,0,0,2,2,4
LDIA,0,0,0,2,2,4
DIAG,0,0,0,1,1,4
IAGG,0,0,0,2,2,4
AGGN,0,0,0,1,1,4
GGNA,0,0,0,1,1,4
GNAE,0,0,0,1,1,4
NAET,0,0,0,1,1,4
TLAG,0,0,0,1,1,4
LAGH,0,0,0,1,1,4
AGHA,0,0,0,1,1,4
GHAV,0,0,0,1,1,4
GLNA,0,0,0,1,1,4
LNAE,0,0,0,1,1,4
NAEL,0,0,0,1,1,4
ELTR,0,0,0,1,1,4
LTRY,0,0,0,1,1,4
TRYT,0,0,0,1,1,4
RYTL,0,0,0,1,1,4
YTLS,0,0,0,1,1,4
TLSL,0,0,0,1,1,4
LSLM,0,0,0,2,2,4
SLMV,0,0,0,1,1,4
LMVL,0,0,0,1,1,4
MVLE,0,0,0,1,1,4
VLER,0,0,0,1,1,4
LERK,0,0,0,1,1,4
ERKL,0,0,0,1,1,4
RKLS,0,0,0,1,1,4
KLSS,0,0,0,1,1,4
LSSA,0,0,0,1,1,4
GLTS,0,0,0,1,1,4
LTSL,0,0,0,2,2,4
TSLM,0,0,0,1,1,4
SLMA,0,0,0,1,1,4
LMAI,0,0,0,1,1,4
MAID,0,0,0,1,1,4
AIDK,0,0,0,1,1,4
IDKL,0,0,0,1,1,4
GLWA,0,0,0,1,1,4
WAIA,0,0,0,1,1,4
IAVK,0,0,0,1,1,4
AVKA,0,0,0,1,1,4
KAGK,0,0,0,1,1,4
AGKV,0,0,0,1,1,4
KVIL,0,0,0,1,1,4
VILK,0,0,0,1,1,4
ILKL,0,0,0,1,1,4
KLIV,0,0,0,1,1,4
VFIW,0,0,0,1,1,4
FIWI,0,0,0,1,1,4
IWIR,0,0,0,1,1,4
WIRV,0,0,0,2,2,4
GLWK,0,0,0,1,1,4
LWKS,0,0,0,1,1,4
WKSL,0,0,0,1,1,4
KSLG,0,0,0,1,1,4
SLGA,0,0,0,1,1,4
GAVV,0,0,0,1,1,4
AVVK,0,0,0,3,3,4
VVKR,0,0,0,1,1,4
VKRV,0,0,0,1,1,4
KRVE,0,0,0,2,2,4
RVEG,0,0,0,1,1,4
VEGL,0,0,0,3,3,4
EGLW,0,0,0,1,1,4
GLWV,0,0,0,1,1,4
LWVG,0,0,0,1,1,4
WVGL,0,0,0,1,1,4
VGLF,0,0,0,1,1,4
GNFA,0,0,0,1,1,4
ADLL,0,0,0,1,1,4
DLLA,0,0,0,1,1,4
LLAH,0,0,0,2,2,4
LAHS,0,0,0,2,2,4
AHSD,0,0,0,1,1,4
HSDG,0,0,0,1,1,4
SDGL,0,0,0,1,1,4
DGLI,0,0,0,2,2,4
GLIK,0,0,0,2,2,4
LIKN,0,0,0,1,1,4
IKNI,0,0,0,1,1,4
KNIS,0,0,0,1,1,4
NISD,0,0,0,1,1,4
ISDD,0,0,0,1,1,4
SDDL,0,0,0,1,1,4
DDLR,0,0,0,2,2,4
DLRA,0,0,0,1,1,4
LRAL,0,0,0,2,2,4
ALDK,0,0,0,2,2,4
LDKL,0,0,0,4,4,4
DKLI,0,0,0,1,1,4
GNYL,0,0,0,1,1,4
NYLR,0,0,0,1,1,4
YLRA,0,0,0,1,1,4
LRAE,0,0,0,1,1,4
RAEI,0,0,0,1,1,4
AEIL,0,0,0,1,1,4
EILY,0,0,0,1,1,4
YRLK,0,0,0,1,1,4
GPDM,0,0,0,1,1,4
PDMT,0,0,0,1,1,4
DMTA,0,0,0,1,1,4
MTAM,0,0,0,2,2,4
TAMV,0,0,0,1,1,4
AMVA,0,0,0,1,1,4
MVAL,0,0,0,1,1,4
VALI,0,0,0,1,1,4
ALIA,0,0,0,2,2,4
LIAS,0,0,0,1,1,4
IASV,0,0,0,1,1,4
GPKD,0,0,0,1,1,4
PKDA,0,0,0,1,1,4
KDAV,0,0,0,1,1,4
DAVV,0,0,0,2,2,4
VVKV,0,0,0,1,1,4
VKVF,0,0,0,1,1,4
KVFN,0,0,0,1,1,4
VFNQ,0,0,0,1,1,4
FNQW,0,0,0,1,1,4
NQWG,0,0,0,1,1,4
GPKK,0,0,0,1,1,4
PKKA,0,0,0,1,1,4
KKAQ,0,0,0,1,1,4
KAQL,0,0,0,1,1,4
QLIV,0,0,0,1,1,4
LIVG,0,0,0,1,1,4
IVGW,0,0,0,1,1,4
VGWR,0,0,0,1,1,4
GWRE,0,0,0,1,1,4
WREL,0,0,0,1,1,4
RELH,0,0,0,1,1,4
ELHG,0,0,0,1,1,4
GSDF,0,0,0,1,1,4
SDFL,0,0,0,1,1,4
FLIH,0,0,0,1,1,4
LIHF,0,0,0,1,1,4
IHFI,0,0,0,1,1,4
HFID,0,0,0,1,1,4
FIDE,0,0,0,1,1,4
GSHA,0,0,0,1,1,4
SHAN,0,0,0,1,1,4
HANE,0,0,0,1,1,4
ANEF,0,0,0,2,2,4
NEFF,0,0,0,2,2,4
EFFF,0,0,0,1,1,4
FFFR,0,0,0,1,1,4
FFRA,0,0,0,1,1,4
GTLR,0,0,0,1,1,4
TLRH,0,0,0,1,1,4
LRHA,0,0,0,1,1,4
RHAA,0,0,0,1,1,4
HAAN,0,0,0,1,1,4
AANA,0,0,0,1,1,4
ANAA,0,0,0,2,2,4
NAAF,0,0,0,1,1,4
AAFI,0,0,0,1,1,4
AFIM,0,0,0,1,1,4
FIML,0,0,0,1,1,4
IMLE,0,0,0,1,1,4
MLEA,0,0,0,3,3,4
LEAA,0,0,0,1,1,4
GTTT,0,0,0,1,1,4
TTTA,0,0,0,1,1,4
TTAV,0,0,0,1,1,4
TAVI,0,0,0,1,1,4
AVII,0,0,0,1,1,4
VIIA,0,0,0,1,1,4
IIAG,0,0,0,1,1,4
AGGL,0,0,0,1,1,4
GGLL,0,0,0,1,1,4
GLLQ,0,0,0,1,1,4
LLQQ,0,0,0,2,2,4
QQAQ,0,0,0,1,1,4
QAQG,0,0,0,1,1,4
AQGL,0,0,0,1,1,4
QGLI,0,0,0,1,1,4
GLIN,0,0,0,1,1,4
GVSG,0,0,0,1,1,4
VSGL,0,0,0,1,1,4
SGLA,0,0,0,1,1,4
GLAA,0,0,0,1,1,4
LAAA,0,0,0,2,2,4
AAAR,0,0,0,2,2,4
AARQ,0,0,0,1,1,4
ARQL,0,0,0,1,1,4
RQLQ,0,0,0,2,2,4
QLQS,0,0,0,2,2,4
LQSF,0,0,0,1,1,4
GWQN,0,0,0,1,1,4
WQNE,0,0,0,1,1,4
QNEL,0,0,0,1,1,4
NELL,0,0,0,2,2,4
ELLL,0,0,0,1,1,4
LLLL,0,0,0,3,3,4
LLLR,0,0,0,1,1,4
LLRY,0,0,0,1,1,4
LRYL,0,0,0,1,1,4
RYLD,0,0,0,1,1,4
LDEN,0,0,0,1,1,4
GYKK,0,0,0,1,1,4
YKKV,0,0,0,1,1,4
KKVS,0,0,0,1,1,4
KVSK,0,0,0,2,2,4
VSKS,0,0,0,1,1,4
SKSY,0,0,0,1,1,4
KSYT,0,0,0,1,1,4
SYTG,0,0,0,1,1,4
YTGE,0,0,0,1,1,4
TGEW,0,0,0,1,1,4
GEWK,0,0,0,1,1,4
EWKK,0,0,0,1,1,4
WKKY,0,0,0,1,1,4
KKYL,0,0,0,2,2,4
KYLN,0,0,0,1,1,4
YLNS,0,0,0,1,1,4
HAHA,0,0,0,1,1,4
AHAS,0,0,0,1,1,4
HASA,0,0,0,1,1,4
ASAI,0,0,0,1,1,4
SAIA,0,0,0,2,2,4
AIAK,0,0,0,1,1,4
AKAY,0,0,0,2,2,4
KAYA,0,0,0,2,2,4
AYAS,0,0,0,1,1,4
YASE,0,0,0,1,1,4
ASEI,0,0,0,1,1,4
SEIA,0,0,0,1,1,4
EIAF,0,0,0,1,1,4
IAFE,0,0,0,1,1,4
AFEA,0,0,0,2,2,4
FEAA,0,0,0,2,2,4
EAAN,0,0,0,1,1,4
AANQ,0,0,0,2,2,4
ANQA,0,0,0,1,1,4
NQAI,0,0,0,1,1,4
QAIQ,0,0,0,1,1,4
AIQI,0,0,0,1,1,4
IQIH,0,0,0,1,1,4
QIHG,0,0,0,3,3,4
HALR,0,0,0,1,1,4
ALRT,0,0,0,2,2,4
LRTI,0,0,0,1,1,4
RTIV,0,0,0,1,1,4
TIVF,0,0,0,1,1,4
IVFE,0,0,0,1,1,4
VFEL,0,0,0,1,1,4
FELL,0,0,0,1,1,4
ELLT,0,0,0,3,3,4
LLTR,0,0,0,1,1,4
LTRH,0,0,0,2,2,4
HDKH,0,0,0,1,1,4
DKHI,0,0,0,1,1,4
KHIE,0,0,0,1,1,4
HIEI,0,0,0,1,1,4
IEIV,0,0,0,1,1,4
EIVV,0,0,0,1,1,4
IVVR,0,0,0,1,1,4
VVRQ,0,0,0,1,1,4
VRQM,0,0,0,1,1,4
DLVT,0,0,0,1,1,4
LVTD,0,0,0,1,1,4
VTDG,0,0,0,1,1,4
TDGL,0,0,0,1,1,4
GLIT,0,0,0,1,1,4
ITLY,0,0,0,1,1,4
TLYI,0,0,0,1,1,4
LYIE,0,0,0,2,2,4
YIET,0,0,0,1,1,4
IETK,0,0,0,1,1,4
HFGS,0,0,0,1,1,4
GSLL,0,0,0,2,2,4
SLLL,0,0,0,1,1,4
LLLA,0,0,0,3,3,4
LLAA,0,0,0,1,1,4
LAAW,0,0,0,1,1,4
AAWL,0,0,0,1,1,4
AWLA,0,0,0,2,2,4
WLAE,0,0,0,1,1,4
HGLV,0,0,0,1,1,4
GLVK,0,0,0,1,1,4
LVKA,0,0,0,1,1,4
KAGH,0,0,0,1,1,4
AGHP,0,0,0,1,1,4
GHPL,0,0,0,1,1,4
HPLK,0,0,0,1,1,4
PLKR,0,0,0,1,1,4
LKRK,0,0,0,1,1,4
KRKL,0,0,0,1,1,4
RKLG,0,0,0,1,1,4
KLGH,0,0,0,1,1,4
HHKA,0,0,0,1,1,4
HKAY,0,0,0,2,2,4
KAYV,0,0,0,1,1,4
AYVD,0,0,0,1,1,4
YVDG,0,0,0,1,1,4
VDGA,0,0,0,1,1,4
DGAN,0,0,0,1,1,4
GANT,0,0,0,1,1,4
ANTA,0,0,0,1,1,4
NTAL,0,0,0,1,1,4
TALD,0,0,0,1,1,4
AEAR,0,0,0,2,2,4
EARD,0,0,0,1,1,4
ARDK,0,0,0,1,1,4
HKEM,0,0,0,1,1,4
KEMA,0,0,0,1,1,4
MAKA,0,0,0,1,1,4
KAFE,0,0,0,2,2,4
AFEE,0,0,0,2,2,4
FEEW,0,0,0,1,1,4
HLDL,0,0,0,1,1,4
LDLI,0,0,0,1,1,4
DLIN,0,0,0,1,1,4
LINM,0,0,0,1,1,4
INMM,0,0,0,1,1,4
NMMS,0,0,0,1,1,4
MMSR,0,0,0,1,1,4
MSRL,0,0,0,1,1,4
SRLA,0,0,0,4,4,4
RLAR,0,0,0,1,1,4
AREE,0,0,0,1,1,4
EELV,0,0,0,1,1,4
ELVH,0,0,0,1,1,4
LVHH,0,0,0,1,1,4
VHHE,0,0,0,1,1,4
HHEQ,0,0,0,1,1,4
HEQV,0,0,0,1,1,4
QVLR,0,0,0,1,1,4
LRLM,0,0,0,1,1,4
RLMK,0,0,0,1,1,4
LMKR,0,0,0,1,1,4
MKRR,0,0,0,1,1,4
HMKM,0,0,0,1,1,4
MKMR,0,0,0,1,1,4
KMRS,0,0,0,1,1,4
MRSQ,0,0,0,1,1,4
RSQL,0,0,0,1,1,4
QLLI,0,0,0,1,1,4
LLIV,0,0,0,2,2,4
LIVL,0,0,0,1,1,4
IVLQ,0,0,0,1,1,4
VLQE,0,0,0,1,1,4
LQEH,0,0,0,1,1,4
QEHL,0,0,0,1,1,4
EHLR,0,0,0,2,2,4
HLRN,0,0,0,1,1,4
HPAF,0,0,0,1,1,4
PAFI,0,0,0,1,1,4
AFIA,0,0,0,1,1,4
FIAH,0,0,0,1,1,4
IAHA,0,0,0,1,1,4
AHAD,0,0,0,1,1,4
HADR,0,0,0,1,1,4
ADRV,0,0,0,1,1,4
DRVL,0,0,0,2,2,4
RVLG,0,0,0,2,2,4
VLGG,0,0,0,1,1,4
LGGL,0,0,0,1,1,4
GGLD,0,0,0,1,1,4
GLDI,0,0,0,1,1,4
DIAI,0,0,0,1,1,4
IAIS,0,0,0,1,1,4
AIST,0,0,0,1,1,4
HPFY,0,0,0,1,1,4
PFYQ,0,0,0,1,1,4
FYQA,0,0,0,1,1,4
YQAL,0,0,0,1,1,4
QALG,0,0,0,1,1,4
ALGQ,0,0,0,1,1,4
LGQL,0,0,0,1,1,4
GQLA,0,0,0,1,1,4
QLAR,0,0,0,1,1,4
RLTL,0,0,0,1,1,4
LTLA,0,0,0,1,1,4
TLAQ,0,0,0,1,1,4
LAQW,0,0,0,3,3,4
AQWQ,0,0,0,1,1,4
QWQA,0,0,0,2,2,4
WQAQ,0,0,0,2,2,4
QAQL,0,0,0,1,1,4
HQAA,0,0,0,1,1,4
QAAM,0,0,0,1,1,4
AMQM,0,0,0,1,1,4
MQML,0,0,0,1,1,4
QMLK,0,0,0,1,1,4
MLKE,0,0,0,1,1,4
LKET,0,0,0,1,1,4
KETI,0,0,0,1,1,4
TINE,0,0,0,1,1,4
INEE,0,0,0,1,1,4
NEEA,0,0,0,1,1,4
AAEW,0,0,0,1,1,4
AEWD,0,0,0,1,1,4
EWDR,0,0,0,1,1,4
WDRL,0,0,0,1,1,4
DRLH,0,0,0,1,1,4
HSAT,0,0,0,1,1,4
SATR,0,0,0,1,1,4
ATRA,0,0,0,1,1,4
TRAA,0,0,0,1,1,4
AAML,0,0,0,1,1,4
AMLV,0,0,0,1,1,4
MLVR,0,0,0,1,1,4
LVRI,0,0,0,2,2,4
VRIN,0,0,0,1,1,4
RINT,0,0,0,1,1,4
HSDW,0,0,0,1,1,4
SDWI,0,0,0,1,1,4
DWIS,0,0,0,1,1,4
WISN,0,0,0,1,1,4
ISNA,0,0,0,1,1,4
SNAN,0,0,0,1,1,4
NANK,0,0,0,1,1,4
ANKV,0,0,0,1,1,4
NKVR,0,0,0,1,1,4
KVRV,0,0,0,1,1,4
VRVI,0,0,0,1,1,4
RVIY,0,0,0,1,1,4
VIYW,0,0,0,1,1,4
IYWQ,0,0,0,1,1,4
YWQM,0,0,0,1,1,4
WQMT,0,0,0,1,1,4
HSRR,0,0,0,1,1,4
SRRG,0,0,0,1,1,4
RGLL,0,0,0,1,1,4
LLKM,0,0,0,1,1,4
LKMV,0,0,0,1,1,4
KMVG,0,0,0,1,1,4
MVGK,0,0,0,1,1,4
VGKR,0,0,0,1,1,4
GKRR,0,0,0,2,2,4
KRRR,0,0,0,1,1,4
LLAY,0,0,0,1,1,4
LAYL,0,0,0,2,2,4
AYLR,0,0,0,1,1,4
YLRN,0,0,0,1,1,4
LRNK,0,0,0,1,1,4
HTFL,0,0,0,1,1,4
TFLD,0,0,0,1,1,4
FLDD,0,0,0,1,1,4
LDDI,0,0,0,1,1,4
DDIV,0,0,0,1,1,4
DIVG,0,0,0,1,1,4
IVGA,0,0,0,1,1,4
VGAI,0,0,0,1,1,4
GAIA,0,0,0,1,1,4
IAAA,0,0,0,1,1,4
AAAA,0,0,0,3,3,4
AAAS,0,0,0,1,1,4
AASR,0,0,0,1,1,4
ASRL,0,0,0,2,2,4
RLAH,0,0,0,1,1,4
AHSY,0,0,0,1,1,4
HSYH,0,0,0,1,1,4
SYHD,0,0,0,1,1,4
HVVD,0,0,0,1,1,4
VVDE,0,0,0,1,1,4
VDEK,0,0,0,1,1,4
EKAR,0,0,0,1,1,4
KARL,0,0,0,1,1,4
ARLI,0,0,0,1,1,4
RLIY,0,0,0,1,1,4
LIYE,0,0,0,1,1,4
IYED,0,0,0,1,1,4
HWDK,0,0,0,1,1,4
WDKV,0,0,0,1,1,4
DKVA,0,0,0,1,1,4
KVAD,0,0,0,1,1,4
VADM,0,0,0,2,2,4
ADMV,0,0,0,1,1,4
DMVA,0,0,0,1,1,4
MVAN,0,0,0,1,1,4
VANF,0,0,0,1,1,4
ANFA,0,0,0,1,1,4
NFAH,0,0,0,1,1,4
FAHE,0,0,0,1,1,4
AHEI,0,0,0,1,1,4
HEID,0,0,0,1,1,4
EIDT,0,0,0,1,1,4
IDTY,0,0,0,2,2,4
DTYG,0,0,0,1,1,4
IAMV,0,0,0,1,1,4
AMVN,0,0,0,1,1,4
MVNG,0,0,0,1,1,4
VNGL,0,0,0,1,1,4
NGLM,0,0,0,1,1,4
GLMG,0,0,0,1,1,4
LMGV,0,0,0,1,1,4
MGVL,0,0,0,1,1,4
GVLD,0,0,0,1,1,4
VLDK,0,0,0,1,1,4
KLAH,0,0,0,1,1,4
LAHL,0,0,0,1,1,4
AHLI,0,0,0,1,1,4
HLID,0,0,0,1,1,4
LIDE,0,0,0,1,1,4
IASE,0,0,0,1,1,4
ASEF,0,0,0,1,1,4
SEFK,0,0,0,1,1,4
EFKN,0,0,0,1,1,4
FKNI,0,0,0,1,1,4
KNIA,0,0,0,1,1,4
NIAT,0,0,0,1,1,4
IATN,0,0,0,1,1,4
ATNS,0,0,0,2,2,4
IDDL,0,0,0,1,1,4
DLRV,0,0,0,1,1,4
LRVI,0,0,0,1,1,4
RVIA,0,0,0,1,1,4
VIAR,0,0,0,1,1,4
IARE,0,0,0,2,2,4
AREN,0,0,0,1,1,4
RENL,0,0,0,1,1,4
ENLE,0,0,0,1,1,4
NLER,0,0,0,1,1,4
LERR,0,0,0,1,1,4
ERRR,0,0,0,1,1,4
RRRK,0,0,0,1,1,4
IDDS,0,0,0,1,1,4
DDSV,0,0,0,1,1,4
SVNN,0,0,0,1,1,4
VNNL,0,0,0,2,2,4
NNLI,0,0,0,1,1,4
NLIP,0,0,0,1,1,4
LIPF,0,0,0,1,1,4
IPFM,0,0,0,1,1,4
PFMQ,0,0,0,1,1,4
FMQK,0,0,0,2,2,4
MQKH,0,0,0,1,1,4
IEEA,0,0,0,1,1,4
EEAT,0,0,0,1,1,4
EATE,0,0,0,1,1,4
ATEF,0,0,0,1,1,4
TEFY,0,0,0,1,1,4
EFYE,0,0,0,1,1,4
FYEN,0,0,0,1,1,4
YEND,0,0,0,1,1,4
ENDV,0,0,0,1,1,4
IEFR,0,0,0,1,1,4
EFRK,0,0,0,1,1,4
FRKA,0,0,0,2,2,4
RKAF,0,0,0,2,2,4
FLKI,0,0,0,1,1,4
LKIL,0,0,0,1,1,4
IGVQ,0,0,0,1,1,4
GVQQ,0,0,0,1,1,4
VQQH,0,0,0,1,1,4
QQHA,0,0,0,1,1,4
QHAD,0,0,0,1,1,4
HADK,0,0,0,1,1,4
ADKV,0,0,0,1,1,4
DKVQ,0,0,0,1,1,4
KVQR,0,0,0,1,1,4
VQRA,0,0,0,1,1,4
QRAL,0,0,0,2,2,4
ALGE,0,0,0,1,1,4
GEAI,0,0,0,1,1,4
EAID,0,0,0,1,1,4
AIDD,0,0,0,1,1,4
IHNV,0,0,0,1,1,4
HNVV,0,0,0,1,1,4
NVVG,0,0,0,1,1,4
VVGK,0,0,0,1,1,4
IKPL,0,0,0,1,1,4
KPLN,0,0,0,1,1,4
PLNN,0,0,0,1,1,4
LNNF,0,0,0,2,2,4
NNFA,0,0,0,1,1,4
NFAA,0,0,0,1,1,4
FAAE,0,0,0,1,1,4
AAEV,0,0,0,1,1,4
AEVG,0,0,0,1,1,4
VGKI,0,0,0,1,1,4
GKIR,0,0,0,1,1,4
KIRD,0,0,0,1,1,4
IRDS,0,0,0,1,1,4
IMEL,0,0,0,1,1,4
MELL,0,0,0,2,2,4
ELLG,0,0,0,2,2,4
LLGT,0,0,0,1,1,4
LGTV,0,0,0,1,1,4
GTVI,0,0,0,1,1,4
TVIQ,0,0,0,1,1,4
VIQH,0,0,0,1,1,4
IQHE,0,0,0,1,1,4
QHEG,0,0,0,1,1,4
HEGI,0,0,0,1,1,4
EGIH,0,0,0,1,1,4
GIHQ,0,0,0,1,1,4
IHQG,0,0,0,1,1,4
HQGQ,0,0,0,1,1,4
QGQY,0,0,0,1,1,4
GQYY,0,0,0,1,1,4
QYYV,0,0,0,1,1,4
YYVA,0,0,0,1,1,4
YVAL,0,0,0,1,1,4
VALK,0,0,0,1,1,4
ALKQ,0,0,0,3,3,4
LKQS,0,0,0,1,1,4
KQSG,0,0,0,1,1,4
IPAA,0,0,0,1,1,4
PAAK,0,0,0,1,1,4
AAKI,0,0,0,1,1,4
AKIN,0,0,0,1,1,4
KINW,0,0,0,1,1,4
INWD,0,0,0,1,1,4
NWDR,0,0,0,1,1,4
WDRD,0,0,0,1,1,4
DRDI,0,0,0,1,1,4
RDIE,0,0,0,1,1,4
DIEY,0,0,0,1,1,4
IEYM,0,0,0,1,1,4
EYMA,0,0,0,1,1,4
YMAG,0,0,0,1,1,4
MAGI,0,0,0,1,1,4
AGIL,0,0,0,1,1,4
GILE,0,0,0,2,2,4
ILEN,0,0,0,2,2,4
IPAV,0,0,0,1,1,4
PAVA,0,0,0,1,1,4
AVAN,0,0,0,1,1,4
VANW,0,0,0,1,1,4
ANWI,0,0,0,1,1,4
NWIK,0,0,0,1,1,4
IKRR,0,0,0,1,1,4
IPEA,0,0,0,1,1,4
PEAK,0,0,0,1,1,4
EAKS,0,0,0,1,1,4
AKSF,0,0,0,1,1,4
KSFY,0,0,0,2,2,4
SFYG,0,0,0,1,1,4
FYGF,0,0,0,1,1,4
YGFQ,0,0,0,1,1,4
GFQI,0,0,0,1,1,4
FQIM,0,0,0,1,1,4
QIMI,0,0,0,1,1,4
IMIE,0,0,0,1,1,4
MIEN,0,0,0,1,1,4
IENI,0,0,0,2,2,4
ENIH,0,0,0,1,1,4
NIHS,0,0,0,1,1,4
IHSE,0,0,0,1,1,4
HSET,0,0,0,1,1,4
SETY,0,0,0,1,1,4
ETYS,0,0,0,1,1,4
TYSL,0,0,0,1,1,4
YSLL,0,0,0,1,1,4
SLLI,0,0,0,1,1,4
LLID,0,0,0,1,1,4
LIDT,0,0,0,1,1,4
DTYI,0,0,0,1,1,4
IRVN,0,0,0,1,1,4
RVNA,0,0,0,2,2,4
VNAT,0,0,0,1,1,4
NATK,0,0,0,1,1,4
ATKA,0,0,0,1,1,4
TKAY,0,0,0,1,1,4
KAYE,0,0,0,2,2,4
AYEM,0,0,0,1,1,4
YEMA,0,0,0,1,1,4
EMAL,0,0,0,1,1,4
KDAE,0,0,0,1,1,4
AENH,0,0,0,1,1,4
ENHK,0,0,0,1,1,4
NHKA,0,0,0,1,1,4
KAYL,0,0,0,2,2,4
AYLK,0,0,0,1,1,4
YLKS,0,0,0,2,2,4
LKSH,0,0,0,1,1,4
KDFE,0,0,0,1,1,4
DFET,0,0,0,1,1,4
FETL,0,0,0,1,1,4
TLKV,0,0,0,1,1,4
LKVD,0,0,0,1,1,4
KVDF,0,0,0,1,1,4
VDFL,0,0,0,2,2,4
DFLS,0,0,0,2,2,4
FLSK,0,0,0,1,1,4
SKLP,0,0,0,1,1,4
KLPE,0,0,0,1,1,4
LPEM,0,0,0,2,2,4
EMLK,0,0,0,1,1,4
MLKM,0,0,0,1,1,4
LKMF,0,0,0,1,1,4
KMFE,0,0,0,1,1,4
MFED,0,0,0,1,1,4
FEDR,0,0,0,1,1,4
EDRL,0,0,0,1,1,4
KDTV,0,0,0,1,1,4
DTVI,0,0,0,1,1,4
TVIE,0,0,0,1,1,4
VIED,0,0,0,1,1,4
IEDI,0,0,0,1,1,4
EDII,0,0,0,1,1,4
DIID,0,0,0,3,3,4
IIDK,0,0,0,1,1,4
IDKT,0,0,0,1,1,4
DKTF,0,0,0,1,1,4
KTFE,0,0,0,1,1,4
TFEE,0,0,0,1,1,4
FEEA,0,0,0,1,1,4
EEAD,0,0,0,1,1,4
KEDI,0,0,0,2,2,4
EDIH,0,0,0,1,1,4
DIHR,0,0,0,1,1,4
IHRS,0,0,0,1,1,4
HRSL,0,0,0,1,1,4
RSLV,0,0,0,1,1,4
EELT,0,0,0,1,1,4
ELTK,0,0,0,1,1,4
LTKI,0,0,0,2,2,4
TKIS,0,0,0,1,1,4
KISA,0,0,0,1,1,4
ISAK,0,0,0,1,1,4
SAKE,0,0,0,1,1,4
AKEK,0,0,0,1,1,4
KEEG,0,0,0,1,1,4
EEGY,0,0,0,1,1,4
EGYF,0,0,0,1,1,4
GYFY,0,0,0,1,1,4
YFYF,0,0,0,1,1,4
FYFR,0,0,0,1,1,4
YFRS,0,0,0,1,1,4
FRSR,0,0,0,1,1,4
RSRL,0,0,0,2,2,4
SRLS,0,0,0,1,1,4
RLSQ,0,0,0,1,1,4
KEEV,0,0,0,1,1,4
EEVQ,0,0,0,1,1,4
EVQK,0,0,0,2,2,4
VQKV,0,0,0,2,2,4
QKVL,0,0,0,1,1,4
KVLE,0,0,0,1,1,4
VLED,0,0,0,1,1,4
KEIA,0,0,0,1,1,4
EIAE,0,0,0,1,1,4
AEKM,0,0,0,2,2,4
EKMV,0,0,0,1,1,4
KMVE,0,0,0,1,1,4
MVEG,0,0,0,1,1,4
VEGR,0,0,0,1,1,4
EGRM,0,0,0,1,1,4
GRMK,0,0,0,1,1,4
RMKK,0,0,0,1,1,4
MKKF,0,0,0,1,1,4
KKFT,0,0,0,1,1,4
KFTG,0,0,0,1,1,4
FTGE,0,0,0,1,1,4
TGEV,0,0,0,1,1,4
LKKW,0,0,0,1,1,4
KKWE,0,0,0,1,1,4
KWEG,0,0,0,1,1,4
WEGI,0,0,0,1,1,4
EGIW,0,0,0,1,1,4
GIWA,0,0,0,1,1,4
IWAT,0,0,0,1,1,4
WATF,0,0,0,1,1,4
ATFK,0,0,0,1,1,4
TFKP,0,0,0,1,1,4
FKPA,0,0,0,1,1,4
KPAL,0,0,0,1,1,4
PALS,0,0,0,1,1,4
ALSA,0,0,0,3,3,4
LSAV,0,0,0,1,1,4
SAVV,0,0,0,1,1,4
KFLR,0,0,0,1,1,4
FLRF,0,0,0,1,1,4
LRFI,0,0,0,1,1,4
RFIL,0,0,0,1,1,4
FILK,0,0,0,1,1,4
ILKW,0,0,0,1,1,4
LKWF,0,0,0,1,1,4
WFKV,0,0,0,1,1,4
KVIF,0,0,0,1,1,4
VIFQ,0,0,0,1,1,4
LTKL,0,0,0,3,3,4
TKLK,0,0,0,1,1,4
KLKN,0,0,0,1,1,4
LKNI,0,0,0,1,1,4
KNIV,0,0,0,1,1,4
NIVA,0,0,0,1,1,4
IVAN,0,0,0,1,1,4
VANI,0,0,0,1,1,4
ANIR,0,0,0,1,1,4
NIRI,0,0,0,1,1,4
IRIW,0,0,0,1,1,4
RIWW,0,0,0,1,1,4
IWWV,0,0,0,1,1,4
WWVI,0,0,0,1,1,4
WVIL,0,0,0,1,1,4
VILL,0,0,0,1,1,4
KGQE,0,0,0,1,1,4
GQEY,0,0,0,1,1,4
QEYI,0,0,0,1,1,4
EYIN,0,0,0,1,1,4
YINN,0,0,0,1,1,4
INNI,0,0,0,1,1,4
NNIH,0,0,0,1,1,4
NIHL,0,0,0,1,1,4
KHFD,0,0,0,1,1,4
HFDF,0,0,0,1,1,4
FDFL,0,0,0,1,1,4
DFLA,0,0,0,1,1,4
FLAE,0,0,0,2,2,4
LAEF,0,0,0,1,1,4
AEFN,0,0,0,1,1,4
EFNA,0,0,0,1,1,4
FNAK,0,0,0,1,1,4
NAKA,0,0,0,1,1,4
AKAN,0,0,0,1,1,4
KAND,0,0,0,1,1,4
KHHA,0,0,0,1,1,4
HHAA,0,0,0,1,1,4
HAAY,0,0,0,1,1,4
AAYV,0,0,0,1,1,4
AYVN,0,0,0,1,1,4
YVNN,0,0,0,1,1,4
NNLN,0,0,0,2,2,4
NLNN,0,0,0,1,1,4
LNNA,0,0,0,1,1,4
NNAL,0,0,0,1,1,4
NALK,0,0,0,2,2,4
KIPD,0,0,0,1,1,4
IPDD,0,0,0,1,1,4
PDDL,0,0,0,1,1,4
DDLQ,0,0,0,1,1,4
DLQA,0,0,0,1,1,4
LQAD,0,0,0,1,1,4
QADF,0,0,0,1,1,4
ADFN,0,0,0,1,1,4
DFNK,0,0,0,1,1,4
FNKF,0,0,0,1,1,4
NKFR,0,0,0,1,1,4
KKAE,0,0,0,1,1,4
KAEA,0,0,0,1,1,4
AEAV,0,0,0,1,1,4
EAVA,0,0,0,1,1,4
AVAT,0,0,0,1,1,4
VATV,0,0,0,1,1,4
ATVV,0,0,0,1,1,4
TVVA,0,0,0,1,1,4
VVAA,0,0,0,2,2,4
AAVD,0,0,0,1,1,4
AVDQ,0,0,0,1,1,4
VDQA,0,0,0,1,1,4
DQAR,0,0,0,1,1,4
QARV,0,0,0,3,3,4
KKDV,0,0,0,1,1,4
KDVK,0,0,0,1,1,4
DVKL,0,0,0,1,1,4
VKLI,0,0,0,2,2,4
KLIL,0,0,0,1,1,4
LILD,0,0,0,1,1,4
ILDT,0,0,0,1,1,4
LDTI,0,0,0,1,1,4
DTIL,0,0,0,1,1,4
TILE,0,0,0,1,1,4
ILET,0,0,0,2,2,4
LETI,0,0,0,1,1,4
ETIT,0,0,0,2,2,4
TITE,0,0,0,2,2,4
ITEA,0,0,0,1,1,4
TEAL,0,0,0,1,1,4
KKEE,0,0,0,2,2,4
EELQ,0,0,0,1,1,4
LQRS,0,0,0,1,1,4
QRSL,0,0,0,1,1,4
RSLN,0,0,0,1,1,4
SLNI,0,0,0,1,1,4
LNIL,0,0,0,3,3,4
NILT,0,0,0,1,1,4
ILTA,0,0,0,1,1,4
LTAF,0,0,0,1,1,4
KKQE,0,0,0,1,1,4
KQEL,0,0,0,1,1,4
QELL,0,0,0,4,4,4
ELLE,0,0,0,1,1,4
LTKH,0,0,0,1,1,4
TKHF,0,0,0,1,1,4
KHFQ,0,0,0,1,1,4
KKTA,0,0,0,1,1,4
KTAE,0,0,0,1,1,4
RLIV,0,0,0,1,1,4
LIVE,0,0,0,1,1,4
IVEM,0,0,0,1,1,4
VEMK,0,0,0,1,1,4
EMKD,0,0,0,1,1,4
MKDR,0,0,0,1,1,4
KDRF,0,0,0,1,1,4
DRFK,0,0,0,1,1,4
RFKG,0,0,0,1,1,4
KKVK,0,0,0,1,1,4
KVKG,0,0,0,1,1,4
KGYK,0,0,0,1,1,4
GYKR,0,0,0,1,1,4
YKRA,0,0,0,1,1,4
RALT,0,0,0,2,2,4
ALTE,0,0,0,2,2,4
KLDS,0,0,0,1,1,4
LDSR,0,0,0,1,1,4
DSRF,0,0,0,1,1,4
SRFD,0,0,0,1,1,4
RFDN,0,0,0,1,1,4
FDNN,0,0,0,1,1,4
DNNL,0,0,0,1,1,4
NNLG,0,0,0,1,1,4
NLGK,0,0,0,1,1,4
LGKF,0,0,0,1,1,4
GKFR,0,0,0,1,1,4
KFRF,0,0,0,1,1,4
FRFV,0,0,0,1,1,4
RFVL,0,0,0,1,1,4
FVLL,0,0,0,1,1,4
VLLL,0,0,0,1,1,4
LLLF,0,0,0,1,1,4
LLFV,0,0,0,1,1,4
LEEK,0,0,0,1,1,4
EEKF,0,0,0,1,1,4
EKFP,0,0,0,1,1,4
KFPQ,0,0,0,1,1,4
FPQV,0,0,0,1,1,4
PQVA,0,0,0,1,1,4
QVAA,0,0,0,1,1,4
VAAT,0,0,0,2,2,4
LKEL,0,0,0,1,1,4
KELA,0,0,0,1,1,4
ELAL,0,0,0,2,2,4
LALI,0,0,0,1,1,4
ALIF,0,0,0,1,1,4
LIFI,0,0,0,1,1,4
IFIS,0,0,0,1,1,4
FISN,0,0,0,1,1,4
ISNL,0,0,0,1,1,4
SNLV,0,0,0,1,1,4
NLVA,0,0,0,2,2,4
LVAN,0,0,0,2,2,4
KNIK,0,0,0,1,1,4
NIKR,0,0,0,1,1,4
IKRN,0,0,0,1,1,4
RNVE,0,0,0,1,1,4
NVEK,0,0,0,1,1,4
VEKI,0,0,0,1,1,4
IIAQ,0,0,0,1,1,4
IAQW,0,0,0,1,1,4
AQWD,0,0,0,1,1,4
QWDE,0,0,0,1,1,4
WDER,0,0,0,1,1,4
DERT,0,0,0,1,1,4
ERTR,0,0,0,1,1,4
RTRK,0,0,0,1,1,4
KPEE,0,0,0,1,1,4
EEVE,0,0,0,1,1,4
EVEQ,0,0,0,1,1,4
VEQI,0,0,0,1,1,4
EQIK,0,0,0,1,1,4
QIKL,0,0,0,1,1,4
IKLY,0,0,0,1,1,4
KLYV,0,0,0,1,1,4
LYVM,0,0,0,1,1,4
YVMS,0,0,0,1,1,4
VMSR,0,0,0,1,1,4
MSRE,0,0,0,1,1,4
SREY,0,0,0,1,1,4
REYE,0,0,0,1,1,4
EYED,0,0,0,1,1,4
YEDY,0,0,0,1,1,4
EDYM,0,0,0,1,1,4
DYMA,0,0,0,1,1,4
YMAR,0,0,0,1,1,4
KPEQ,0,0,0,1,1,4
PEQY,0,0,0,1,1,4
EQYN,0,0,0,1,1,4
QYNI,0,0,0,1,1,4
YNIV,0,0,0,1,1,4
NIVG,0,0,0,1,1,4
IVGE,0,0,0,1,1,4
VGEH,0,0,0,1,1,4
GEHL,0,0,0,1,1,4
EHLL,0,0,0,2,2,4
HLLA,0,0,0,1,1,4
LLAT,0,0,0,1,1,4
LATL,0,0,0,1,1,4
ATLD,0,0,0,1,1,4
TLDE,0,0,0,1,1,4
DEMF,0,0,0,1,1,4
EMFS,0,0,0,1,1,4
KPQE,0,0,0,2,2,4
PQEL,0,0,0,1,1,4
LLSL,0,0,0,2,2,4
SLII,0,0,0,1,1,4
IIER,0,0,0,1,1,4
IERF,0,0,0,1,1,4
ERFE,0,0,0,1,1,4
PQER,0,0,0,1,1,4
QERA,0,0,0,1,1,4
ERAD,0,0,0,1,1,4
RADL,0,0,0,1,1,4
ADLI,0,0,0,1,1,4
DLIS,0,0,0,1,1,4
LISY,0,0,0,1,1,4
ISYL,0,0,0,1,1,4
SYLK,0,0,0,1,1,4
LKEA,0,0,0,2,2,4
KEAT,0,0,0,1,1,4
EATS,0,0,0,1,1,4
KPWL,0,0,0,1,1,4
PWLS,0,0,0,1,1,4
WLSV,0,0,0,1,1,4
LSVI,0,0,0,1,1,4
SVIL,0,0,0,1,1,4
VILF,0,0,0,1,1,4
ILFL,0,0,0,1,1,4
LFLI,0,0,0,1,1,4
FLIR,0,0,0,3,3,4
LIRE,0,0,0,4,4,4
IRER,0,0,0,1,1,4
RERS,0,0,0,1,1,4
ERSR,0,0,0,1,1,4
QAEA,0,0,0,3,3,4
AEAE,0,0,0,1,1,4
EAEE,0,0,0,1,1,4
AEEF,0,0,0,1,1,4
EEFV,0,0,0,1,1,4
EFVQ,0,0,0,1,1,4
FVQT,0,0,0,1,1,4
VQTL,0,0,0,2,2,4
QTLG,0,0,0,1,1,4
TLGQ,0,0,0,1,1,4
LGQS,0,0,0,1,1,4
GQSL,0,0,0,1,1,4
QSLA,0,0,0,2,2,4
KQLT,0,0,0,1,1,4
QLTA,0,0,0,1,1,4
LTAI,0,0,0,1,1,4
TAIA,0,0,0,1,1,4
IAAL,0,0,0,2,2,4
KREI,0,0,0,1,1,4
REII,0,0,0,1,1,4
EIIH,0,0,0,1,1,4
IIHA,0,0,0,1,1,4
IHAV,0,0,0,1,1,4
AVLT,0,0,0,1,1,4
VLTG,0,0,0,1,1,4
LTGL,0,0,0,1,1,4
TGLA,0,0,0,1,1,4
GLAL,0,0,0,1,1,4
LALD,0,0,0,1,1,4
ALDQ,0,0,0,1,1,4
DQLA,0,0,0,2,2,4
QLAE,0,0,0,1,1,4
KREV,0,0,0,1,1,4
REVQ,0,0,0,1,1,4
EVQN,0,0,0,1,1,4
VQNA,0,0,0,1,1,4
QNAI,0,0,0,2,2,4
NAIL,0,0,0,2,2,4
AILT,0,0,0,2,2,4
ILTG,0,0,0,1,1,4
LTGI,0,0,0,1,1,4
TGIQ,0,0,0,1,1,4
GIQL,0,0,0,1,1,4
IQLD,0,0,0,1,1,4
QLDK,0,0,0,1,1,4
KSEA,0,0,0,1,1,4
SEAL,0,0,0,1,1,4
LAKM,0,0,0,1,1,4
AKMW,0,0,0,1,1,4
KMWG,0,0,0,1,1,4
MWGQ,0,0,0,1,1,4
WGQR,0,0,0,1,1,4
KTAS,0,0,0,1,1,4
TAST,0,0,0,1,1,4
ASTG,0,0,0,2,2,4
STGF,0,0,0,1,1,4
GFAE,0,0,0,1,1,4
FAEL,0,0,0,1,1,4
AELL,0,0,0,1,1,4
ELLK,0,0,0,1,1,4
LLKD,0,0,0,2,2,4
LKDR,0,0,0,2,2,4
KDRR,0,0,0,1,1,4
DRRE,0,0,0,1,1,4
RREQ,0,0,0,1,1,4
REQV,0,0,0,2,2,4
KTFR,0,0,0,1,1,4
TFRT,0,0,0,1,1,4
FRTT,0,0,0,1,1,4
RTTF,0,0,0,1,1,4
TTFK,0,0,0,1,1,4
TFKT,0,0,0,1,1,4
KTLL,0,0,0,1,1,4
VAEF,0,0,0,1,1,4
AEFE,0,0,0,1,1,4
EFER,0,0,0,1,1,4
FERL,0,0,0,2,2,4
ERLF,0,0,0,1,1,4
LFRQ,0,0,0,1,1,4
FRQA,0,0,0,2,2,4
RQAA,0,0,0,1,1,4
KVNR,0,0,0,1,1,4
VNRA,0,0,0,1,1,4
NRAV,0,0,0,1,1,4
RAVA,0,0,0,3,3,4
VAAE,0,0,0,1,1,4
AAEI,0,0,0,1,1,4
AEIR,0,0,0,2,2,4
EIRN,0,0,0,1,1,4
IRNW,0,0,0,1,1,4
RNWT,0,0,0,1,1,4
NWTW,0,0,0,1,1,4
WTWV,0,0,0,1,1,4
TWVF,0,0,0,1,1,4
WVFL,0,0,0,1,1,4
VFLI,0,0,0,1,1,4
FLIW,0,0,0,1,1,4
KVRE,0,0,0,2,2,4
VRET,0,0,0,1,1,4
RETR,0,0,0,1,1,4
TREI,0,0,0,1,1,4
REIL,0,0,0,1,1,4
EILD,0,0,0,2,2,4
ILDI,0,0,0,1,1,4
LDII,0,0,0,1,1,4
IIDT,0,0,0,1,1,4
IDTV,0,0,0,1,1,4
DTVY,0,0,0,1,1,4
TVYN,0,0,0,1,1,4
VYNS,0,0,0,1,1,4
KVRG,0,0,0,1,1,4
VRGL,0,0,0,1,1,4
RGLI,0,0,0,1,1,4
GLIE,0,0,0,2,2,4
LIEI,0,0,0,1,1,4
IEII,0,0,0,1,1,4
EIIS,0,0,0,1,1,4
IISN,0,0,0,1,1,4
KVSD,0,0,0,1,1,4
VSDI,0,0,0,1,1,4
SDIL,0,0,0,1,1,4
DILT,0,0,0,1,1,4
ILTV,0,0,0,1,1,4
LTVA,0,0,0,2,2,4
TVAI,0,0,0,1,1,4
VAIR,0,0,0,1,1,4
AIRL,0,0,0,1,1,4
IRLE,0,0,0,1,1,4
RLEE,0,0,0,2,2,4
LEEE,0,0,0,1,1,4
EEEG,0,0,0,1,1,4
EEGE,0,0,0,1,1,4
GERF,0,0,0,2,2,4
ERFY,0,0,0,1,1,4
RFYR,0,0,0,1,1,4
FYRE,0,0,0,1,1,4
RELS,0,0,0,2,2,4
KVVD,0,0,0,1,1,4
VVDN,0,0,0,1,1,4
VDNF,0,0,0,1,1,4
DNFE,0,0,0,1,1,4
NFEN,0,0,0,1,1,4
FENI,0,0,0,1,1,4
ENIL,0,0,0,1,1,4
NILI,0,0,0,1,1,4
ILII,0,0,0,1,1,4
KVWK,0,0,0,1,1,4
VWKG,0,0,0,1,1,4
WKGV,0,0,0,1,1,4
KGVK,0,0,0,1,1,4
GVKT,0,0,0,1,1,4
VKTI,0,0,0,2,2,4
KTII,0,0,0,1,1,4
TIIA,0,0,0,1,1,4
IIAD,0,0,0,1,1,4
IADV,0,0,0,1,1,4
ADVW,0,0,0,1,1,4
DVWQ,0,0,0,1,1,4
VWQV,0,0,0,1,1,4
KWEA,0,0,0,1,1,4
WEAE,0,0,0,1,1,4
EAEK,0,0,0,1,1,4
AEKI,0,0,0,2,2,4
EKIH,0,0,0,1,1,4
KIHI,0,0,0,1,1,4
IHIG,0,0,0,1,1,4
HIGF,0,0,0,1,1,4
IGFR,0,0,0,1,1,4
GFRQ,0,0,0,1,1,4
RQAY,0,0,0,1,1,4
KWVR,0,0,0,1,1,4
WVRI,0,0,0,1,1,4
VRIW,0,0,0,1,1,4
RIWI,0,0,0,1,1,4
IWIK,0,0,0,1,1,4
WIKV,0,0,0,1,1,4
LRGL,0,0,0,1,1,4
RGLF,0,0,0,1,1,4
GLFV,0,0,0,1,1,4
LFVW,0,0,0,1,1,4
FVWV,0,0,0,1,1,4
VWVW,0,0,0,1,1,4
WVWF,0,0,0,1,1,4
VWFF,0,0,0,1,1,4
KYDH,0,0,0,1,1,4
YDHF,0,0,0,1,1,4
DHFA,0,0,0,1,1,4
HFAG,0,0,0,1,1,4
FAGR,0,0,0,1,1,4
AGRA,0,0,0,1,1,4
GRAY,0,0,0,1,1,4
RAYV,0,0,0,1,1,4
AYVR,0,0,0,1,1,4
YVRL,0,0,0,1,1,4
VRLH,0,0,0,1,1,4
RLHQ,0,0,0,1,1,4
LHQD,0,0,0,1,1,4
LADL,0,0,0,2,2,4
ADLQ,0,0,0,1,1,4
DLQE,0,0,0,2,2,4
LQEQ,0,0,0,1,1,4
QEQL,0,0,0,1,1,4
EQLY,0,0,0,1,1,4
QLYN,0,0,0,1,1,4
LYNG,0,0,0,1,1,4
DAYI,0,0,0,1,1,4
AYIN,0,0,0,1,1,4
YINL,0,0,0,1,1,4
INLG,0,0,0,1,1,4
NLGN,0,0,0,1,1,4
LGNV,0,0,0,1,1,4
GNVL,0,0,0,1,1,4
NVLK,0,0,0,1,1,4
LDEA,0,0,0,2,2,4
EAAT,0,0,0,1,1,4
AATR,0,0,0,1,1,4
ATRS,0,0,0,1,1,4
TRSK,0,0,0,1,1,4
RSKA,0,0,0,1,1,4
SKAW,0,0,0,1,1,4
KAWM,0,0,0,1,1,4
AWMV,0,0,0,1,1,4
WMVD,0,0,0,1,1,4
MVDA,0,0,0,1,1,4
VDAL,0,0,0,1,1,4
DALA,0,0,0,2,2,4
LEAR,0,0,0,1,1,4
EARM,0,0,0,1,1,4
ARMK,0,0,0,1,1,4
RMKQ,0,0,0,1,1,4
MKQF,0,0,0,1,1,4
KQFK,0,0,0,1,1,4
QFKD,0,0,0,1,1,4
FKDM,0,0,0,1,1,4
KDML,0,0,0,1,1,4
DMLL,0,0,0,1,1,4
MLLE,0,0,0,1,1,4
LEEF,0,0,0,2,2,4
EEFD,0,0,0,1,1,4
EFDK,0,0,0,1,1,4
DKVS,0,0,0,1,1,4
VSKN,0,0,0,1,1,4
SKNV,0,0,0,1,1,4
KNVD,0,0,0,1,1,4
LEPI,0,0,0,1,1,4
EPIK,0,0,0,1,1,4
PIKA,0,0,0,1,1,4
IKAW,0,0,0,1,1,4
KAWI,0,0,0,1,1,4
AWIE,0,0,0,1,1,4
IEKR,0,0,0,1,1,4
LEQV,0,0,0,1,1,4
EQVE,0,0,0,2,2,4
QVEF,0,0,0,1,1,4
VEFK,0,0,0,1,1,4
EFKL,0,0,0,1,1,4
FKLN,0,0,0,1,1,4
KLNQ,0,0,0,2,2,4
LNQL,0,0,0,2,2,4
NQLL,0,0,0,2,2,4
QLLE,0,0,0,1,1,4
LLEN,0,0,0,1,1,4
LENL,0,0,0,1,1,4
LHDA,0,0,0,1,1,4
DAIH,0,0,0,1,1,4
AIHM,0,0,0,1,1,4
IHMA,0,0,0,1,1,4
HMAA,0,0,0,1,1,4
MAAD,0,0,0,1,1,4
AADN,0,0,0,1,1,4
ADNA,0,0,0,1,1,4
DNAV,0,0,0,1,1,4
RAEA,0,0,0,1,1,4
AEAL,0,0,0,3,3,4
EALI,0,0,0,1,1,4
ALIH,0,0,0,1,1,4
IHLA,0,0,0,1,1,4
HLAN,0,0,0,2,2,4
NAAL,0,0,0,1,1,4
AALE,0,0,0,1,1,4
LKYV,0,0,0,1,1,4
KYVG,0,0,0,1,1,4
YVGM,0,0,0,1,1,4
GMVL,0,0,0,1,1,4
MVLN,0,0,0,1,1,4
VLNE,0,0,0,1,1,4
LNEA,0,0,0,1,1,4
NEAL,0,0,0,1,1,4
LRLW,0,0,0,1,1,4
LLNI,0,0,0,2,2,4
LNIR,0,0,0,1,1,4
NIRR,0,0,0,1,1,4
IRRE,0,0,0,1,1,4
RREF,0,0,0,1,1,4
REFI,0,0,0,1,1,4
EFIE,0,0,0,1,1,4
FIEK,0,0,0,1,1,4
LLPA,0,0,0,1,1,4
PALL,0,0,0,1,1,4
ALLQ,0,0,0,1,1,4
LQQI,0,0,0,1,1,4
QQIG,0,0,0,1,1,4
QIGR,0,0,0,1,1,4
IGRE,0,0,0,1,1,4
GREN,0,0,0,1,1,4
LLTE,0,0,0,1,1,4
LTEV,0,0,0,1,1,4
TEVE,0,0,0,1,1,4
EVET,0,0,0,1,1,4
VETY,0,0,0,1,1,4
ETYV,0,0,0,1,1,4
TYVL,0,0,0,1,1,4
YVLS,0,0,0,1,1,4
VLSI,0,0,0,1,1,4
LMEP,0,0,0,1,1,4
MEPV,0,0,0,1,1,4
EPVR,0,0,0,1,1,4
REAA,0,0,0,1,1,4
EAAG,0,0,0,2,2,4
AAGR,0,0,0,1,1,4
AGRL,0,0,0,1,1,4
GRLA,0,0,0,1,1,4
RLAD,0,0,0,1,1,4
LADA,0,0,0,3,3,4
LMGH,0,0,0,1,1,4
MGHQ,0,0,0,1,1,4
GHQK,0,0,0,1,1,4
HQKK,0,0,0,1,1,4
QKKI,0,0,0,1,1,4
KILG,0,0,0,1,1,4
ILGS,0,0,0,1,1,4
LGSI,0,0,0,2,2,4
GSIQ,0,0,0,1,1,4
SIQT,0,0,0,1,1,4
IQTM,0,0,0,1,1,4
QTMR,0,0,0,1,1,4
TMRA,0,0,0,1,1,4
MRAQ,0,0,0,1,1,4
RAQL,0,0,0,1,1,4
AQLT,0,0,0,1,1,4
NNFS,0,0,0,1,1,4
NFSR,0,0,0,1,1,4
FSRY,0,0,0,1,1,4
SRYF,0,0,0,1,1,4
RYFL,0,0,0,1,1,4
YFLH,0,0,0,1,1,4
FLHQ,0,0,0,1,1,4
LHQS,0,0,0,1,1,4
HQSR,0,0,0,1,1,4
QSRE,0,0,0,1,1,4
SREE,0,0,0,1,1,4
REET,0,0,0,1,1,4
EETE,0,0,0,1,1,4
ETEH,0,0,0,1,1,4
TEHA,0,0,0,1,1,4
EHAE,0,0,0,1,1,4
HAEK,0,0,0,1,1,4
EKLM,0,0,0,1,1,4
KLMR,0,0,0,1,1,4
MRLQ,0,0,0,1,1,4
RLQN,0,0,0,1,1,4
LQNQ,0,0,0,1,1,4
QNQR,0,0,0,1,1,4
NQRG,0,0,0,1,1,4
LPED,0,0,0,1,1,4
PEDQ,0,0,0,1,1,4
EDQE,0,0,0,1,1,4
DQEL,0,0,0,1,1,4
ELLF,0,0,0,2,2,4
LLFQ,0,0,0,1,1,4
LFQS,0,0,0,1,1,4
FQSA,0,0,0,1,1,4
QSAS,0,0,0,1,1,4
SASL,0,0,0,1,1,4
ASLE,0,0,0,1,1,4
SLEL,0,0,0,1,1,4
LELF,0,0,0,1,1,4
ELFV,0,0,0,1,1,4
LFVL,0,0,0,2,2,4
FVLR,0,0,0,1,1,4
RLAY,0,0,0,2,2,4
LAYR,0,0,0,1,1,4
AYRA,0,0,0,1,1,4
LPHF,0,0,0,1,1,4
PHFY,0,0,0,1,1,4
HFYE,0,0,0,1,1,4
FYEL,0,0,0,1,1,4
YELF,0,0,0,1,1,4
ELFS,0,0,0,1,1,4
FSLW,0,0,0,1,1,4
SLWA,0,0,0,1,1,4
LPIH,0,0,0,1,1,4
PIHY,0,0,0,1,1,4
IHYK,0,0,0,1,1,4
HYKL,0,0,0,1,1,4
YKLS,0,0,0,1,1,4
KLSQ,0,0,0,1,1,4
LSQE,0,0,0,1,1,4
SQEF,0,0,0,1,1,4
QEFF,0,0,0,1,1,4
EFFL,0,0,0,1,1,4
FFLK,0,0,0,1,1,4
FLKA,0,0,0,2,2,4
LKAY,0,0,0,3,3,4
LQAP,0,0,0,1,1,4
QAPL,0,0,0,1,1,4
APLQ,0,0,0,1,1,4
PLQR,0,0,0,1,1,4
LQRR,0,0,0,1,1,4
RRIL,0,0,0,1,1,4
RILE,0,0,0,1,1,4
ILEI,0,0,0,1,1,4
LEIG,0,0,0,1,1,4
EIGK,0,0,0,1,1,4
IGKK,0,0,0,1,1,4
GKKH,0,0,0,1,1,4
LQME,0,0,0,1,1,4
QMEF,0,0,0,1,1,4
MEFK,0,0,0,1,1,4
EFKY,0,0,0,1,1,4
FKYL,0,0,0,1,1,4
KYLA,0,0,0,1,1,4
YLAY,0,0,0,1,1,4
AYLT,0,0,0,2,2,4
YLTG,0,0,0,2,2,4
LQNA,0,0,0,2,2,4
NAII,0,0,0,1,1,4
AIIE,0,0,0,1,1,4
IIEF,0,0,0,1,1,4
IEFY,0,0,0,1,1,4
EFYT,0,0,0,1,1,4
FYTE,0,0,0,1,1,4
YTEY,0,0,0,1,1,4
TEYY,0,0,0,1,1,4
LQWY,0,0,0,1,1,4
QWYV,0,0,0,1,1,4
WYVS,0,0,0,1,1,4
YVSE,0,0,0,1,1,4
VSEQ,0,0,0,1,1,4
SEQH,0,0,0,1,1,4
EQHE,0,0,0,1,1,4
QHEE,0,0,0,1,1,4
HEEE,0,0,0,1,1,4
EEEA,0,0,0,1,1,4
EEAL,0,0,0,1,1,4
EALF,0,0,0,1,1,4
LFRG,0,0,0,1,1,4
FRGI,0,0,0,1,1,4
RGIV,0,0,0,1,1,4
GIVD,0,0,0,1,1,4
IVDK,0,0,0,1,1,4
VDKI,0,0,0,1,1,4
DKIK,0,0,0,2,2,4
KIKL,0,0,0,1,1,4
IKLI,0,0,0,1,1,4
REIV,0,0,0,1,1,4
EIVE,0,0,0,1,1,4
IVEN,0,0,0,1,1,4
VENM,0,0,0,1,1,4
ENMI,0,0,0,1,1,4
NMIK,0,0,0,1,1,4
MIKS,0,0,0,2,2,4
IKSS,0,0,0,1,1,4
KSSL,0,0,0,2,2,4
SSLE,0,0,0,1,1,4
SLER,0,0,0,1,1,4
RAIA,0,0,0,2,2,4
IAAY,0,0,0,1,1,4
LRSW,0,0,0,1,1,4
RSWF,0,0,0,1,1,4
SWFR,0,0,0,1,1,4
WFRE,0,0,0,1,1,4
LIAH,0,0,0,1,1,4
IAHR,0,0,0,2,2,4
HRLA,0,0,0,1,1,4
RLAS,0,0,0,1,1,4
LASV,0,0,0,1,1,4
ASVN,0,0,0,1,1,4
SVNL,0,0,0,1,1,4
LRTY,0,0,0,1,1,4
RTYF,0,0,0,1,1,4
TYFM,0,0,0,1,1,4
YFME,0,0,0,1,1,4
MERL,0,0,0,1,1,4
RLRH,0,0,0,1,1,4
LRHY,0,0,0,1,1,4
RHYR,0,0,0,1,1,4
HYRQ,0,0,0,1,1,4
YRQL,0,0,0,1,1,4
RQLS,0,0,0,1,1,4
QLSL,0,0,0,1,1,4
LSTV,0,0,0,1,1,4
STVS,0,0,0,1,1,4
TVSN,0,0,0,1,1,4
VSNF,0,0,0,1,1,4
SNFF,0,0,0,1,1,4
NFFM,0,0,0,1,1,4
FFMN,0,0,0,1,1,4
FMNA,0,0,0,1,1,4
LVGA,0,0,0,1,1,4
VGAL,0,0,0,1,1,4
GALM,0,0,0,1,1,4
ALMH,0,0,0,1,1,4
LMHV,0,0,0,1,1,4
MHVM,0,0,0,1,1,4
HVMQ,0,0,0,1,1,4
VMQK,0,0,0,1,1,4
MQKR,0,0,0,1,1,4
QKRS,0,0,0,1,1,4
KRSR,0,0,0,2,2,4
LVLP,0,0,0,1,1,4
VLPI,0,0,0,1,1,4
LPIA,0,0,0,1,1,4
PIAQ,0,0,0,1,1,4
IAQA,0,0,0,1,1,4
QALK,0,0,0,1,1,4
ALKV,0,0,0,1,1,4
MEAL,0,0,0,1,1,4
EALK,0,0,0,1,1,4
LKKQ,0,0,0,1,1,4
KKQI,0,0,0,1,1,4
KQIL,0,0,0,1,1,4
QILQ,0,0,0,1,1,4
ILQI,0,0,0,1,1,4
EKLN,0,0,0,1,1,4
NQLW,0,0,0,1,1,4
QLWE,0,0,0,1,1,4
LWEK,0,0,0,1,1,4
WEKA,0,0,0,1,1,4
EKAQ,0,0,0,1,1,4
KAQR,0,0,0,1,1,4
AQRL,0,0,0,2,2,4
QRLH,0,0,0,1,1,4
MLEE,0,0,0,1,1,4
LEEY,0,0,0,1,1,4
EEYR,0,0,0,1,1,4
EYRK,0,0,0,1,1,4
YRKH,0,0,0,1,1,4
ERAA,0,0,0,1,1,4
MPEV,0,0,0,1,1,4
PEVF,0,0,0,1,1,4
EVFN,0,0,0,1,1,4
VFNY,0,0,0,1,1,4
FNYL,0,0,0,1,1,4
NYLG,0,0,0,1,1,4
YLGI,0,0,0,1,1,4
LGIY,0,0,0,1,1,4
GIYL,0,0,0,1,1,4
IYLT,0,0,0,1,1,4
YLTQ,0,0,0,1,1,4
LTQA,0,0,0,1,1,4
MPGT,0,0,0,1,1,4
PGTA,0,0,0,1,1,4
GTAT,0,0,0,1,1,4
TATH,0,0,0,1,1,4
ATHT,0,0,0,1,1,4
THTV,0,0,0,1,1,4
HTVK,0,0,0,1,1,4
TVKM,0,0,0,1,1,4
VKMF,0,0,0,1,1,4
KMFS,0,0,0,1,1,4
MPYT,0,0,0,1,1,4
PYTD,0,0,0,1,1,4
YTDA,0,0,0,1,1,4
TDAV,0,0,0,1,1,4
AVVH,0,0,0,1,1,4
VVHE,0,0,0,1,1,4
VHEV,0,0,0,1,1,4
HEVQ,0,0,0,1,1,4
EVQR,0,0,0,1,1,4
VQRY,0,0,0,1,1,4
QRYI,0,0,0,1,1,4
RYID,0,0,0,1,1,4
MTDQ,0,0,0,1,1,4
TDQQ,0,0,0,2,2,4
DQQA,0,0,0,1,1,4
QQAE,0,0,0,2,2,4
EARA,0,0,0,1,1,4
ARAF,0,0,0,1,1,4
MVFK,0,0,0,1,1,4
VFKQ,0,0,0,1,1,4
FKQM,0,0,0,1,1,4
KQME,0,0,0,3,3,4
QMEQ,0,0,0,1,1,4
MEQV,0,0,0,1,1,4
EQVA,0,0,0,1,1,4
QVAQ,0,0,0,1,1,4
VAQF,0,0,0,1,1,4
AQFL,0,0,0,1,1,4
QFLK,0,0,0,1,1,4
KAAE,0,0,0,1,1,4
AAED,0,0,0,1,1,4
AEDY,0,0,0,1,1,4
MYSN,0,0,0,1,1,4
YSNR,0,0,0,1,1,4
SNRM,0,0,0,1,1,4
NRMR,0,0,0,1,1,4
RMRS,0,0,0,1,1,4
MRSY,0,0,0,1,1,4
RSYK,0,0,0,1,1,4
SYKQ,0,0,0,1,1,4
YKQE,0,0,0,1,1,4
KQEM,0,0,0,1,1,4
QEMG,0,0,0,1,1,4
EMGK,0,0,0,1,1,4
MGKL,0,0,0,1,1,4
GKLE,0,0,0,2,2,4
KLET,0,0,0,1,1,4
LETD,0,0,0,1,1,4
ETDF,0,0,0,1,1,4
TDFK,0,0,0,1,1,4
DFKR,0,0,0,1,1,4
FKRS,0,0,0,1,1,4
RSRI,0,0,0,1,1,4
NAAG,0,0,0,1,1,4
AAGW,0,0,0,1,1,4
AGWD,0,0,0,1,1,4
GWDL,0,0,0,1,1,4
WDLL,0,0,0,1,1,4
DLLL,0,0,0,1,1,4
LLLT,0,0,0,1,1,4
LLTL,0,0,0,1,1,4
LTLY,0,0,0,1,1,4
TLYR,0,0,0,2,2,4
LYRS,0,0,0,1,1,4
NAAQ,0,0,0,1,1,4
AAQL,0,0,0,2,2,4
AQLD,0,0,0,1,1,4
QLDA,0,0,0,1,1,4
ALAH,0,0,0,1,1,4
LAHA,0,0,0,1,1,4
AHAL,0,0,0,2,2,4
HALL,0,0,0,1,1,4
ALLE,0,0,0,1,1,4
LLEI,0,0,0,1,1,4
LEIP,0,0,0,1,1,4
EIPR,0,0,0,1,1,4
IPRF,0,0,0,1,1,4
PRFS,0,0,0,1,1,4
RFSY,0,0,0,1,1,4
FSYA,0,0,0,1,1,4
SYAT,0,0,0,1,1,4
YATR,0,0,0,1,1,4
NAGQ,0,0,0,1,1,4
AGQA,0,0,0,1,1,4
GQAN,0,0,0,1,1,4
QANE,0,0,0,1,1,4
EFFN,0,0,0,1,1,4
FFNE,0,0,0,1,1,4
FNEF,0,0,0,1,1,4
NEFW,0,0,0,1,1,4
EFWS,0,0,0,1,1,4
NAKI,0,0,0,1,1,4
KIAR,0,0,0,1,1,4
IARI,0,0,0,1,1,4
ARIN,0,0,0,1,1,4
RINE,0,0,0,1,1,4
INEL,0,0,0,3,3,4
NELA,0,0,0,1,1,4
ELAA,0,0,0,2,2,4
AKAG,0,0,0,1,1,4
KAGV,0,0,0,1,1,4
NAKY,0,0,0,1,1,4
AKYV,0,0,0,1,1,4
KYVA,0,0,0,1,1,4
YVAE,0,0,0,2,2,4
VAEA,0,0,0,1,1,4
EATG,0,0,0,1,1,4
ATGN,0,0,0,1,1,4
TGNF,0,0,0,2,2,4
GNFI,0,0,0,1,1,4
NFIT,0,0,0,1,1,4
FITV,0,0,0,1,1,4
ITVM,0,0,0,1,1,4
TVMD,0,0,0,1,1,4
VMDA,0,0,0,1,1,4
MDAL,0,0,0,2,2,4
DALK,0,0,0,3,3,4
NASR,0,0,0,1,1,4
ASRT,0,0,0,1,1,4
SRTV,0,0,0,1,1,4
RTVG,0,0,0,1,1,4
TVGV,0,0,0,1,1,4
VGVV,0,0,0,1,1,4
GVVA,0,0,0,1,1,4
AALL,0,0,0,1,1,4
NDAE,0,0,0,1,1,4
DAEV,0,0,0,1,1,4
AEVK,0,0,0,2,2,4
KIAA,0,0,0,1,1,4
IAAQ,0,0,0,1,1,4
AAQY,0,0,0,1,1,4
AQYG,0,0,0,1,1,4
QYGK,0,0,0,1,1,4
YGKD,0,0,0,1,1,4
NDEE,0,0,0,1,1,4
EETV,0,0,0,1,1,4
ETVA,0,0,0,1,1,4
TVAL,0,0,0,1,1,4
VALT,0,0,0,1,1,4
ALTA,0,0,0,1,1,4
LTAG,0,0,0,1,1,4
TAGG,0,0,0,1,1,4
AGGH,0,0,0,1,1,4
GGHT,0,0,0,1,1,4
NEEV,0,0,0,1,1,4
EEVR,0,0,0,1,1,4
EVRI,0,0,0,1,1,4
VRIE,0,0,0,1,1,4
RIEA,0,0,0,2,2,4
EAII,0,0,0,1,1,4
AIIG,0,0,0,1,1,4
IIGL,0,0,0,1,1,4
IGLS,0,0,0,1,1,4
GLSY,0,0,0,1,1,4
LSYR,0,0,0,1,1,4
NEQD,0,0,0,1,1,4
EQDL,0,0,0,2,2,4
QDLG,0,0,0,1,1,4
DLGI,0,0,0,1,1,4
LGIQ,0,0,0,1,1,4
GIQY,0,0,0,1,1,4
IQYK,0,0,0,1,1,4
QYKA,0,0,0,1,1,4
YKAL,0,0,0,1,1,4
ALKP,0,0,0,1,1,4
LKPE,0,0,0,1,1,4
KPEV,0,0,0,1,1,4
PEVD,0,0,0,1,1,4
EVDK,0,0,0,1,1,4
DKLN,0,0,0,1,1,4
KLNI,0,0,0,2,2,4
LNIM,0,0,0,1,1,4
NIMA,0,0,0,2,2,4
IMAA,0,0,0,1,1,4
MAAK,0,0,0,1,1,4
AAKR,0,0,0,2,2,4
AKRQ,0,0,0,1,1,4
RQQE,0,0,0,1,1,4
QQEL,0,0,0,1,1,4
NEYI,0,0,0,1,1,4
EYIM,0,0,0,1,1,4
YIMS,0,0,0,1,1,4
IMSL,0,0,0,1,1,4
MSLI,0,0,0,1,1,4
SLIS,0,0,0,1,1,4
LISD,0,0,0,1,1,4
ISDN,0,0,0,1,1,4
NFKD,0,0,0,1,1,4
FKDV,0,0,0,1,1,4
KDVI,0,0,0,1,1,4
DVIE,0,0,0,1,1,4
VIET,0,0,0,1,1,4
IETA,0,0,0,1,1,4
ETAK,0,0,0,1,1,4
TAKK,0,0,0,1,1,4
KKVM,0,0,0,1,1,4
KVMN,0,0,0,1,1,4
VMNF,0,0,0,1,1,4
NGET,0,0,0,1,1,4
GETF,0,0,0,1,1,4
ETFL,0,0,0,1,1,4
TFLT,0,0,0,2,2,4
FLTE,0,0,0,1,1,4
LTEL,0,0,0,1,1,4
TELL,0,0,0,1,1,4
ELLD,0,0,0,2,2,4
GLEV,0,0,0,1,1,4
LEVV,0,0,0,1,1,4
EVVK,0,0,0,2,2,4
VVKA,0,0,0,1,1,4
VKAL,0,0,0,1,1,4
LAQG,0,0,0,1,1,4
NIDE,0,0,0,1,1,4
IDEI,0,0,0,1,1,4
EIER,0,0,0,1,1,4
IERK,0,0,0,1,1,4
ERKI,0,0,0,1,1,4
RKID,0,0,0,1,1,4
KIDE,0,0,0,1,1,4
IDEA,0,0,0,1,1,4
DEAI,0,0,0,1,1,4
NIDS,0,0,0,1,1,4
IDSY,0,0,0,1,1,4
DSYL,0,0,0,1,1,4
SYLN,0,0,0,1,1,4
YLNA,0,0,0,1,1,4
LNAV,0,0,0,1,1,4
NAVN,0,0,0,1,1,4
AVNI,0,0,0,1,1,4
VNII,0,0,0,2,2,4
NIIN,0,0,0,1,1,4
IINI,0,0,0,1,1,4
INIF,0,0,0,1,1,4
NIFK,0,0,0,2,2,4
IFKI,0,0,0,1,1,4
NIEQ,0,0,0,1,1,4
IEQL,0,0,0,2,2,4
EQLW,0,0,0,1,1,4
QLWR,0,0,0,1,1,4
LWRD,0,0,0,1,1,4
WRDY,0,0,0,1,1,4
DYNK,0,0,0,1,1,4
YNKY,0,0,0,1,1,4
NKYE,0,0,0,1,1,4
KYEE,0,0,0,1,1,4
YEEG,0,0,0,1,1,4
EEGI,0,0,0,2,2,4
EGIN,0,0,0,1,1,4
NILK,0,0,0,1,1,4
LKQI,0,0,0,2,2,4
KQIF,0,0,0,1,1,4
QIFK,0,0,0,1,1,4
IFKL,0,0,0,1,1,4
FKLL,0,0,0,1,1,4
LLQA,0,0,0,2,2,4
NINE,0,0,0,1,1,4
NELF,0,0,0,1,1,4
ELFI,0,0,0,1,1,4
LFIE,0,0,0,1,1,4
FIEI,0,0,0,1,1,4
IEIS,0,0,0,1,1,4
EISR,0,0,0,1,1,4
ISRR,0,0,0,1,1,4
SRRI,0,0,0,1,1,4
NIPK,0,0,0,1,1,4
IPKH,0,0,0,1,1,4
PKHT,0,0,0,1,1,4
KHTH,0,0,0,1,1,4
HTHR,0,0,0,1,1,4
THRF,0,0,0,1,1,4
HRFF,0,0,0,1,1,4
RFFI,0,0,0,1,1,4
FFIL,0,0,0,1,1,4
FILV,0,0,0,1,1,4
ILVL,0,0,0,1,1,4
LVLE,0,0,0,1,1,4
VLEI,0,0,0,1,1,4
NKDQ,0,0,0,1,1,4
KDQW,0,0,0,1,1,4
DQWE,0,0,0,1,1,4
QWEE,0,0,0,1,1,4
WEER,0,0,0,1,1,4
EERI,0,0,0,2,2,4
ERIQ,0,0,0,1,1,4
RIQV,0,0,0,1,1,4
IQVW,0,0,0,1,1,4
QVWH,0,0,0,1,1,4
VWHE,0,0,0,1,1,4
WHEE,0,0,0,1,1,4
HEEH,0,0,0,1,1,4
NKEE,0,0,0,1,1,4
EEMM,0,0,0,1,1,4
EMMD,0,0,0,1,1,4
MMDI,0,0,0,1,1,4
MDIV,0,0,0,1,1,4
VKAI,0,0,0,1,1,4
KAIY,0,0,0,1,1,4
AIYD,0,0,0,1,1,4
IYDM,0,0,0,1,1,4
YDMM,0,0,0,1,1,4
DMMG,0,0,0,1,1,4
NKLV,0,0,0,1,1,4
KLVD,0,0,0,1,1,4
LVDR,0,0,0,2,2,4
VDRW,0,0,0,1,1,4
DRWL,0,0,0,1,1,4
RWLH,0,0,0,1,1,4
WLHV,0,0,0,1,1,4
LHVR,0,0,0,1,1,4
HVRK,0,0,0,1,1,4
RKHL,0,0,0,1,1,4
KHLL,0,0,0,1,1,4
HLLV,0,0,0,1,1,4
LLVA,0,0,0,2,2,4
LVAY,0,0,0,1,1,4
AYYN,0,0,0,1,1,4
YYNL,0,0,0,1,1,4
YNLV,0,0,0,1,1,4
NLVG,0,0,0,2,2,4
NKQA,0,0,0,1,1,4
KQAD,0,0,0,1,1,4
QADS,0,0,0,1,1,4
ADSI,0,0,0,1,1,4
DSIK,0,0,0,1,1,4
SIKQ,0,0,0,2,2,4
IKQM,0,0,0,1,1,4
QMEE,0,0,0,1,1,4
MEER,0,0,0,1,1,4
EERN,0,0,0,1,1,4
ERNK,0,0,0,1,1,4
RNKK,0,0,0,1,1,4
NKKR,0,0,0,1,1,4
KKRV,0,0,0,2,2,4
RVEN,0,0,0,1,1,4
VENF,0,0,0,1,1,4
ENFK,0,0,0,1,1,4
NFKK,0,0,0,1,1,4
FKKT,0,0,0,1,1,4
KKTG,0,0,0,1,1,4
NKRA,0,0,0,1,1,4
RAVD,0,0,0,1,1,4
AVDW,0,0,0,1,1,4
VDWA,0,0,0,1,1,4
DWAM,0,0,0,1,1,4
WAMR,0,0,0,1,1,4
AMRA,0,0,0,1,1,4
MRAA,0,0,0,1,1,4
AAMA,0,0,0,1,1,4
AMAL,0,0,0,1,1,4
NKSV,0,0,0,1,1,4
KSVG,0,0,0,1,1,4
SVGA,0,0,0,1,1,4
VGAV,0,0,0,1,1,4
GAVY,0,0,0,2,2,4
AVYA,0,0,0,1,1,4
VYAI,0,0,0,1,1,4
YAIL,0,0,0,1,1,4
AILY,0,0,0,1,1,4
LYLS,0,0,0,1,1,4
NLDS,0,0,0,1,1,4
DSIQ,0,0,0,1,1,4
SIQE,0,0,0,1,1,4
IQEE,0,0,0,2,2,4
QEEL,0,0,0,2,2,4
EELA,0,0,0,1,1,4
ELAD,0,0,0,1,1,4
LADV,0,0,0,1,1,4
ADVI,0,0,0,1,1,4
VIAW,0,0,0,1,1,4
IAWT,0,0,0,1,1,4
AWTV,0,0,0,1,1,4
WTVS,0,0,0,1,1,4
TVSI,0,0,0,1,1,4
VSIA,0,0,0,2,2,4
SIAN,0,0,0,1,1,4
IANL,0,0,0,1,1,4
ANLE,0,0,0,1,1,4
NLEG,0,0,0,1,1,4
NLEQ,0,0,0,1,1,4
LEQT,0,0,0,1,1,4
EQTA,0,0,0,1,1,4
QTAR,0,0,0,1,1,4
TARR,0,0,0,1,1,4
ARRW,0,0,0,1,1,4
RRWL,0,0,0,1,1,4
RWLE,0,0,0,1,1,4
WLEE,0,0,0,1,1,4
LEER,0,0,0,2,2,4
EERG,0,0,0,2,2,4
NLES,0,0,0,1,1,4
LESE,0,0,0,1,1,4
ESEI,0,0,0,1,1,4
SEIH,0,0,0,1,1,4
EIHT,0,0,0,1,1,4
IHTV,0,0,0,1,1,4
HTVL,0,0,0,1,1,4
TVLK,0,0,0,1,1,4
VLKH,0,0,0,1,1,4
LKHL,0,0,0,2,2,4
KHLV,0,0,0,1,1,4
HLVE,0,0,0,1,1,4
LVEN,0,0,0,2,2,4
VENN,0,0,0,1,1,4
NLFD,0,0,0,1,1,4
LFDH,0,0,0,1,1,4
FDHF,0,0,0,1,1,4
DHFS,0,0,0,1,1,4
HFSA,0,0,0,1,1,4
FSAV,0,0,0,1,1,4
SAVA,0,0,0,1,1,4
AVAQ,0,0,0,1,1,4
VAQR,0,0,0,2,2,4
NLFP,0,0,0,1,1,4
LFPI,0,0,0,1,1,4
FPIV,0,0,0,1,1,4
PIVF,0,0,0,1,1,4
IVFG,0,0,0,1,1,4
VFGV,0,0,0,1,1,4
FGVI,0,0,0,1,1,4
GVIF,0,0,0,1,1,4
VIFD,0,0,0,1,1,4
IFDA,0,0,0,1,1,4
NLLY,0,0,0,1,1,4
LLYD,0,0,0,1,1,4
LYDI,0,0,0,1,1,4
YDIV,0,0,0,1,1,4
IVKE,0,0,0,2,2,4
VKEN,0,0,0,1,1,4
KENG,0,0,0,1,1,4
NLNQ,0,0,0,1,1,4
LNQS,0,0,0,1,1,4
NQSI,0,0,0,1,1,4
QSID,0,0,0,1,1,4
SIDN,0,0,0,1,1,4
IDNF,0,0,0,1,1,4
DNFV,0,0,0,1,1,4
NFVN,0,0,0,1,1,4
FVNM,0,0,0,1,1,4
VNMA,0,0,0,1,1,4
NMAF,0,0,0,1,1,4
MAFF,0,0,0,1,1,4
AFFA,0,0,0,1,1,4
NLST,0,0,0,1,1,4
LSTL,0,0,0,1,1,4
STLA,0,0,0,1,1,4
AALV,0,0,0,2,2,4
ALVA,0,0,0,2,2,4
LVAA,0,0,0,3,3,4
VAAA,0,0,0,2,2,4
AAAG,0,0,0,1,1,4
NLTQ,0,0,0,1,1,4
LTQL,0,0,0,1,1,4
TQLK,0,0,0,1,1,4
QLKA,0,0,0,1,1,4
LKAS,0,0,0,1,1,4
KASF,0,0,0,2,2,4
ASFA,0,0,0,1,1,4
SFAV,0,0,0,2,2,4
FAVQ,0,0,0,1,1,4
LVAD,0,0,0,2,2,4
ADMR,0,0,0,1,1,4
DMRF,0,0,0,1,1,4
MRFN,0,0,0,1,1,4
RFNV,0,0,0,1,1,4
FNVV,0,0,0,1,1,4
NVVR,0,0,0,1,1,4
VVRE,0,0,0,1,1,4
VRES,0,0,0,1,1,4
RESE,0,0,0,1,1,4
ESEA,0,0,0,1,1,4
SEAR,0,0,0,1,1,4
EARL,0,0,0,1,1,4
ARLQ,0,0,0,2,2,4
LQVS,0,0,0,1,1,4
QVSR,0,0,0,1,1,4
VSRL,0,0,0,1,1,4
SRLY,0,0,0,1,1,4
RLYS,0,0,0,1,1,4
NNAI,0,0,0,1,1,4
NAIT,0,0,0,1,1,4
AITK,0,0,0,1,1,4
ITKG,0,0,0,1,1,4
TKGF,0,0,0,1,1,4
KGFT,0,0,0,1,1,4
GFTA,0,0,0,1,1,4
FTAL,0,0,0,1,1,4
KLLV,0,0,0,1,1,4
NPAA,0,0,0,1,1,4
PAAE,0,0,0,1,1,4
AAEK,0,0,0,1,1,4
EKMQ,0,0,0,1,1,4
KMQV,0,0,0,1,1,4
MQVL,0,0,0,2,2,4
QVLQ,0,0,0,1,1,4
LQVL,0,0,0,1,1,4
VLDR,0,0,0,1,1,4
LDRL,0,0,0,1,1,4
DRLR,0,0,0,1,1,4
RLRG,0,0,0,1,1,4
LRGK,0,0,0,1,1,4
RGKL,0,0,0,1,1,4
GKLQ,0,0,0,1,1,4
LQEK,0,0,0,2,2,4
QEKG,0,0,0,1,1,4
NPAQ,0,0,0,1,1,4
PAQY,0,0,0,1,1,4
AQYL,0,0,0,1,1,4
QYLA,0,0,0,1,1,4
YLAQ,0,0,0,1,1,4
LAQH,0,0,0,1,1,4
AQHE,0,0,0,1,1,4
QHEQ,0,0,0,1,1,4
HEQL,0,0,0,1,1,4
EQLL,0,0,0,2,2,4
NPAR,0,0,0,1,1,4
RALY,0,0,0,1,1,4
ALYQ,0,0,0,1,1,4
LYQT,0,0,0,1,1,4
YQTV,0,0,0,1,1,4
QTVR,0,0,0,1,1,4
TVRE,0,0,0,1,1,4
VREL,0,0,0,1,1,4
LIEN,0,0,0,1,1,4
IENS,0,0,0,1,1,4
ENSL,0,0,0,1,1,4
NSLD,0,0,0,1,1,4
NPEI,0,0,0,1,1,4
PEIL,0,0,0,1,1,4
ILLA,0,0,0,1,1,4
LARV,0,0,0,1,1,4
ARVK,0,0,0,1,1,4
RVKR,0,0,0,1,1,4
VKRF,0,0,0,1,1,4
KRFL,0,0,0,1,1,4
RFLE,0,0,0,1,1,4
FLER,0,0,0,2,2,4
LERE,0,0,0,2,2,4
NPER,0,0,0,1,1,4
PERV,0,0,0,1,1,4
ERVL,0,0,0,1,1,4
RVLL,0,0,0,1,1,4
VLLQ,0,0,0,2,2,4
LLQL,0,0,0,4,4,4
LQLK,0,0,0,1,1,4
QLKY,0,0,0,1,1,4
LKYR,0,0,0,1,1,4
KYRY,0,0,0,1,1,4
YRYD,0,0,0,1,1,4
RYDV,0,0,0,1,1,4
YDVE,0,0,0,1,1,4
DVEI,0,0,0,1,1,4
NPGQ,0,0,0,1,1,4
PGQA,0,0,0,1,1,4
GQAI,0,0,0,1,1,4
QAIW,0,0,0,1,1,4
AIWL,0,0,0,1,1,4
IWLG,0,0,0,1,1,4
WLGE,0,0,0,1,1,4
LGEF,0,0,0,1,1,4
GEFS,0,0,0,1,1,4
EFSK,0,0,0,1,1,4
FSKR,0,0,0,1,1,4
SKRH,0,0,0,1,1,4
NPMI,0,0,0,1,1,4
PMII,0,0,0,1,1,4
MIIE,0,0,0,1,1,4
IIEG,0,0,0,1,1,4
IEGQ,0,0,0,1,1,4
EGQI,0,0,0,1,1,4
GQIH,0,0,0,1,1,4
IHGG,0,0,0,1,1,4
HGGL,0,0,0,1,1,4
GGLT,0,0,0,1,1,4
GLTE,0,0,0,2,2,4
LTEG,0,0,0,3,3,4
TEGY,0,0,0,1,1,4
EGYA,0,0,0,1,1,4
GYAV,0,0,0,1,1,4
YAVA,0,0,0,1,1,4
AVAM,0,0,0,1,1,4
VAMG,0,0,0,1,1,4
NPQV,0,0,0,1,1,4
PQVL,0,0,0,1,1,4
QVLA,0,0,0,1,1,4
VLAD,0,0,0,2,2,4
LADI,0,0,0,1,1,4
ADIG,0,0,0,1,1,4
DIGA,0,0,0,1,1,4
IGAE,0,0,0,1,1,4
GAEA,0,0,0,1,1,4
NPRW,0,0,0,1,1,4
PRWI,0,0,0,1,1,4
RWIG,0,0,0,1,1,4
WIGR,0,0,0,1,1,4
IGRH,0,0,0,1,1,4
GRHK,0,0,0,1,1,4
RHKH,0,0,0,1,1,4
HKHM,0,0,0,1,1,4
KHMF,0,0,0,1,1,4
HMFN,0,0,0,1,1,4
MFNF,0,0,0,1,1,4
FNFL,0,0,0,1,1,4
NFLD,0,0,0,1,1,4
NPVL,0,0,0,1,1,4
PVLQ,0,0,0,1,1,4
LQQH,0,0,0,1,1,4
QQHF,0,0,0,1,1,4
QHFR,0,0,0,1,1,4
HFRN,0,0,0,1,1,4
FRNL,0,0,0,1,1,4
RNLE,0,0,0,1,1,4
NLEA,0,0,0,1,1,4
NQDE,0,0,0,1,1,4
QDEL,0,0,0,2,2,4
DELE,0,0,0,1,1,4
ELEG,0,0,0,1,1,4
LEGY,0,0,0,1,1,4
EGYN,0,0,0,1,1,4
GYNL,0,0,0,1,1,4
YNLF,0,0,0,1,1,4
NLFK,0,0,0,1,1,4
LFKG,0,0,0,1,1,4
FKGS,0,0,0,1,1,4
KGSG,0,0,0,1,1,4
NQPF,0,0,0,1,1,4
QPFA,0,0,0,1,1,4
PFAL,0,0,0,1,1,4
FALE,0,0,0,1,1,4
ALEM,0,0,0,1,1,4
LEMI,0,0,0,1,1,4
EMIK,0,0,0,1,1,4
IKSR,0,0,0,1,1,4
KSRQ,0,0,0,2,2,4
SRQK,0,0,0,1,1,4
RQKK,0,0,0,1,1,4
QKKD,0,0,0,2,2,4
NQRA,0,0,0,1,1,4
RALL,0,0,0,1,1,4
LKSL,0,0,0,2,2,4
KSLQ,0,0,0,2,2,4
SLQD,0,0,0,2,2,4
LQDY,0,0,0,1,1,4
QDYR,0,0,0,1,1,4
DYRQ,0,0,0,1,1,4
YRQH,0,0,0,1,1,4
RQHL,0,0,0,1,1,4
QHLD,0,0,0,1,1,4
HLDQ,0,0,0,1,1,4
DQLI,0,0,0,1,1,4
QLIT,0,0,0,1,1,4
ITLI,0,0,0,1,1,4
LISN,0,0,0,1,1,4
NREA,0,0,0,1,1,4
REAN,0,0,0,1,1,4
EANL,0,0,0,1,1,4
ANLQ,0,0,0,1,1,4
NLQA,0,0,0,1,1,4
LQAL,0,0,0,1,1,4
QALI,0,0,0,1,1,4
LIAT,0,0,0,1,1,4
IATG,0,0,0,1,1,4
NRKM,0,0,0,1,1,4
RKMA,0,0,0,1,1,4
KMAM,0,0,0,1,1,4
MAMG,0,0,0,1,1,4
AMGR,0,0,0,1,1,4
MGRK,0,0,0,1,1,4
GRKK,0,0,0,1,1,4
RKKF,0,0,0,1,1,4
KKFN,0,0,0,1,1,4
KFNM,0,0,0,1,1,4
FNMD,0,0,0,1,1,4
NSDQ,0,0,0,1,1,4
SDQD,0,0,0,1,1,4
DQDA,0,0,0,1,1,4
QDAG,0,0,0,1,1,4
DAGI,0,0,0,1,1,4
AGIA,0,0,0,1,1,4
GIAI,0,0,0,1,1,4
IAII,0,0,0,1,1,4
AIIR,0,0,0,1,1,4
IIRR,0,0,0,1,1,4
IRRA,0,0,0,1,1,4
RRAL,0,0,0,2,2,4
NSNH,0,0,0,1,1,4
SNHQ,0,0,0,1,1,4
NHQM,0,0,0,1,1,4
HQML,0,0,0,1,1,4
QMLL,0,0,0,1,1,4
MLLV,0,0,0,1,1,4
LLVQ,0,0,0,3,3,4
LVQQ,0,0,0,1,1,4
VQQA,0,0,0,1,1,4
QAED,0,0,0,1,1,4
AEDK,0,0,0,1,1,4
EDKI,0,0,0,1,1,4
IKEL,0,0,0,3,3,4
KELL,0,0,0,1,1,4
ELLN,0,0,0,1,1,4
LLNT,0,0,0,1,1,4
NSNT,0,0,0,1,1,4
SNTF,0,0,0,1,1,4
NTFL,0,0,0,1,1,4
FLTR,0,0,0,1,1,4
LTRL,0,0,0,2,2,4
TRLL,0,0,0,1,1,4
RLLV,0,0,0,1,1,4
LLVH,0,0,0,1,1,4
LVHM,0,0,0,1,1,4
SRER,0,0,0,1,1,4
RERE,0,0,0,1,1,4
EREM,0,0,0,2,2,4
REMF,0,0,0,1,1,4
EMFV,0,0,0,1,1,4
MFVQ,0,0,0,1,1,4
FVQE,0,0,0,1,1,4
VQEV,0,0,0,2,2,4
QEVR,0,0,0,1,1,4
EVRR,0,0,0,2,2,4
VRRY,0,0,0,1,1,4
RRYY,0,0,0,1,1,4
NSSD,0,0,0,1,1,4
SSDS,0,0,0,1,1,4
SDSI,0,0,0,1,1,4
DSID,0,0,0,1,1,4
SIDW,0,0,0,1,1,4
IDWL,0,0,0,1,1,4
DWLT,0,0,0,1,1,4
WLTS,0,0,0,1,1,4
LTSM,0,0,0,1,1,4
NSVL,0,0,0,1,1,4
SVLR,0,0,0,1,1,4
VLRA,0,0,0,1,1,4
LRAV,0,0,0,2,2,4
AVAE,0,0,0,2,2,4
VAEV,0,0,0,1,1,4
AEVY,0,0,0,2,2,4
NTDT,0,0,0,1,1,4
TDTL,0,0,0,1,1,4
DTLE,0,0,0,2,2,4
TLER,0,0,0,1,1,4
LERV,0,0,0,1,1,4
ERVT,0,0,0,1,1,4
RVTE,0,0,0,1,1,4
VTEI,0,0,0,1,1,4
TEIF,0,0,0,1,1,4
IFKA,0,0,0,1,1,4
NTEK,0,0,0,1,1,4
TEKL,0,0,0,1,1,4
LLKT,0,0,0,1,1,4
LKTV,0,0,0,1,1,4
KTVP,0,0,0,1,1,4
TVPI,0,0,0,1,1,4
VPII,0,0,0,1,1,4
PIIQ,0,0,0,1,1,4
IIQN,0,0,0,1,1,4
IQNQ,0,0,0,1,1,4
QNQM,0,0,0,1,1,4
NQMD,0,0,0,1,1,4
QMDA,0,0,0,1,1,4
DALL,0,0,0,1,1,4
ALLD,0,0,0,1,1,4
NTPE,0,0,0,1,1,4
TPEA,0,0,0,1,1,4
PEAY,0,0,0,1,1,4
EAYS,0,0,0,1,1,4
AYSV,0,0,0,1,1,4
YSVL,0,0,0,1,1,4
SVLF,0,0,0,2,2,4
VLFD,0,0,0,1,1,4
LFDM,0,0,0,1,1,4
FDMA,0,0,0,1,1,4
DMAR,0,0,0,1,1,4
MARE,0,0,0,1,1,4
AREV,0,0,0,1,1,4
REVN,0,0,0,1,1,4
VNRL,0,0,0,2,2,4
NRLK,0,0,0,1,1,4
RLKA,0,0,0,1,1,4
LKAE,0,0,0,1,1,4
KAED,0,0,0,1,1,4
VGKA,0,0,0,1,1,4
GKAW,0,0,0,1,1,4
KAWA,0,0,0,1,1,4
AWAE,0,0,0,2,2,4
WAED,0,0,0,1,1,4
AEDV,0,0,0,2,2,4
EDVL,0,0,0,1,1,4
LALV,0,0,0,1,1,4
ALVK,0,0,0,1,1,4
LVKH,0,0,0,1,1,4
NVKD,0,0,0,2,2,4
VKDL,0,0,0,1,1,4
KDLA,0,0,0,2,2,4
DLAD,0,0,0,1,1,4
ADAA,0,0,0,1,1,4
DAAK,0,0,0,1,1,4
AKRT,0,0,0,1,1,4
VKDV,0,0,0,1,1,4
KDVT,0,0,0,1,1,4
DVTK,0,0,0,1,1,4
VTKL,0,0,0,1,1,4
TKLV,0,0,0,1,1,4
NWDD,0,0,0,1,1,4
WDDM,0,0,0,1,1,4
DDME,0,0,0,1,1,4
DMEK,0,0,0,1,1,4
MEKI,0,0,0,1,1,4
EKIW,0,0,0,1,1,4
KIWH,0,0,0,1,1,4
IWHH,0,0,0,1,1,4
WHHT,0,0,0,1,1,4
HHTF,0,0,0,1,1,4
HTFY,0,0,0,1,1,4
TFYN,0,0,0,1,1,4
NYAH,0,0,0,1,1,4
YAHL,0,0,0,1,1,4
AHLN,0,0,0,1,1,4
HLNR,0,0,0,1,1,4
LNRG,0,0,0,1,1,4
NRGI,0,0,0,1,1,4
RGIA,0,0,0,1,1,4
GIAL,0,0,0,1,1,4
IALY,0,0,0,1,1,4
ALYY,0,0,0,1,1,4
LYYG,0,0,0,1,1,4
NYEE,0,0,0,1,1,4
YEEI,0,0,0,1,1,4
EEIY,0,0,0,2,2,4
EIYI,0,0,0,1,1,4
IYIL,0,0,0,1,1,4
YILN,0,0,0,1,1,4
ILNH,0,0,0,1,1,4
LNHI,0,0,0,1,1,4
NHIL,0,0,0,1,1,4
HILR,0,0,0,1,1,4
NYEK,0,0,0,1,1,4
YEKF,0,0,0,1,1,4
EKFS,0,0,0,1,1,4
KFSE,0,0,0,1,1,4
SETK,0,0,0,1,1,4
ETKE,0,0,0,1,1,4
TKER,0,0,0,2,2,4
KERL,0,0,0,2,2,4
RLLE,0,0,0,2,2,4
LLEK,0,0,0,2,2,4
PAER,0,0,0,1,1,4
AERY,0,0,0,1,1,4
ERYY,0,0,0,1,1,4
RYYR,0,0,0,1,1,4
YYRD,0,0,0,1,1,4
YRDA,0,0,0,1,1,4
RDAR,0,0,0,1,1,4
DARI,0,0,0,1,1,4
ARIT,0,0,0,1,1,4
PALD,0,0,0,1,1,4
ALDI,0,0,0,1,1,4
LDIL,0,0,0,1,1,4
DILK,0,0,0,1,1,4
ILKA,0,0,0,2,2,4
KALV,0,0,0,1,1,4
ALVD,0,0,0,2,2,4
LVDN,0,0,0,1,1,4
VDNL,0,0,0,1,1,4
DNLY,0,0,0,2,2,4
NLYV,0,0,0,1,1,4
LYVE,0,0,0,1,1,4
YVEN,0,0,0,1,1,4
PATS,0,0,0,1,1,4
ATSR,0,0,0,1,1,4
TSRK,0,0,0,1,1,4
SRKI,0,0,0,2,2,4
RKIF,0,0,0,2,2,4
KIFK,0,0,0,1,1,4
IFKY,0,0,0,1,1,4
FKYI,0,0,0,1,1,4
KYIR,0,0,0,1,1,4
YIRE,0,0,0,1,1,4
IREL,0,0,0,3,3,4
RELD,0,0,0,1,1,4
PDEV,0,0,0,1,1,4
DEVS,0,0,0,1,1,4
EVSA,0,0,0,1,1,4
VSAL,0,0,0,1,1,4
ALRR,0,0,0,2,2,4
LRRT,0,0,0,1,1,4
RRTT,0,0,0,1,1,4
RTTE,0,0,0,1,1,4
TTEK,0,0,0,1,1,4
TEKN,0,0,0,1,1,4
EKNT,0,0,0,1,1,4
KNTT,0,0,0,1,1,4
NTTT,0,0,0,1,1,4
TTTL,0,0,0,1,1,4
TTLI,0,0,0,1,1,4
TLIN,0,0,0,1,1,4
LINL,0,0,0,1,1,4
INLA,0,0,0,2,2,4
NLAK,0,0,0,1,1,4
AKQH,0,0,0,1,1,4
PDFR,0,0,0,1,1,4
DFRK,0,0,0,1,1,4
AFKR,0,0,0,2,2,4
KRLL,0,0,0,1,1,4
PDIK,0,0,0,1,1,4
DIKA,0,0,0,1,1,4
IKAQ,0,0,0,1,1,4
KAQY,0,0,0,1,1,4
AQYQ,0,0,0,1,1,4
QYQQ,0,0,0,1,1,4
YQQR,0,0,0,1,1,4
QQRW,0,0,0,1,1,4
QRWL,0,0,0,1,1,4
PDYR,0,0,0,1,1,4
DYRE,0,0,0,1,1,4
YREV,0,0,0,1,1,4
REVM,0,0,0,1,1,4
EVME,0,0,0,1,1,4
VMET,0,0,0,1,1,4
METF,0,0,0,1,1,4
ETFQ,0,0,0,1,1,4
TFQE,0,0,0,1,1,4
PEAL,0,0,0,1,1,4
ALTV,0,0,0,1,1,4
TVAA,0,0,0,1,1,4
AATE,0,0,0,1,1,4
ATEV,0,0,0,1,1,4
TEVR,0,0,0,1,1,4
VRRI,0,0,0,1,1,4
RIRD,0,0,0,1,1,4
IRDR,0,0,0,1,1,4
RDRA,0,0,0,1,1,4
DRAI,0,0,0,1,1,4
AIQS,0,0,0,1,1,4
IQSD,0,0,0,1,1,4
QSDA,0,0,0,1,1,4
SDAQ,0,0,0,1,1,4
DAQV,0,0,0,1,1,4
QVAP,0,0,0,1,1,4
VAPM,0,0,0,1,1,4
APMT,0,0,0,1,1,4
PMTT,0,0,0,1,1,4
PEDF,0,0,0,1,1,4
EDFA,0,0,0,1,1,4
DFAN,0,0,0,2,2,4
FANH,0,0,0,1,1,4
ANHL,0,0,0,1,1,4
NHLF,0,0,0,1,1,4
HLFT,0,0,0,1,1,4
LFTV,0,0,0,1,1,4
FTVF,0,0,0,1,1,4
TVFD,0,0,0,1,1,4
PEKE,0,0,0,1,1,4
EKEA,0,0,0,2,2,4
EAVT,0,0,0,1,1,4
AVTL,0,0,0,1,1,4
VTLG,0,0,0,1,1,4
TLGI,0,0,0,1,1,4
LGIK,0,0,0,1,1,4
GIKA,0,0,0,1,1,4
IKAL,0,0,0,1,1,4
ALKS,0,0,0,2,2,4
LKSS,0,0,0,1,1,4
PEVQ,0,0,0,2,2,4
EVQI,0,0,0,1,1,4
VQIA,0,0,0,1,1,4
QIAI,0,0,0,1,1,4
IAIL,0,0,0,1,1,4
ILTE,0,0,0,1,1,4
LTEQ,0,0,0,1,1,4
TEQI,0,0,0,1,1,4
EQIN,0,0,0,1,1,4
QINN,0,0,0,1,1,4
INNL,0,0,0,1,1,4
NLNE,0,0,0,1,1,4
LNEH,0,0,0,1,1,4
NEHL,0,0,0,1,1,4
HLRV,0,0,0,1,1,4
PEYE,0,0,0,1,1,4
EYEH,0,0,0,1,1,4
YEHL,0,0,0,1,1,4
EHLY,0,0,0,1,1,4
HLYT,0,0,0,1,1,4
LYTE,0,0,0,1,1,4
YTEL,0,0,0,1,1,4
TELT,0,0,0,1,1,4
ELTG,0,0,0,1,1,4
LTGT,0,0,0,1,1,4
TGTI,0,0,0,1,1,4
GTIV,0,0,0,1,1,4
TIVL,0,0,0,1,1,4
IVLL,0,0,0,1,1,4
VLLI,0,0,0,1,1,4
LLIE,0,0,0,2,2,4
LIES,0,0,0,1,1,4
PGLR,0,0,0,1,1,4
GLRR,0,0,0,1,1,4
LRRA,0,0,0,2,2,4
RRAW,0,0,0,1,1,4
RAWK,0,0,0,1,1,4
AWKR,0,0,0,1,1,4
WKRL,0,0,0,1,1,4
PGRI,0,0,0,1,1,4
GRIQ,0,0,0,1,1,4
RIQR,0,0,0,1,1,4
IQRV,0,0,0,1,1,4
QRVA,0,0,0,1,1,4
RVAR,0,0,0,1,1,4
ARGS,0,0,0,1,1,4
PIAF,0,0,0,1,1,4
IAFI,0,0,0,1,1,4
AFIH,0,0,0,1,1,4
FIHK,0,0,0,1,1,4
IHKA,0,0,0,1,1,4
HKAI,0,0,0,1,1,4
PIDI,0,0,0,1,1,4
IDID,0,0,0,1,1,4
DIDY,0,0,0,1,1,4
IDYM,0,0,0,1,1,4
DYMI,0,0,0,1,1,4
YMIS,0,0,0,1,1,4
MISD,0,0,0,1,1,4
ISDT,0,0,0,1,1,4
SDTL,0,0,0,1,1,4
TLEL,0,0,0,1,1,4
LELL,0,0,0,2,2,4
ELLR,0,0,0,2,2,4
PIEA,0,0,0,1,1,4
IEAF,0,0,0,1,1,4
EAFL,0,0,0,1,1,4
FLRL,0,0,0,1,1,4
LRLN,0,0,0,1,1,4
RLNE,0,0,0,1,1,4
LNEE,0,0,0,1,1,4
NEEL,0,0,0,1,1,4
PIKF,0,0,0,1,1,4
IKFI,0,0,0,1,1,4
KFIR,0,0,0,1,1,4
FIRK,0,0,0,1,1,4
IRKA,0,0,0,1,1,4
PKAY,0,0,0,1,1,4
AYAQ,0,0,0,1,1,4
YAQH,0,0,0,1,1,4
AQHV,0,0,0,1,1,4
QHVF,0,0,0,1,1,4
HVFR,0,0,0,1,1,4
VFRS,0,0,0,1,1,4
PKPL,0,0,0,1,1,4
KPLV,0,0,0,1,1,4
PLVS,0,0,0,1,1,4
LVSF,0,0,0,2,2,4
VSFF,0,0,0,1,1,4
SFFQ,0,0,0,1,1,4
FFQS,0,0,0,1,1,4
FQSL,0,0,0,1,1,4
QSLL,0,0,0,1,1,4
SLLQ,0,0,0,3,3,4
LQLV,0,0,0,2,2,4
QLVN,0,0,0,1,1,4
LVNH,0,0,0,1,1,4
VNHD,0,0,0,1,1,4
NHDL,0,0,0,1,1,4
HDLL,0,0,0,1,1,4
DLLE,0,0,0,1,1,4
LLEQ,0,0,0,1,1,4
LEQQ,0,0,0,2,2,4
EQQN,0,0,0,1,1,4
PLEE,0,0,0,1,1,4
EELF,0,0,0,1,1,4
ELFL,0,0,0,1,1,4
LFLE,0,0,0,2,2,4
FLEQ,0,0,0,1,1,4
LEQL,0,0,0,1,1,4
QLEA,0,0,0,1,1,4
PLGR,0,0,0,1,1,4
LGRL,0,0,0,1,1,4
GRLI,0,0,0,1,1,4
RLIH,0,0,0,1,1,4
LIHM,0,0,0,1,1,4
IHMV,0,0,0,1,1,4
HMVN,0,0,0,1,1,4
MVNQ,0,0,0,1,1,4
VNQK,0,0,0,1,1,4
NQKK,0,0,0,1,1,4
KKDR,0,0,0,1,1,4
KDRL,0,0,0,1,1,4
DRLL,0,0,0,1,1,4
RLLN,0,0,0,1,1,4
LLNE,0,0,0,1,1,4
LNEY,0,0,0,1,1,4
NEYL,0,0,0,1,1,4
EYLS,0,0,0,1,1,4
PLTK,0,0,0,1,1,4
TKGI,0,0,0,1,1,4
KGIL,0,0,0,1,1,4
GILG,0,0,0,1,1,4
ILGF,0,0,0,1,1,4
LGFV,0,0,0,1,1,4
GFVF,0,0,0,1,1,4
FVFT,0,0,0,1,1,4
FTLT,0,0,0,1,1,4
PNDM,0,0,0,1,1,4
NDMS,0,0,0,1,1,4
DMSR,0,0,0,1,1,4
MSRI,0,0,0,1,1,4
SRIF,0,0,0,1,1,4
RIFN,0,0,0,1,1,4
IFNI,0,0,0,1,1,4
FNIV,0,0,0,1,1,4
NIVK,0,0,0,2,2,4
VKES,0,0,0,1,1,4
KESL,0,0,0,1,1,4
PNGP,0,0,0,1,1,4
NGPT,0,0,0,1,1,4
GPTH,0,0,0,1,1,4
PTHA,0,0,0,1,1,4
THAP,0,0,0,1,1,4
HAPW,0,0,0,1,1,4
APWL,0,0,0,1,1,4
PWLL,0,0,0,1,1,4
LAHK,0,0,0,1,1,4
AHKI,0,0,0,1,1,4
HKIQ,0,0,0,1,1,4
PQHE,0,0,0,1,1,4
QHER,0,0,0,1,1,4
HERD,0,0,0,1,1,4
ERDV,0,0,0,1,1,4
RDVI,0,0,0,1,1,4
DVIY,0,0,0,1,1,4
VIYE,0,0,0,1,1,4
IYEE,0,0,0,1,1,4
YEEE,0,0,0,1,1,4
EEES,0,0,0,1,1,4
PQSY,0,0,0,1,1,4
QSYA,0,0,0,1,1,4
SYAM,0,0,0,1,1,4
YAMA,0,0,0,1,1,4
AMAI,0,0,0,1,1,4
MAIA,0,0,0,1,1,4
IARQ,0,0,0,1,1,4
ARQE,0,0,0,1,1,4
RQES,0,0,0,1,1,4
QESA,0,0,0,1,1,4
PQYA,0,0,0,1,1,4
QYAL,0,0,0,2,2,4
YALE,0,0,0,1,1,4
ALEL,0,0,0,1,1,4
LLTV,0,0,0,1,1,4
LTVY,0,0,0,1,1,4
TVYA,0,0,0,1,1,4
VYAW,0,0,0,1,1,4
YAWE,0,0,0,1,1,4
AWEQ,0,0,0,1,1,4
WEQG,0,0,0,1,1,4
EQGS,0,0,0,1,1,4
PQYS,0,0,0,1,1,4
QYSQ,0,0,0,1,1,4
YSQA,0,0,0,1,1,4
SQAR,0,0,0,1,1,4
ARVM,0,0,0,1,1,4
RVML,0,0,0,1,1,4
VMLV,0,0,0,1,1,4
MLVK,0,0,0,1,1,4
LVKT,0,0,0,1,1,4
KTIS,0,0,0,1,1,4
TISM,0,0,0,1,1,4
ISMI,0,0,0,1,1,4
SMIS,0,0,0,1,1,4
MISI,0,0,0,1,1,4
ISIV,0,0,0,1,1,4
SIVD,0,0,0,1,1,4
IVDD,0,0,0,1,1,4
VDDT,0,0,0,1,1,4
DDTF,0,0,0,1,1,4
DTFD,0,0,0,1,1,4
TFDA,0,0,0,1,1,4
PRES,0,0,0,1,1,4
RESF,0,0,0,1,1,4
ESFA,0,0,0,1,1,4
FAVL,0,0,0,1,1,4
AVLA,0,0,0,1,1,4
VLAS,0,0,0,1,1,4
ASAL,0,0,0,1,1,4
SALA,0,0,0,1,1,4
LALM,0,0,0,1,1,4
ALMA,0,0,0,1,1,4
LMAA,0,0,0,1,1,4
MAAV,0,0,0,1,1,4
AAVF,0,0,0,1,1,4
AVFE,0,0,0,2,2,4
VFER,0,0,0,1,1,4
ERLA,0,0,0,1,1,4
RLAV,0,0,0,1,1,4
LAVE,0,0,0,1,1,4
VEIR,0,0,0,1,1,4
EIRE,0,0,0,1,1,4
PRRQ,0,0,0,1,1,4
RRQQ,0,0,0,1,1,4
RQQS,0,0,0,1,1,4
QQSL,0,0,0,1,1,4
SLAL,0,0,0,1,1,4
LALR,0,0,0,1,1,4
ALRW,0,0,0,1,1,4
LRWL,0,0,0,1,1,4
RWLV,0,0,0,1,1,4
WLVQ,0,0,0,1,1,4
LVQA,0,0,0,3,3,4
VQAA,0,0,0,1,1,4
QAAN,0,0,0,1,1,4
PSAL,0,0,0,1,1,4
SALI,0,0,0,2,2,4
LIDQ,0,0,0,2,2,4
IDQE,0,0,0,1,1,4
DQEI,0,0,0,1,1,4
QEIN,0,0,0,1,1,4
EINV,0,0,0,1,1,4
INVL,0,0,0,1,1,4
NVLR,0,0,0,2,2,4
VLRQ,0,0,0,1,1,4
LRQQ,0,0,0,1,1,4
RQQA,0,0,0,1,1,4
QQAA,0,0,0,1,1,4
QAAQ,0,0,0,1,1,4
AQRF,0,0,0,1,1,4
PSDQ,0,0,0,1,1,4
SDQQ,0,0,0,1,1,4
DQQN,0,0,0,1,1,4
QQNE,0,0,0,1,1,4
QNEM,0,0,0,1,1,4
NEMV,0,0,0,1,1,4
MVRE,0,0,0,1,1,4
PSFF,0,0,0,1,1,4
SFFR,0,0,0,1,1,4
FFRL,0,0,0,1,1,4
LHKY,0,0,0,1,1,4
HKYM,0,0,0,1,1,4
KYMD,0,0,0,1,1,4
YMDN,0,0,0,1,1,4
MDNI,0,0,0,1,1,4
DNIF,0,0,0,1,1,4
IFKK,0,0,0,1,1,4
FKKH,0,0,0,1,1,4
KKHT,0,0,0,1,1,4
KHTD,0,0,0,1,1,4
PSSQ,0,0,0,1,1,4
SSQI,0,0,0,1,1,4
SQIV,0,0,0,1,1,4
QIVG,0,0,0,1,1,4
IVGT,0,0,0,1,1,4
VGTQ,0,0,0,1,1,4
GTQA,0,0,0,1,1,4
TQAV,0,0,0,1,1,4
QAVF,0,0,0,1,1,4
AVFN,0,0,0,1,1,4
VFNV,0,0,0,1,1,4
FNVM,0,0,0,1,1,4
NVMM,0,0,0,1,1,4
VMMG,0,0,0,1,1,4
PSVV,0,0,0,1,1,4
SVVA,0,0,0,1,1,4
VVAN,0,0,0,1,1,4
VANT,0,0,0,1,1,4
ANTV,0,0,0,1,1,4
NTVK,0,0,0,1,1,4
TVKG,0,0,0,1,1,4
VKGG,0,0,0,1,1,4
PTKE,0,0,0,1,1,4
KERE,0,0,0,1,1,4
EREQ,0,0,0,2,2,4
EQVI,0,0,0,1,1,4
QVIA,0,0,0,2,2,4
VIAH,0,0,0,1,1,4
IAHL,0,0,0,1,1,4
AHLG,0,0,0,1,1,4
HLGL,0,0,0,1,1,4
PTLL,0,0,0,1,1,4
TLLD,0,0,0,2,2,4
LDLF,0,0,0,1,1,4
DLFA,0,0,0,1,1,4
LFAE,0,0,0,2,2,4
FAED,0,0,0,1,1,4
AEDI,0,0,0,1,1,4
EDIG,0,0,0,1,1,4
DIGH,0,0,0,1,1,4
IGHA,0,0,0,1,1,4
GHAN,0,0,0,1,1,4
HANQ,0,0,0,1,1,4
ANQL,0,0,0,1,1,4
QLLQ,0,0,0,1,1,4
QLVD,0,0,0,2,2,4
LVDE,0,0,0,1,1,4
VDEE,0,0,0,1,1,4
DEEF,0,0,0,1,1,4
EEFQ,0,0,0,1,1,4
EFQA,0,0,0,1,1,4
FQAL,0,0,0,1,1,4
QALE,0,0,0,1,1,4
ALER,0,0,0,1,1,4
PVSD,0,0,0,1,1,4
VSDT,0,0,0,1,1,4
SDTM,0,0,0,1,1,4
DTMD,0,0,0,1,1,4
TMDM,0,0,0,1,1,4
MDML,0,0,0,1,1,4
DMLT,0,0,0,1,1,4
MLTK,0,0,0,1,1,4
PWTQ,0,0,0,1,1,4
WTQR,0,0,0,1,1,4
TQRF,0,0,0,1,1,4
QRFF,0,0,0,1,1,4
FFES,0,0,0,1,1,4
FESF,0,0,0,1,1,4
ESFG,0,0,0,1,1,4
QAGN,0,0,0,1,1,4
AGNY,0,0,0,1,1,4
GNYA,0,0,0,1,1,4
NYAS,0,0,0,1,1,4
YASM,0,0,0,1,1,4
ASMF,0,0,0,1,1,4
SMFW,0,0,0,1,1,4
MFWL,0,0,0,1,1,4
FWLT,0,0,0,1,1,4
QAKE,0,0,0,2,2,4
AKEV,0,0,0,1,1,4
EVLK,0,0,0,1,1,4
VLKQ,0,0,0,1,1,4
LKQH,0,0,0,3,3,4
KQHF,0,0,0,1,1,4
QHFE,0,0,0,1,1,4
HFEK,0,0,0,1,1,4
ARVW,0,0,0,1,1,4
RVWV,0,0,0,1,1,4
VWVA,0,0,0,1,1,4
WVAR,0,0,0,1,1,4
VARA,0,0,0,1,1,4
RAVS,0,0,0,1,1,4
VSEH,0,0,0,1,1,4
SEHQ,0,0,0,1,1,4
EHQR,0,0,0,1,1,4
HQRF,0,0,0,1,1,4
QRFT,0,0,0,1,1,4
RFTA,0,0,0,1,1,4
QAST,0,0,0,1,1,4
STGS,0,0,0,1,1,4
TGSL,0,0,0,1,1,4
SLLN,0,0,0,1,1,4
NILR,0,0,0,1,1,4
QDDV,0,0,0,1,1,4
DDVL,0,0,0,1,1,4
DVLE,0,0,0,1,1,4
VLEA,0,0,0,2,2,4
EALS,0,0,0,1,1,4
LSAA,0,0,0,1,1,4
SAAV,0,0,0,1,1,4
AAVR,0,0,0,1,1,4
DELV,0,0,0,1,1,4
ELVW,0,0,0,1,1,4
LVWG,0,0,0,1,1,4
VWGA,0,0,0,1,1,4
WGAY,0,0,0,1,1,4
GAYW,0,0,0,1,1,4
AYWL,0,0,0,1,1,4
YWLY,0,0,0,1,1,4
WLYK,0,0,0,1,1,4
LYKA,0,0,0,1,1,4
YKAT,0,0,0,1,1,4
QDLL,0,0,0,1,1,4
DLLD,0,0,0,1,1,4
LLDR,0,0,0,1,1,4
LDRV,0,0,0,1,1,4
RVLA,0,0,0,1,1,4
VLAA,0,0,0,2,2,4
LAAH,0,0,0,1,1,4
AAHA,0,0,0,1,1,4
AHAY,0,0,0,1,1,4
HAYW,0,0,0,1,1,4
AYWS,0,0,0,1,1,4
YWSQ,0,0,0,1,1,4
QEWV,0,0,0,1,1,4
EWVE,0,0,0,1,1,4
WVEL,0,0,0,1,1,4
VELM,0,0,0,1,1,4
ELMV,0,0,0,1,1,4
LMVE,0,0,0,1,1,4
MVEA,0,0,0,1,1,4
VEAK,0,0,0,1,1,4
EAKE,0,0,0,1,1,4
QFRR,0,0,0,1,1,4
FRRG,0,0,0,1,1,4
RRGA,0,0,0,1,1,4
RGAN,0,0,0,1,1,4
GANF,0,0,0,1,1,4
ANFK,0,0,0,1,1,4
NFKF,0,0,0,1,1,4
FKFE,0,0,0,1,1,4
KFEL,0,0,0,1,1,4
FELG,0,0,0,1,1,4
ELGE,0,0,0,1,1,4
LGEI,0,0,0,1,1,4
EILE,0,0,0,1,1,4
LEND,0,0,0,1,1,4
QFSR,0,0,0,1,1,4
FSRQ,0,0,0,1,1,4
SRQM,0,0,0,1,1,4
RQML,0,0,0,1,1,4
QMLD,0,0,0,1,1,4
MLDR,0,0,0,1,1,4
LDRK,0,0,0,1,1,4
DRKL,0,0,0,1,1,4
LLLG,0,0,0,1,1,4
QGLA,0,0,0,1,1,4
GLAE,0,0,0,1,1,4
EKIF,0,0,0,1,1,4
KIFW,0,0,0,1,1,4
IFWS,0,0,0,1,1,4
FWSL,0,0,0,1,1,4
WSLK,0,0,0,1,1,4
QHLA,0,0,0,1,1,4
AKLE,0,0,0,1,1,4
KLEM,0,0,0,1,1,4
LEMK,0,0,0,1,1,4
EMKI,0,0,0,1,1,4
MKIF,0,0,0,1,1,4
KIFF,0,0,0,1,1,4
IFFE,0,0,0,1,1,4
FFEE,0,0,0,1,1,4
FEEL,0,0,0,1,1,4
IKQT,0,0,0,1,1,4
KQTN,0,0,0,1,1,4
QTNA,0,0,0,1,1,4
TNAG,0,0,0,1,1,4
NAGA,0,0,0,1,1,4
AGAV,0,0,0,1,1,4
AVYR,0,0,0,1,1,4
VYRL,0,0,0,1,1,4
YRLI,0,0,0,1,1,4
RLID,0,0,0,1,1,4
IDQL,0,0,0,1,1,4
DQLG,0,0,0,1,1,4
QINE,0,0,0,1,1,4
INEM,0,0,0,1,1,4
NEMH,0,0,0,1,1,4
EMHL,0,0,0,1,1,4
MHLL,0,0,0,1,1,4
HLLI,0,0,0,1,1,4
LIQQ,0,0,0,2,2,4
IQQA,0,0,0,1,1,4
QQAR,0,0,0,1,1,4
QIPR,0,0,0,1,1,4
IPRI,0,0,0,1,1,4
PRIA,0,0,0,1,1,4
RIAR,0,0,0,1,1,4
AREK,0,0,0,1,1,4
REKI,0,0,0,2,2,4
EKIR,0,0,0,1,1,4
KIRG,0,0,0,1,1,4
IRGL,0,0,0,1,1,4
RGLT,0,0,0,1,1,4
LTEY,0,0,0,1,1,4
TEYF,0,0,0,1,1,4
QLEE,0,0,0,1,1,4
EESM,0,0,0,1,1,4
SMLY,0,0,0,1,1,4
MLYS,0,0,0,1,1,4
LYSL,0,0,0,1,1,4
YSLN,0,0,0,1,1,4
QLLR,0,0,0,2,2,4
LLRG,0,0,0,1,1,4
LRGV,0,0,0,1,1,4
RGVG,0,0,0,1,1,4
GVGA,0,0,0,1,1,4
VGAA,0,0,0,1,1,4
GAAA,0,0,0,1,1,4
AAAT,0,0,0,1,1,4
AATA,0,0,0,2,2,4
ATAV,0,0,0,1,1,4
TAVT,0,0,0,1,1,4
AVTQ,0,0,0,1,1,4
VTQA,0,0,0,1,1,4
TQAL,0,0,0,1,1,4
QALN,0,0,0,1,1,4
ALNE,0,0,0,1,1,4
LNEL,0,0,0,1,1,4
ELLQ,0,0,0,2,2,4
LLQH,0,0,0,2,2,4
LQHV,0,0,0,1,1,4
QHVK,0,0,0,1,1,4
HVKA,0,0,0,1,1,4
VDRL,0,0,0,1,1,4
DRLD,0,0,0,1,1,4
RLDQ,0,0,0,1,1,4
LDQS,0,0,0,1,1,4
DQSW,0,0,0,1,1,4
QSWQ,0,0,0,1,1,4
SWQY,0,0,0,1,1,4
WQYY,0,0,0,1,1,4
QYYQ,0,0,0,1,1,4
YYQD,0,0,0,1,1,4
YQDR,0,0,0,1,1,4
QDRL,0,0,0,1,1,4
DRLM,0,0,0,1,1,4
RLMA,0,0,0,1,1,4
QLVS,0,0,0,1,1,4
VSFL,0,0,0,1,1,4
SFLI,0,0,0,1,1,4
LIRL,0,0,0,1,1,4
IRLL,0,0,0,2,2,4
RLLK,0,0,0,1,1,4
LLKV,0,0,0,2,2,4
LKVW,0,0,0,1,1,4
KVWI,0,0,0,1,1,4
VWIR,0,0,0,1,1,4
IRVV,0,0,0,1,1,4
RVVI,0,0,0,1,1,4
QMSF,0,0,0,1,1,4
MSFW,0,0,0,1,1,4
SFWG,0,0,0,1,1,4
FWGA,0,0,0,1,1,4
WGAT,0,0,0,1,1,4
GATV,0,0,0,1,1,4
ATVI,0,0,0,1,1,4
TVIT,0,0,0,1,1,4
VITG,0,0,0,1,1,4
ITGL,0,0,0,1,1,4
TGLF,0,0,0,1,1,4
GLFG,0,0,0,1,1,4
QPNA,0,0,0,1,1,4
PNAI,0,0,0,1,1,4
AILE,0,0,0,1,1,4
ILEK,0,0,0,2,2,4
LEKV,0,0,0,2,2,4
EKVF,0,0,0,1,1,4
KVFT,0,0,0,1,1,4
VFTA,0,0,0,1,1,4
QRAF,0,0,0,1,1,4
RAFL,0,0,0,1,1,4
KLYM,0,0,0,1,1,4
LYMI,0,0,0,1,1,4
YMIT,0,0,0,1,1,4
MITM,0,0,0,1,1,4
ITMT,0,0,0,1,1,4
QTRE,0,0,0,1,1,4
REHL,0,0,0,1,1,4
HLLL,0,0,0,2,2,4
LARQ,0,0,0,1,1,4
ARQI,0,0,0,1,1,4
IAKW,0,0,0,1,1,4
AKWG,0,0,0,1,1,4
KWGA,0,0,0,1,1,4
WGAW,0,0,0,1,1,4
GAWV,0,0,0,1,1,4
AWVK,0,0,0,1,1,4
WVKR,0,0,0,1,1,4
VKRI,0,0,0,1,1,4
KRIE,0,0,0,2,2,4
IEAK,0,0,0,1,1,4
EAKF,0,0,0,1,1,4
AKFR,0,0,0,1,1,4
KFRS,0,0,0,1,1,4
FRSL,0,0,0,1,1,4
QVIE,0,0,0,1,1,4
VIEV,0,0,0,1,1,4
IEVL,0,0,0,2,2,4
EVLN,0,0,0,1,1,4
VLNK,0,0,0,1,1,4
LNKQ,0,0,0,1,1,4
NKQV,0,0,0,1,1,4
KQVA,0,0,0,2,2,4
QVAD,0,0,0,1,1,4
VADW,0,0,0,1,1,4
ADWS,0,0,0,1,1,4
DWSV,0,0,0,1,1,4
WSVL,0,0,0,1,1,4
VLFT,0,0,0,1,1,4
LFTK,0,0,0,1,1,4
FTKL,0,0,0,1,1,4
TKLH,0,0,0,1,1,4
KLHN,0,0,0,1,1,4
LHNF,0,0,0,2,2,4
HNFH,0,0,0,2,2,4
NFHW,0,0,0,1,1,4
FHWY,0,0,0,1,1,4
HWYV,0,0,0,1,1,4
QVTQ,0,0,0,1,1,4
VTQE,0,0,0,1,1,4
TQEL,0,0,0,1,1,4
QELR,0,0,0,1,1,4
ELRA,0,0,0,1,1,4
RALM,0,0,0,1,1,4
ALMD,0,0,0,1,1,4
LMDE,0,0,0,1,1,4
MDET,0,0,0,1,1,4
DETM,0,0,0,1,1,4
ETMK,0,0,0,1,1,4
TMKE,0,0,0,1,1,4
MKEL,0,0,0,1,1,4
KELK,0,0,0,1,1,4
ELKA,0,0,0,1,1,4
KAYK,0,0,0,1,1,4
AYKS,0,0,0,2,2,4
YKSE,0,0,0,1,1,4
KSEL,0,0,0,1,1,4
SELE,0,0,0,1,1,4
RAAA,0,0,0,2,2,4
AIEQ,0,0,0,1,1,4
EQLK,0,0,0,1,1,4
QLKI,0,0,0,1,1,4
LKIW,0,0,0,1,1,4
KIWG,0,0,0,1,1,4
IWGE,0,0,0,1,1,4
WGER,0,0,0,1,1,4
GERV,0,0,0,1,1,4
ERVG,0,0,0,1,1,4
RDIP,0,0,0,1,1,4
DIPE,0,0,0,1,1,4
IPEL,0,0,0,1,1,4
PELA,0,0,0,1,1,4
ELAQ,0,0,0,1,1,4
AQLQ,0,0,0,2,2,4
LQSE,0,0,0,1,1,4
QSEI,0,0,0,2,2,4
SEIL,0,0,0,3,3,4
ILDA,0,0,0,1,1,4
LDAI,0,0,0,1,1,4
DAIW,0,0,0,1,1,4
REEE,0,0,0,1,1,4
EEEK,0,0,0,1,1,4
EEKE,0,0,0,2,2,4
ALRF,0,0,0,1,1,4
LRFA,0,0,0,1,1,4
RFAE,0,0,0,1,1,4
FAEA,0,0,0,1,1,4
AEAQ,0,0,0,1,1,4
REEI,0,0,0,1,1,4
EIYQ,0,0,0,2,2,4
IYQA,0,0,0,1,1,4
YQAF,0,0,0,1,1,4
QAFE,0,0,0,1,1,4
FEAI,0,0,0,1,1,4
EAIY,0,0,0,1,1,4
AIYP,0,0,0,1,1,4
IYPV,0,0,0,1,1,4
YPVL,0,0,0,1,1,4
PVLS,0,0,0,1,1,4
VLSE,0,0,0,1,1,4
LSEF,0,0,0,1,1,4
REGF,0,0,0,1,1,4
EGFL,0,0,0,1,1,4
GFLS,0,0,0,1,1,4
FLSP,0,0,0,1,1,4
LSPL,0,0,0,1,1,4
SPLK,0,0,0,1,1,4
PLKA,0,0,0,2,2,4
AYLI,0,0,0,1,1,4
RFES,0,0,0,1,1,4
FESA,0,0,0,1,1,4
ESAV,0,0,0,2,2,4
SAVE,0,0,0,1,1,4
AVET,0,0,0,1,1,4
VETL,0,0,0,1,1,4
ETLL,0,0,0,1,1,4
LDIE,0,0,0,1,1,4
DIES,0,0,0,1,1,4
IESQ,0,0,0,1,1,4
ESQL,0,0,0,1,1,4
SQLE,0,0,0,1,1,4
LEDL,0,0,0,1,1,4
RFLI,0,0,0,1,1,4
LIRV,0,0,0,1,1,4
IRVY,0,0,0,1,1,4
RVYH,0,0,0,1,1,4
VYHP,0,0,0,1,1,4
YHPL,0,0,0,1,1,4
HPLL,0,0,0,1,1,4
PLLL,0,0,0,1,1,4
KRVQ,0,0,0,1,1,4
RVQP,0,0,0,1,1,4
VQPL,0,0,0,1,1,4
QPLV,0,0,0,1,1,4
PLVN,0,0,0,1,1,4
LVNR,0,0,0,1,1,4
VNRW,0,0,0,1,1,4
NRWL,0,0,0,1,1,4
RWLL,0,0,0,1,1,4
WLLL,0,0,0,2,2,4
LLLI,0,0,0,2,2,4
RFSG,0,0,0,1,1,4
FSGK,0,0,0,1,1,4
SGKV,0,0,0,1,1,4
GKVR,0,0,0,1,1,4
REDL,0,0,0,1,1,4
EDLT,0,0,0,1,1,4
DLTK,0,0,0,1,1,4
TKIV,0,0,0,1,1,4
KIVW,0,0,0,1,1,4
IVWV,0,0,0,1,1,4
VWVF,0,0,0,1,1,4
WVFF,0,0,0,1,1,4
VFFW,0,0,0,1,1,4
RFVP,0,0,0,1,1,4
FVPR,0,0,0,1,1,4
VPRW,0,0,0,1,1,4
RWRT,0,0,0,1,1,4
WRTV,0,0,0,1,1,4
RTVV,0,0,0,1,1,4
TVVG,0,0,0,1,1,4
VVGQ,0,0,0,1,1,4
VGQF,0,0,0,1,1,4
GQFK,0,0,0,1,1,4
QFKR,0,0,0,1,1,4
FKRD,0,0,0,1,1,4
KRDI,0,0,0,1,1,4
RDIL,0,0,0,1,1,4
DILV,0,0,0,1,1,4
ILVI,0,0,0,1,1,4
LVIF,0,0,0,1,1,4
VIFL,0,0,0,1,1,4
IFLW,0,0,0,1,1,4
RGEQ,0,0,0,2,2,4
GEQM,0,0,0,1,1,4
EQMK,0,0,0,1,1,4
QMKG,0,0,0,1,1,4
MKGH,0,0,0,1,1,4
KGHA,0,0,0,1,1,4
GHAA,0,0,0,1,1,4
HAAT,0,0,0,1,1,4
AATI,0,0,0,1,1,4
ATIE,0,0,0,1,1,4
TIED,0,0,0,1,1,4
IEDQ,0,0,0,1,1,4
EDQV,0,0,0,1,1,4
DQVR,0,0,0,1,1,4
QVRR,0,0,0,1,1,4
VRRM,0,0,0,1,1,4
RRMI,0,0,0,1,1,4
RMIA,0,0,0,1,1,4
RGFR,0,0,0,1,1,4
GFRG,0,0,0,1,1,4
FRGW,0,0,0,1,1,4
RGWW,0,0,0,1,1,4
GWWL,0,0,0,1,1,4
WWLA,0,0,0,1,1,4
LAST,0,0,0,1,1,4
ASTI,0,0,0,1,1,4
STIL,0,0,0,2,2,4
TILL,0,0,0,1,1,4
LLLV,0,0,0,1,1,4
LVAE,0,0,0,1,1,4
RGQL,0,0,0,1,1,4
GQLI,0,0,0,1,1,4
IREA,0,0,0,1,1,4
REAY,0,0,0,2,2,4
EAYE,0,0,0,1,1,4
AYED,0,0,0,1,1,4
RHSD,0,0,0,1,1,4
HSDN,0,0,0,1,1,4
SDNI,0,0,0,1,1,4
DNIN,0,0,0,1,1,4
NINK,0,0,0,1,1,4
INKF,0,0,0,1,1,4
NKFL,0,0,0,1,1,4
KFLD,0,0,0,1,1,4
FLDF,0,0,0,1,1,4
LDFI,0,0,0,1,1,4
DFIH,0,0,0,1,1,4
FIHG,0,0,0,1,1,4
IHGI,0,0,0,1,1,4
RIEN,0,0,0,1,1,4
IENG,0,0,0,1,1,4
ENGL,0,0,0,1,1,4
NGLR,0,0,0,1,1,4
GLRK,0,0,0,1,1,4
LRKR,0,0,0,1,1,4
RLQS,0,0,0,1,1,4
LQSI,0,0,0,1,1,4
QSIY,0,0,0,1,1,4
IYRH,0,0,0,1,1,4
YRHL,0,0,0,1,1,4
RHLE,0,0,0,1,1,4
ILKN,0,0,0,2,2,4
KNFD,0,0,0,1,1,4
NFDS,0,0,0,1,1,4
FDSW,0,0,0,1,1,4
DSWW,0,0,0,1,1,4
SWWG,0,0,0,1,1,4
WWGK,0,0,0,1,1,4
WGKV,0,0,0,1,1,4
KVIV,0,0,0,1,1,4
VIVI,0,0,0,1,1,4
IVIL,0,0,0,1,1,4
RILQ,0,0,0,1,1,4
ILQW,0,0,0,1,1,4
LQWI,0,0,0,1,1,4
QWII,0,0,0,1,1,4
WIIR,0,0,0,1,1,4
IIRL,0,0,0,1,1,4
RLLL,0,0,0,1,1,4
LIVW,0,0,0,1,1,4
IVWW,0,0,0,1,1,4
RIWA,0,0,0,1,1,4
IWAR,0,0,0,1,1,4
WARL,0,0,0,1,1,4
RLQG,0,0,0,2,2,4
LQGV,0,0,0,1,1,4
GVFR,0,0,0,1,1,4
VFRV,0,0,0,1,1,4
FRVV,0,0,0,1,1,4
RVVF,0,0,0,1,1,4
VVFW,0,0,0,1,1,4
VFWL,0,0,0,1,1,4
RKQS,0,0,0,1,1,4
KQSL,0,0,0,1,1,4
QSLE,0,0,0,1,1,4
SLEQ,0,0,0,2,2,4
LEQD,0,0,0,1,1,4
QDLQ,0,0,0,1,1,4
DLQF,0,0,0,1,1,4
LQFY,0,0,0,1,1,4
QFYY,0,0,0,1,1,4
FYYG,0,0,0,1,1,4
RLDE,0,0,0,1,1,4
EAEA,0,0,0,1,1,4
AEAS,0,0,0,1,1,4
EASA,0,0,0,1,1,4
ASAR,0,0,0,1,1,4
SARS,0,0,0,1,1,4
ARSG,0,0,0,1,1,4
RSGI,0,0,0,1,1,4
SGIE,0,0,0,1,1,4
GIEV,0,0,0,1,1,4
RLFE,0,0,0,1,1,4
LFEQ,0,0,0,1,1,4
FEQA,0,0,0,1,1,4
EQAS,0,0,0,1,1,4
QASR,0,0,0,1,1,4
RLAE,0,0,0,1,1,4
LAEH,0,0,0,1,1,4
AEHY,0,0,0,1,1,4
RLKS,0,0,0,1,1,4
LKSG,0,0,0,1,1,4
KSGW,0,0,0,1,1,4
SGWR,0,0,0,1,1,4
GWRD,0,0,0,1,1,4
WRDA,0,0,0,1,1,4
RDAL,0,0,0,1,1,4
KQIV,0,0,0,1,1,4
QIVF,0,0,0,1,1,4
VFFF,0,0,0,1,1,4
FFFF,0,0,0,2,2,4
FFFL,0,0,0,1,1,4
RLLG,0,0,0,1,1,4
LLGK,0,0,0,2,2,4
LGKW,0,0,0,1,1,4
GKWS,0,0,0,1,1,4
KWSA,0,0,0,1,1,4
WSAI,0,0,0,1,1,4
SAIL,0,0,0,1,1,4
KNVR,0,0,0,2,2,4
NVRF,0,0,0,1,1,4
VRFF,0,0,0,1,1,4
RFFF,0,0,0,1,1,4
FFFW,0,0,0,1,1,4
FFWL,0,0,0,1,1,4
RLVV,0,0,0,1,1,4
LVVL,0,0,0,1,1,4
VVLE,0,0,0,1,1,4
ALTN,0,0,0,2,2,4
LTNF,0,0,0,2,2,4
TNFL,0,0,0,1,1,4
NFLN,0,0,0,1,1,4
FLNH,0,0,0,1,1,4
RLWT,0,0,0,1,1,4
LWTQ,0,0,0,1,1,4
WTQW,0,0,0,1,1,4
TQWQ,0,0,0,1,1,4
WQAI,0,0,0,1,1,4
QAIV,0,0,0,1,1,4
AIVQ,0,0,0,1,1,4
IVQE,0,0,0,1,1,4
VQEI,0,0,0,1,1,4
QEIR,0,0,0,1,1,4
EIRF,0,0,0,1,1,4
RFLW,0,0,0,1,1,4
FLWL,0,0,0,1,1,4
LWLL,0,0,0,1,1,4
RMDE,0,0,0,1,1,4
MDEV,0,0,0,1,1,4
DEVR,0,0,0,1,1,4
RTLQ,0,0,0,1,1,4
TLQE,0,0,0,1,1,4
LQEN,0,0,0,1,1,4
QENL,0,0,0,1,1,4
ENLR,0,0,0,1,1,4
NLRQ,0,0,0,1,1,4
QLQD,0,0,0,1,1,4
LQDE,0,0,0,1,1,4
QDEY,0,0,0,1,1,4
DEYD,0,0,0,1,1,4
EYDQ,0,0,0,1,1,4
YDQQ,0,0,0,1,1,4
DQQQ,0,0,0,1,1,4
QQQT,0,0,0,1,1,4
RNEV,0,0,0,1,1,4
NEVV,0,0,0,1,1,4
EVVS,0,0,0,1,1,4
VVSL,0,0,0,1,1,4
VSLM,0,0,0,2,2,4
SLMQ,0,0,0,1,1,4
MQAN,0,0,0,1,1,4
QANG,0,0,0,1,1,4
RPED,0,0,0,1,1,4
PEDK,0,0,0,1,1,4
EDKS,0,0,0,1,1,4
DKSK,0,0,0,1,1,4
KSKI,0,0,0,1,1,4
SKIV,0,0,0,1,1,4
KIVA,0,0,0,1,1,4
IVAE,0,0,0,1,1,4
RPEV,0,0,0,1,1,4
EVQD,0,0,0,1,1,4
VQDA,0,0,0,1,1,4
QDAL,0,0,0,1,1,4
DALS,0,0,0,1,1,4
LSAE,0,0,0,1,1,4
RPQL,0,0,0,1,1,4
PQLR,0,0,0,1,1,4
QLRN,0,0,0,1,1,4
RNLL,0,0,0,1,1,4
NLLH,0,0,0,1,1,4
LLHE,0,0,0,1,1,4
LHEK,0,0,0,1,1,4
RPRI,0,0,0,1,1,4
PRII,0,0,0,1,1,4
RIIA,0,0,0,1,1,4
IIAA,0,0,0,1,1,4
IAAI,0,0,0,1,1,4
AAIW,0,0,0,1,1,4
AIWH,0,0,0,1,1,4
IWHY,0,0,0,1,1,4
WHYV,0,0,0,1,1,4
HYVK,0,0,0,1,1,4
YVKA,0,0,0,1,1,4
VKAR,0,0,0,1,1,4
RRQE,0,0,0,1,1,4
RQEL,0,0,0,2,2,4
QELE,0,0,0,1,1,4
EEFS,0,0,0,1,1,4
EFSA,0,0,0,1,1,4
FSAA,0,0,0,1,1,4
LARR,0,0,0,1,1,4
RVIE,0,0,0,1,1,4
VIEG,0,0,0,1,1,4
IEGI,0,0,0,1,1,4
EGIK,0,0,0,1,1,4
GIKN,0,0,0,1,1,4
IKNV,0,0,0,2,2,4
KNVI,0,0,0,1,1,4
NVIP,0,0,0,1,1,4
VIPK,0,0,0,1,1,4
PKLL,0,0,0,1,1,4
KLLT,0,0,0,1,1,4
LLTW,0,0,0,1,1,4
LTWW,0,0,0,1,1,4
TWWP,0,0,0,1,1,4
VNAA,0,0,0,1,1,4
NAAI,0,0,0,2,2,4
AAIP,0,0,0,1,1,4
AIPN,0,0,0,1,1,4
IPNI,0,0,0,1,1,4
PNII,0,0,0,1,1,4
NIIV,0,0,0,1,1,4
WRWI,0,0,0,1,1,4
RWIV,0,0,0,1,1,4
WIVK,0,0,0,1,1,4
IVKW,0,0,0,1,1,4
VKWW,0,0,0,1,1,4
KWWL,0,0,0,1,1,4
WWLF,0,0,0,1,1,4
WLFV,0,0,0,2,2,4
RYGW,0,0,0,1,1,4
YGWR,0,0,0,1,1,4
GWRT,0,0,0,1,1,4
WRTA,0,0,0,1,1,4
RTAV,0,0,0,1,1,4
TAVD,0,0,0,1,1,4
AVDY,0,0,0,1,1,4
VDYS,0,0,0,1,1,4
DYSW,0,0,0,1,1,4
YSWF,0,0,0,1,1,4
SWFG,0,0,0,1,1,4
SAAT,0,0,0,1,1,4
TADF,0,0,0,1,1,4
ADFV,0,0,0,1,1,4
DFVA,0,0,0,1,1,4
FVAM,0,0,0,1,1,4
VAMT,0,0,0,1,1,4
AMTA,0,0,0,1,1,4
TAMA,0,0,0,1,1,4
AMAA,0,0,0,1,1,4
MAAR,0,0,0,1,1,4
AARI,0,0,0,1,1,4
ARIF,0,0,0,1,1,4
SAAW,0,0,0,1,1,4
AAWA,0,0,0,1,1,4
WAEW,0,0,0,1,1,4
AEWQ,0,0,0,1,1,4
EWQK,0,0,0,1,1,4
WQKA,0,0,0,1,1,4
QKAR,0,0,0,1,1,4
SAEE,0,0,0,1,1,4
AEEM,0,0,0,1,1,4
EEMV,0,0,0,1,1,4
EMVQ,0,0,0,1,1,4
MVQT,0,0,0,1,1,4
QTLV,0,0,0,1,1,4
TLVN,0,0,0,1,1,4
LVND,0,0,0,1,1,4
VNDY,0,0,0,1,1,4
NDYS,0,0,0,1,1,4
DYSA,0,0,0,1,1,4
YSAL,0,0,0,1,1,4
ALIQ,0,0,0,1,1,4
LIQE,0,0,0,2,2,4
IQEL,0,0,0,1,1,4
QELK,0,0,0,1,1,4
ELKE,0,0,0,1,1,4
LKEG,0,0,0,1,1,4
KEGM,0,0,0,1,1,4
EGME,0,0,0,1,1,4
GMEV,0,0,0,1,1,4
MEVA,0,0,0,1,1,4
EVAG,0,0,0,1,1,4
VAGE,0,0,0,1,1,4
AGEA,0,0,0,1,1,4
SANN,0,0,0,1,1,4
ANNI,0,0,0,1,1,4
NNII,0,0,0,1,1,4
NIIE,0,0,0,1,1,4
IIEE,0,0,0,1,1,4
IEEI,0,0,0,1,1,4
EEIQ,0,0,0,1,1,4
EIQM,0,0,0,1,1,4
IQMQ,0,0,0,1,1,4
QMQK,0,0,0,1,1,4
SASS,0,0,0,1,1,4
ASSQ,0,0,0,1,1,4
SSQN,0,0,0,2,2,4
SQNA,0,0,0,1,1,4
QNAW,0,0,0,1,1,4
NAWL,0,0,0,1,1,4
WLAA,0,0,0,1,1,4
AANR,0,0,0,1,1,4
ANRN,0,0,0,1,1,4
SAVK,0,0,0,1,1,4
AVKV,0,0,0,1,1,4
VKVL,0,0,0,1,1,4
KVLA,0,0,0,1,1,4
LAEE,0,0,0,2,2,4
AEES,0,0,0,1,1,4
EESK,0,0,0,2,2,4
SDEF,0,0,0,1,1,4
DEFN,0,0,0,1,1,4
EFNT,0,0,0,1,1,4
FNTV,0,0,0,1,1,4
NTVA,0,0,0,1,1,4
TVAD,0,0,0,1,1,4
VADN,0,0,0,1,1,4
ADNL,0,0,0,1,1,4
DNLV,0,0,0,1,1,4
NLVT,0,0,0,1,1,4
LVTF,0,0,0,1,1,4
VTFG,0,0,0,1,1,4
TFGD,0,0,0,1,1,4
FGDS,0,0,0,1,1,4
GDSF,0,0,0,1,1,4
DSFL,0,0,0,1,1,4
SFLQ,0,0,0,1,1,4
FLQV,0,0,0,1,1,4
LQVI,0,0,0,1,1,4
QVIL,0,0,0,1,1,4
VILD,0,0,0,1,1,4
ILDH,0,0,0,1,1,4
LDHI,0,0,0,1,1,4
SDEL,0,0,0,1,1,4
DELS,0,0,0,1,1,4
ELSR,0,0,0,1,1,4
LSRA,0,0,0,1,1,4
SRAW,0,0,0,1,1,4
RAWE,0,0,0,1,1,4
AWEV,0,0,0,1,1,4
WEVA,0,0,0,1,1,4
EVAY,0,0,0,1,1,4
VAYD,0,0,0,1,1,4
AYDE,0,0,0,2,2,4
YDEL,0,0,0,2,2,4
AAIK,0,0,0,2,2,4
SDIF,0,0,0,1,1,4
IFNK,0,0,0,1,1,4
FNKN,0,0,0,1,1,4
NKNM,0,0,0,1,1,4
KNMR,0,0,0,1,1,4
NMRA,0,0,0,1,1,4
MRAH,0,0,0,1,1,4
RAHA,0,0,0,1,1,4
HALE,0,0,0,1,1,4
DIKK,0,0,0,1,1,4
KKLG,0,0,0,2,2,4
KLGS,0,0,0,1,1,4
LGSS,0,0,0,1,1,4
GSSW,0,0,0,1,1,4
SSWI,0,0,0,1,1,4
SWII,0,0,0,1,1,4
WIIN,0,0,0,1,1,4
IINW,0,0,0,1,1,4
INWF,0,0,0,1,1,4
NWFF,0,0,0,1,1,4
WFFG,0,0,0,1,1,4
SDSE,0,0,0,1,1,4
DSEI,0,0,0,1,1,4
SEIS,0,0,0,1,1,4
EIST,0,0,0,1,1,4
ISTI,0,0,0,1,1,4
TILS,0,0,0,1,1,4
ILSD,0,0,0,1,1,4
SDVV,0,0,0,1,1,4
DVVT,0,0,0,1,1,4
VVTN,0,0,0,1,1,4
VTNE,0,0,0,1,1,4
TNER,0,0,0,1,1,4
SDWY,0,0,0,1,1,4
DWYL,0,0,0,1,1,4
WYLK,0,0,0,1,1,4
YLKG,0,0,0,1,1,4
LKGR,0,0,0,1,1,4
KGRL,0,0,0,1,1,4
GRLT,0,0,0,1,1,4
RLTS,0,0,0,1,1,4
TSLE,0,0,0,1,1,4
SLES,0,0,0,2,2,4
LESQ,0,0,0,1,1,4
ESQF,0,0,0,1,1,4
SQFI,0,0,0,1,1,4
QFIN,0,0,0,1,1,4
FINA,0,0,0,1,1,4
INAL,0,0,0,1,1,4
NALG,0,0,0,1,1,4
ALGI,0,0,0,1,1,4
LGIL,0,0,0,1,1,4
SEAA,0,0,0,1,1,4
KAYM,0,0,0,1,1,4
AYMK,0,0,0,1,1,4
YMKG,0,0,0,1,1,4
MKGL,0,0,0,1,1,4
KGLE,0,0,0,1,1,4
GLEY,0,0,0,1,1,4
LEYQ,0,0,0,1,1,4
EYQM,0,0,0,1,1,4
YQMS,0,0,0,1,1,4
QMSG,0,0,0,1,1,4
MSGN,0,0,0,1,1,4
SGNE,0,0,0,1,1,4
GNEQ,0,0,0,1,1,4
NEQW,0,0,0,1,1,4
EQWS,0,0,0,1,1,4
QWSK,0,0,0,1,1,4
WSKT,0,0,0,1,1,4
SEEE,0,0,0,1,1,4
EEEE,0,0,0,1,1,4
EEEN,0,0,0,1,1,4
EENN,0,0,0,1,1,4
ENNV,0,0,0,1,1,4
NNVI,0,0,0,1,1,4
NVIE,0,0,0,1,1,4
VIEQ,0,0,0,1,1,4
AKEE,0,0,0,1,1,4
KEEI,0,0,0,1,1,4
EIKE,0,0,0,1,1,4
IKEA,0,0,0,1,1,4
EAIK,0,0,0,1,1,4
AIKK,0,0,0,1,1,4
IKKA,0,0,0,2,2,4
KKAD,0,0,0,1,1,4
KADE,0,0,0,1,1,4
ADET,0,0,0,1,1,4
SEEL,0,0,0,1,1,4
ELNS,0,0,0,1,1,4
LNSA,0,0,0,1,1,4
NSAW,0,0,0,2,2,4
SAWT,0,0,0,1,1,4
AWTI,0,0,0,1,1,4
WTIA,0,0,0,1,1,4
TIAY,0,0,0,1,1,4
IAYD,0,0,0,1,1,4
ELAI,0,0,0,1,1,4
LAIV,0,0,0,1,1,4
AIVI,0,0,0,1,1,4
IVIK,0,0,0,1,1,4
IKKE,0,0,0,1,1,4
KEMD,0,0,0,1,1,4
EMDD,0,0,0,1,1,4
MDDA,0,0,0,1,1,4
SEER,0,0,0,1,1,4
ERIR,0,0,0,1,1,4
RIRS,0,0,0,1,1,4
IRSG,0,0,0,1,1,4
RSGV,0,0,0,1,1,4
SGVK,0,0,0,1,1,4
GVKR,0,0,0,1,1,4
VKRL,0,0,0,1,1,4
KRLS,0,0,0,1,1,4
RLSK,0,0,0,1,1,4
LSKS,0,0,0,1,1,4
SKSR,0,0,0,1,1,4
SEEV,0,0,0,1,1,4
EEVL,0,0,0,1,1,4
VLAM,0,0,0,1,1,4
LAMV,0,0,0,1,1,4
AMVS,0,0,0,1,1,4
MVSR,0,0,0,1,1,4
VSRK,0,0,0,1,1,4
SRKM,0,0,0,1,1,4
SEEY,0,0,0,1,1,4
EEYI,0,0,0,1,1,4
EYIQ,0,0,0,1,1,4
YIQL,0,0,0,2,2,4
IQLL,0,0,0,2,2,4
SERE,0,0,0,1,1,4
REAV,0,0,0,1,1,4
VEII,0,0,0,1,1,4
EIIK,0,0,0,1,1,4
IKKN,0,0,0,1,1,4
SESA,0,0,0,1,1,4
SAVS,0,0,0,2,2,4
AVSH,0,0,0,1,1,4
VSHQ,0,0,0,1,1,4
SHQL,0,0,0,1,1,4
HQLR,0,0,0,1,1,4
RSLR,0,0,0,1,1,4
SLRN,0,0,0,1,1,4
SESK,0,0,0,1,1,4
ESKL,0,0,0,1,1,4
SKLI,0,0,0,1,1,4
KLIE,0,0,0,2,2,4
LIEQ,0,0,0,1,1,4
EQAF,0,0,0,1,1,4
QAFR,0,0,0,1,1,4
SFAD,0,0,0,1,1,4
FADF,0,0,0,1,1,4
ADFK,0,0,0,1,1,4
DFKA,0,0,0,1,1,4
FKAQ,0,0,0,1,1,4
KAQF,0,0,0,1,1,4
AQFT,0,0,0,1,1,4
QFTD,0,0,0,1,1,4
FTDA,0,0,0,1,1,4
TDAA,0,0,0,1,1,4
DAAI,0,0,0,1,1,4
AIKN,0,0,0,1,1,4
SFDR,0,0,0,1,1,4
FDRV,0,0,0,1,1,4
DRVM,0,0,0,1,1,4
RVMN,0,0,0,1,1,4
VMNA,0,0,0,1,1,4
MNAI,0,0,0,1,1,4
NAIE,0,0,0,1,1,4
IEEN,0,0,0,1,1,4
SFSR,0,0,0,1,1,4
FSRI,0,0,0,1,1,4
SRII,0,0,0,2,2,4
RIIS,0,0,0,2,2,4
IISE,0,0,0,1,1,4
SELG,0,0,0,1,1,4
ELGT,0,0,0,1,1,4
LGTR,0,0,0,1,1,4
GTRD,0,0,0,1,1,4
SGAR,0,0,0,1,1,4
GARR,0,0,0,1,1,4
ARRV,0,0,0,1,1,4
RRVR,0,0,0,1,1,4
RVRI,0,0,0,1,1,4
RIAQ,0,0,0,1,1,4
IAQT,0,0,0,1,1,4
QTLT,0,0,0,2,2,4
TLTE,0,0,0,1,1,4
LTEN,0,0,0,1,1,4
SGDE,0,0,0,1,1,4
GDEL,0,0,0,1,1,4
DELY,0,0,0,1,1,4
ELYE,0,0,0,1,1,4
LYEL,0,0,0,1,1,4
YELL,0,0,0,1,1,4
LQHI,0,0,0,1,1,4
QHIL,0,0,0,1,1,4
HILK,0,0,0,1,1,4
LKQR,0,0,0,1,1,4
KQRD,0,0,0,1,1,4
QRDH,0,0,0,1,1,4
RDHH,0,0,0,1,1,4
DHHH,0,0,0,1,1,4
HHHH,0,0,0,2,2,4
SGPA,0,0,0,1,1,4
GPAY,0,0,0,1,1,4
PAYV,0,0,0,1,1,4
AYVF,0,0,0,1,1,4
YVFY,0,0,0,2,2,4
VFYL,0,0,0,2,2,4
FYLL,0,0,0,1,1,4
YLLD,0,0,0,2,2,4
LLDA,0,0,0,1,1,4
DALQ,0,0,0,1,1,4
ALQN,0,0,0,1,1,4
QNAA,0,0,0,1,1,4
AAIR,0,0,0,1,1,4
AIRQ,0,0,0,1,1,4
SGRF,0,0,0,1,1,4
GRFW,0,0,0,1,1,4
RFWK,0,0,0,1,1,4
FWKL,0,0,0,1,1,4
WKLY,0,0,0,1,1,4
KLYI,0,0,0,1,1,4
YIEA,0,0,0,1,1,4
IEAE,0,0,0,1,1,4
AEIK,0,0,0,1,1,4
EIKA,0,0,0,1,1,4
SGTI,0,0,0,1,1,4
GTIK,0,0,0,1,1,4
KAAH,0,0,0,1,1,4
AAHE,0,0,0,1,1,4
AHEV,0,0,0,1,1,4
HEVL,0,0,0,1,1,4
EVLM,0,0,0,1,1,4
VLME,0,0,0,1,1,4
LMEM,0,0,0,1,1,4
MEMG,0,0,0,1,1,4
SHAQ,0,0,0,1,1,4
HAQD,0,0,0,1,1,4
AQDI,0,0,0,1,1,4
QDIY,0,0,0,1,1,4
DIYK,0,0,0,1,1,4
IYKE,0,0,0,1,1,4
YKEA,0,0,0,1,1,4
KEAF,0,0,0,1,1,4
EAFN,0,0,0,1,1,4
AFNS,0,0,0,1,1,4
FNSA,0,0,0,1,1,4
SAWD,0,0,0,1,1,4
AWDQ,0,0,0,1,1,4
WDQY,0,0,0,1,1,4
SIDE,0,0,0,1,1,4
IDEK,0,0,0,1,1,4
DEKY,0,0,0,1,1,4
EKYE,0,0,0,2,2,4
KYEA,0,0,0,1,1,4
YEAE,0,0,0,1,1,4
EAEV,0,0,0,1,1,4
KKSE,0,0,0,1,1,4
KSEI,0,0,0,1,1,4
SEID,0,0,0,1,1,4
EIDH,0,0,0,1,1,4
IDHH,0,0,0,1,1,4
DHHK,0,0,0,1,1,4
IERL,0,0,0,2,2,4
LLEM,0,0,0,1,1,4
LEME,0,0,0,1,1,4
EMES,0,0,0,1,1,4
MESL,0,0,0,1,1,4
SIPH,0,0,0,1,1,4
LANL,0,0,0,1,1,4
ANLL,0,0,0,1,1,4
NLLI,0,0,0,1,1,4
LIER,0,0,0,3,3,4
IERS,0,0,0,1,1,4
ERSQ,0,0,0,1,1,4
SISR,0,0,0,2,2,4
ISRY,0,0,0,1,1,4
SRYK,0,0,0,1,1,4
RYKT,0,0,0,1,1,4
YKTI,0,0,0,1,1,4
KTIE,0,0,0,1,1,4
TIEW,0,0,0,1,1,4
IEWL,0,0,0,1,1,4
EWLN,0,0,0,1,1,4
WLNY,0,0,0,1,1,4
NYIA,0,0,0,1,1,4
YIAT,0,0,0,1,1,4
IATE,0,0,0,1,1,4
ATEL,0,0,0,1,1,4
SKDA,0,0,0,1,1,4
KDAL,0,0,0,1,1,4
DALM,0,0,0,1,1,4
ALML,0,0,0,1,1,4
LMLE,0,0,0,1,1,4
LEAF,0,0,0,1,1,4
EAFE,0,0,0,1,1,4
AFEQ,0,0,0,1,1,4
FEQL,0,0,0,1,1,4
QLLG,0,0,0,1,1,4
LGKR,0,0,0,1,1,4
KRRE,0,0,0,1,1,4
RREL,0,0,0,1,1,4
RELL,0,0,0,2,2,4
LLGE,0,0,0,1,1,4
SKDL,0,0,0,1,1,4
DLAQ,0,0,0,1,1,4
QTSY,0,0,0,1,1,4
TSYF,0,0,0,1,1,4
SYFM,0,0,0,1,1,4
YFMA,0,0,0,1,1,4
FMAT,0,0,0,1,1,4
MATN,0,0,0,1,1,4
TNSL,0,0,0,1,1,4
NSLH,0,0,0,1,1,4
SLHL,0,0,0,1,1,4
LHLT,0,0,0,1,1,4
SKED,0,0,0,2,2,4
EDID,0,0,0,1,1,4
DIDT,0,0,0,1,1,4
IDTA,0,0,0,1,1,4
DTAM,0,0,0,1,1,4
TAMK,0,0,0,1,1,4
AMKL,0,0,0,1,1,4
MKLG,0,0,0,1,1,4
LGAG,0,0,0,1,1,4
KEDV,0,0,0,1,1,4
EDVE,0,0,0,1,1,4
DVER,0,0,0,1,1,4
VERV,0,0,0,1,1,4
RVKL,0,0,0,1,1,4
VKLR,0,0,0,1,1,4
KLRI,0,0,0,1,1,4
LRIN,0,0,0,1,1,4
RINL,0,0,0,1,1,4
NLAR,0,0,0,1,1,4
LARN,0,0,0,1,1,4
ARNW,0,0,0,1,1,4
RNWV,0,0,0,1,1,4
NWVK,0,0,0,1,1,4
WVKK,0,0,0,1,1,4
VKKY,0,0,0,1,1,4
SKEE,0,0,0,1,1,4
KEEQ,0,0,0,1,1,4
EEQR,0,0,0,1,1,4
EQRD,0,0,0,1,1,4
QRDY,0,0,0,1,1,4
RDYV,0,0,0,1,1,4
DYVF,0,0,0,1,1,4
FYLA,0,0,0,1,1,4
YLAV,0,0,0,1,1,4
LAVG,0,0,0,2,2,4
AVGN,0,0,0,2,2,4
VGNY,0,0,0,1,1,4
GNYR,0,0,0,1,1,4
NYRL,0,0,0,1,1,4
SKIQ,0,0,0,1,1,4
IQKE,0,0,0,1,1,4
QKEL,0,0,0,1,1,4
KELV,0,0,0,1,1,4
ELVA,0,0,0,1,1,4
LVAI,0,0,0,1,1,4
VAIM,0,0,0,1,1,4
AIMN,0,0,0,1,1,4
SKPI,0,0,0,1,1,4
KPIQ,0,0,0,1,1,4
PIQN,0,0,0,1,1,4
IQNV,0,0,0,1,1,4
QNVE,0,0,0,1,1,4
NVES,0,0,0,1,1,4
VESG,0,0,0,1,1,4
ESGF,0,0,0,1,1,4
SGFI,0,0,0,1,1,4
GFIF,0,0,0,1,1,4
FIFA,0,0,0,1,1,4
IFAL,0,0,0,1,1,4
FALV,0,0,0,1,1,4
ALVS,0,0,0,1,1,4
SKYL,0,0,0,1,1,4
KYLK,0,0,0,1,1,4
SLLS,0,0,0,1,1,4
SKYR,0,0,0,1,1,4
KYRL,0,0,0,1,1,4
YRLT,0,0,0,1,1,4
RLTV,0,0,0,1,1,4
LTVV,0,0,0,1,1,4
TVVV,0,0,0,1,1,4
VVVA,0,0,0,2,2,4
VVAK,0,0,0,1,1,4
VAKR,0,0,0,1,1,4
AKRA,0,0,0,1,1,4
KRAQ,0,0,0,1,1,4
RAQQ,0,0,0,1,1,4
AQQL,0,0,0,1,1,4
LLRH,0,0,0,1,1,4
SLAE,0,0,0,1,1,4
EALG,0,0,0,2,2,4
LGWL,0,0,0,1,1,4
GWLF,0,0,0,1,1,4
LFVS,0,0,0,1,1,4
FVSE,0,0,0,1,1,4
VSEG,0,0,0,1,1,4
SEGS,0,0,0,1,1,4
EQQF,0,0,0,1,1,4
QQFS,0,0,0,1,1,4
QFSI,0,0,0,1,1,4
FSIR,0,0,0,1,1,4
SIRS,0,0,0,1,1,4
IRSF,0,0,0,1,1,4
RSFA,0,0,0,1,1,4
SFAT,0,0,0,1,1,4
FATQ,0,0,0,1,1,4
ATQV,0,0,0,1,1,4
TQVQ,0,0,0,1,1,4
QVQN,0,0,0,1,1,4
VQNM,0,0,0,1,1,4
ESLI,0,0,0,1,1,4
SLID,0,0,0,1,1,4
LIDM,0,0,0,1,1,4
IDMI,0,0,0,1,1,4
DMIT,0,0,0,1,1,4
MITS,0,0,0,1,1,4
ITSI,0,0,0,1,1,4
SLKD,0,0,0,2,2,4
LKDQ,0,0,0,1,1,4
KDQL,0,0,0,1,1,4
QLAL,0,0,0,1,1,4
LAIG,0,0,0,1,1,4
IGKL,0,0,0,1,1,4
GKLG,0,0,0,1,1,4
SLLP,0,0,0,1,1,4
LLPT,0,0,0,1,1,4
LPTL,0,0,0,1,1,4
PTLS,0,0,0,1,1,4
TLSA,0,0,0,1,1,4
LSAI,0,0,0,1,1,4
IAEL,0,0,0,1,1,4
PEMF,0,0,0,1,1,4
EMFD,0,0,0,1,1,4
MFDK,0,0,0,1,1,4
FDKM,0,0,0,1,1,4
DKMR,0,0,0,1,1,4
KMRP,0,0,0,1,1,4
MRPY,0,0,0,1,1,4
RPYY,0,0,0,1,1,4
PYYE,0,0,0,1,1,4
YYEE,0,0,0,1,1,4
YEES,0,0,0,1,1,4
ESKK,0,0,0,1,1,4
KRVK,0,0,0,1,1,4
SMDH,0,0,0,1,1,4
MDHR,0,0,0,1,1,4
DHRI,0,0,0,1,1,4
HRIE,0,0,0,1,1,4
RIER,0,0,0,1,1,4
ERLE,0,0,0,2,2,4
RLEY,0,0,0,1,1,4
LEYY,0,0,0,1,1,4
EYYI,0,0,0,1,1,4
YYIQ,0,0,0,1,1,4
QLLV,0,0,0,2,2,4
LLVK,0,0,0,1,1,4
SNEQ,0,0,0,1,1,4
NEQR,0,0,0,1,1,4
EQRQ,0,0,0,1,1,4
QRQD,0,0,0,1,1,4
RQDI,0,0,0,1,1,4
QDIA,0,0,0,2,2,4
DIAF,0,0,0,2,2,4
IAFA,0,0,0,1,1,4
AFAY,0,0,0,1,1,4
FAYQ,0,0,0,1,1,4
AYQR,0,0,0,1,1,4
YQRR,0,0,0,1,1,4
QRRT,0,0,0,1,1,4
RRTK,0,0,0,1,1,4
SNEV,0,0,0,1,1,4
NEVM,0,0,0,1,1,4
EVMR,0,0,0,1,1,4
VMRI,0,0,0,1,1,4
MRIL,0,0,0,1,1,4
ILIS,0,0,0,1,1,4
LISR,0,0,0,1,1,4
ISRS,0,0,0,1,1,4
SRSL,0,0,0,1,1,4
RSLL,0,0,0,1,1,4
LLQE,0,0,0,2,2,4
SNTE,0,0,0,1,1,4
NTEL,0,0,0,1,1,4
ELQA,0,0,0,1,1,4
LQAV,0,0,0,1,1,4
QAVD,0,0,0,2,2,4
AVDG,0,0,0,1,1,4
VDGR,0,0,0,1,1,4
DGRF,0,0,0,1,1,4
GRFK,0,0,0,1,1,4
RFKR,0,0,0,1,1,4
FKRA,0,0,0,1,1,4
VASM,0,0,0,1,1,4
ASME,0,0,0,1,1,4
SMEA,0,0,0,1,1,4
MEAA,0,0,0,1,1,4
EAAR,0,0,0,1,1,4
AARA,0,0,0,2,2,4
LTNN,0,0,0,1,1,4
SPAE,0,0,0,1,1,4
PAEV,0,0,0,1,1,4
AEVR,0,0,0,1,1,4
EVRD,0,0,0,1,1,4
VRDL,0,0,0,1,1,4
RDLD,0,0,0,1,1,4
DLDF,0,0,0,1,1,4
LDFA,0,0,0,1,1,4
FAND,0,0,0,1,1,4
ANDA,0,0,0,1,1,4
NDAS,0,0,0,1,1,4
DASK,0,0,0,1,1,4
ASKV,0,0,0,1,1,4
SKVL,0,0,0,1,1,4
VLGS,0,0,0,1,1,4
GSIA,0,0,0,1,1,4
SIAG,0,0,0,1,1,4
IAGK,0,0,0,1,1,4
AGKL,0,0,0,1,1,4
KLEK,0,0,0,1,1,4
SPAQ,0,0,0,1,1,4
PAQA,0,0,0,1,1,4
AQAE,0,0,0,1,1,4
LGVW,0,0,0,1,1,4
GVWR,0,0,0,1,1,4
VWRR,0,0,0,1,1,4
WRRY,0,0,0,1,1,4
RRYR,0,0,0,1,1,4
RYRA,0,0,0,1,1,4
YRAY,0,0,0,1,1,4
RAYF,0,0,0,1,1,4
AYFD,0,0,0,1,1,4
SPAV,0,0,0,2,2,4
PAVI,0,0,0,1,1,4
VIDY,0,0,0,1,1,4
IDYV,0,0,0,1,1,4
DYVN,0,0,0,1,1,4
YVNR,0,0,0,1,1,4
NRLE,0,0,0,1,1,4
LEEI,0,0,0,1,1,4
EEIR,0,0,0,1,1,4
EIRD,0,0,0,1,1,4
IRDN,0,0,0,1,1,4
RDNV,0,0,0,1,1,4
PAVQ,0,0,0,1,1,4
AVQM,0,0,0,1,1,4
VQMK,0,0,0,1,1,4
QMKI,0,0,0,1,1,4
MKIK,0,0,0,1,1,4
KELY,0,0,0,1,1,4
ELYR,0,0,0,1,1,4
LYRR,0,0,0,1,1,4
YRRR,0,0,0,1,1,4
SPEE,0,0,0,2,2,4
PEEA,0,0,0,1,1,4
EAAA,0,0,0,1,1,4
LVDG,0,0,0,1,1,4
VDGL,0,0,0,1,1,4
DGLR,0,0,0,1,1,4
PEEK,0,0,0,1,1,4
EKEE,0,0,0,1,1,4
KEEW,0,0,0,1,1,4
EEWM,0,0,0,1,1,4
EWMK,0,0,0,1,1,4
WMKS,0,0,0,1,1,4
MKSI,0,0,0,1,1,4
KSIK,0,0,0,1,1,4
SIKA,0,0,0,1,1,4
IKAS,0,0,0,1,1,4
ASIS,0,0,0,2,2,4
SPEH,0,0,0,1,1,4
PEHR,0,0,0,1,1,4
EHRQ,0,0,0,1,1,4
HRQE,0,0,0,1,1,4
QELI,0,0,0,1,1,4
SPEI,0,0,0,1,1,4
PEIA,0,0,0,1,1,4
IASG,0,0,0,1,1,4
ASGL,0,0,0,1,1,4
SGLK,0,0,0,1,1,4
GLKK,0,0,0,1,1,4
KLIR,0,0,0,1,1,4
SPEQ,0,0,0,1,1,4
PEQM,0,0,0,1,1,4
EQMQ,0,0,0,1,1,4
QMQV,0,0,0,1,1,4
QVLL,0,0,0,1,1,4
LLDQ,0,0,0,1,1,4
LDQA,0,0,0,1,1,4
DQAG,0,0,0,1,1,4
SPEV,0,0,0,1,1,4
PEVV,0,0,0,2,2,4
EVVV,0,0,0,1,1,4
VVAR,0,0,0,1,1,4
ARGE,0,0,0,1,1,4
GEQE,0,0,0,1,1,4
SPKE,0,0,0,2,2,4
PKEA,0,0,0,1,1,4
KEAY,0,0,0,1,1,4
EAYA,0,0,0,1,1,4
AYAY,0,0,0,1,1,4
YAYL,0,0,0,1,1,4
AYLE,0,0,0,1,1,4
YLEK,0,0,0,1,1,4
EKLR,0,0,0,1,1,4
KLRS,0,0,0,1,1,4
LRSI,0,0,0,1,1,4
RSII,0,0,0,1,1,4
SIIQ,0,0,0,1,1,4
IIQY,0,0,0,1,1,4
IQYT,0,0,0,1,1,4
QYTG,0,0,0,1,1,4
PKES,0,0,0,1,1,4
KESE,0,0,0,1,1,4
ESEV,0,0,0,1,1,4
SEVL,0,0,0,1,1,4
RLFA,0,0,0,1,1,4
FAEG,0,0,0,1,1,4
SPKS,0,0,0,1,1,4
PKST,0,0,0,1,1,4
KSTY,0,0,0,1,1,4
STYS,0,0,0,1,1,4
TYSY,0,0,0,1,1,4
YSYW,0,0,0,1,1,4
SYWA,0,0,0,1,1,4
YWAS,0,0,0,1,1,4
WASV,0,0,0,1,1,4
ASVL,0,0,0,1,1,4
SVLN,0,0,0,1,1,4
SPSK,0,0,0,1,1,4
PSKS,0,0,0,1,1,4
SKSL,0,0,0,1,1,4
SLQM,0,0,0,1,1,4
LQMI,0,0,0,1,1,4
QMIL,0,0,0,1,1,4
MILR,0,0,0,1,1,4
ILRR,0,0,0,1,1,4
GDFE,0,0,0,1,1,4
DFEN,0,0,0,1,1,4
FENM,0,0,0,1,1,4
ENML,0,0,0,1,1,4
MLAD,0,0,0,1,1,4
SPVV,0,0,0,1,1,4
PVVI,0,0,0,1,1,4
VVIK,0,0,0,1,1,4
IKKR,0,0,0,1,1,4
KKRI,0,0,0,1,1,4
RIEG,0,0,0,1,1,4
IEGL,0,0,0,1,1,4
EGLI,0,0,0,1,1,4
SQES,0,0,0,1,1,4
QESI,0,0,0,1,1,4
SINQ,0,0,0,1,1,4
INQL,0,0,0,1,1,4
NQLV,0,0,0,1,1,4
QLVY,0,0,0,1,1,4
LVYM,0,0,0,1,1,4
VYMG,0,0,0,1,1,4
SQRQ,0,0,0,1,1,4
QRQR,0,0,0,1,1,4
RQRD,0,0,0,1,1,4
QRDE,0,0,0,1,1,4
DELN,0,0,0,1,1,4
ELNR,0,0,0,1,1,4
LNRA,0,0,0,1,1,4
NRAI,0,0,0,1,1,4
AIAD,0,0,0,2,2,4
IADY,0,0,0,1,1,4
ADYL,0,0,0,1,1,4
DYLR,0,0,0,1,1,4
YLRS,0,0,0,1,1,4
LRSN,0,0,0,1,1,4
SRAI,0,0,0,1,1,4
RAIT,0,0,0,1,1,4
AITQ,0,0,0,1,1,4
ITQY,0,0,0,1,1,4
TQYI,0,0,0,1,1,4
QYIA,0,0,0,1,1,4
YIAH,0,0,0,1,1,4
SRAK,0,0,0,1,1,4
RAKA,0,0,0,1,1,4
ASFD,0,0,0,1,1,4
SFDT,0,0,0,1,1,4
FDTR,0,0,0,1,1,4
DTRV,0,0,0,1,1,4
TRVA,0,0,0,1,1,4
RVAA,0,0,0,1,1,4
AELA,0,0,0,1,1,4
LALN,0,0,0,1,1,4
ALNR,0,0,0,1,1,4
SRDL,0,0,0,1,1,4
RDLQ,0,0,0,1,1,4
QEKY,0,0,0,1,1,4
KYER,0,0,0,1,1,4
YERH,0,0,0,1,1,4
ERHM,0,0,0,1,1,4
RHME,0,0,0,1,1,4
HMEK,0,0,0,1,1,4
EKLI,0,0,0,1,1,4
LIEL,0,0,0,1,1,4
IELA,0,0,0,1,1,4
ELAN,0,0,0,1,1,4
LANK,0,0,0,1,1,4
ANKE,0,0,0,1,1,4
NKEV,0,0,0,1,1,4
KEVE,0,0,0,1,1,4
EVER,0,0,0,1,1,4
VERT,0,0,0,1,1,4
SRKA,0,0,0,1,1,4
RKAL,0,0,0,1,1,4
KALT,0,0,0,1,1,4
TEGN,0,0,0,1,1,4
EGNI,0,0,0,1,1,4
GNIM,0,0,0,1,1,4
IMAV,0,0,0,1,1,4
MAVQ,0,0,0,1,1,4
VQAM,0,0,0,1,1,4
QAMA,0,0,0,1,1,4
AMAY,0,0,0,1,1,4
MAYF,0,0,0,1,1,4
AYFK,0,0,0,1,1,4
YFKE,0,0,0,1,1,4
FKEL,0,0,0,1,1,4
KELI,0,0,0,1,1,4
ELIQ,0,0,0,2,2,4
LIQK,0,0,0,1,1,4
IQKR,0,0,0,1,1,4
QKRK,0,0,0,1,1,4
RKRH,0,0,0,1,1,4
SRPL,0,0,0,1,1,4
RPLH,0,0,0,1,1,4
PLHI,0,0,0,1,1,4
LHIS,0,0,0,1,1,4
HIST,0,0,0,1,1,4
ISTF,0,0,0,1,1,4
STFI,0,0,0,1,1,4
TFIN,0,0,0,1,1,4
FINE,0,0,0,1,1,4
NELD,0,0,0,1,1,4
ELDS,0,0,0,2,2,4
LDSG,0,0,0,1,1,4
DSGF,0,0,0,1,1,4
SGFR,0,0,0,1,1,4
GFRL,0,0,0,1,1,4
FRLL,0,0,0,1,1,4
SRWG,0,0,0,1,1,4
RWGV,0,0,0,1,1,4
WGVL,0,0,0,1,1,4
GVLI,0,0,0,1,1,4
VLIL,0,0,0,1,1,4
LILV,0,0,0,1,1,4
ILVA,0,0,0,1,1,4
LVAL,0,0,0,1,1,4
SSAV,0,0,0,1,1,4
AVSR,0,0,0,1,1,4
VSRI,0,0,0,1,1,4
IISK,0,0,0,1,1,4
SKLK,0,0,0,1,1,4
KLKQ,0,0,0,1,1,4
SQNW,0,0,0,1,1,4
QNWQ,0,0,0,1,1,4
NWQR,0,0,0,1,1,4
WQRF,0,0,0,1,1,4
QRFY,0,0,0,1,1,4
RFYQ,0,0,0,1,1,4
FYQL,0,0,0,1,1,4
YQLT,0,0,0,1,1,4
QLTK,0,0,0,1,1,4
TKLL,0,0,0,1,1,4
LLDS,0,0,0,2,2,4
LDSM,0,0,0,1,1,4
DSMH,0,0,0,1,1,4
SMHE,0,0,0,1,1,4
MHEV,0,0,0,1,1,4
HEVV,0,0,0,1,1,4
EVVE,0,0,0,1,1,4
VVEN,0,0,0,1,1,4
VENL,0,0,0,1,1,4
ENLL,0,0,0,1,1,4
SSRE,0,0,0,1,1,4
SREW,0,0,0,1,1,4
REWF,0,0,0,1,1,4
EWFS,0,0,0,1,1,4
WFST,0,0,0,1,1,4
YRLF,0,0,0,1,1,4
RLFI,0,0,0,1,1,4
LFIG,0,0,0,1,1,4
STAT,0,0,0,1,1,4
TATF,0,0,0,1,1,4
ATFY,0,0,0,1,1,4
TFYD,0,0,0,1,1,4
FYDA,0,0,0,1,1,4
YDAK,0,0,0,2,2,4
DAKK,0,0,0,1,1,4
KFLI,0,0,0,1,1,4
STEV,0,0,0,1,1,4
TEVV,0,0,0,1,1,4
EVVA,0,0,0,1,1,4
VVAL,0,0,0,1,1,4
VALS,0,0,0,1,1,4
ALSR,0,0,0,1,1,4
LSRL,0,0,0,1,1,4
SRLQ,0,0,0,1,1,4
LQGS,0,0,0,1,1,4
QGSL,0,0,0,1,1,4
GSLQ,0,0,0,1,1,4
LQDM,0,0,0,1,1,4
QDML,0,0,0,1,1,4
DMLW,0,0,0,1,1,4
MLWQ,0,0,0,1,1,4
LWQL,0,0,0,1,1,4
WQLD,0,0,0,1,1,4
QLDL,0,0,0,1,1,4
LDLS,0,0,0,1,1,4
STLV,0,0,0,2,2,4
TLVQ,0,0,0,1,1,4
LVQT,0,0,0,1,1,4
VQTP,0,0,0,1,1,4
QTPA,0,0,0,1,1,4
TPAL,0,0,0,1,1,4
PALR,0,0,0,1,1,4
ALRA,0,0,0,1,1,4
VGNI,0,0,0,1,1,4
GNIV,0,0,0,1,1,4
TLVS,0,0,0,1,1,4
LVSV,0,0,0,1,1,4
VSVA,0,0,0,1,1,4
SVAV,0,0,0,1,1,4
VAVA,0,0,0,1,1,4
AVAL,0,0,0,1,1,4
LAAY,0,0,0,2,2,4
AAYK,0,0,0,1,1,4
AYKT,0,0,0,1,1,4
YKTG,0,0,0,1,1,4
SVAD,0,0,0,1,1,4
VADH,0,0,0,1,1,4
ADHS,0,0,0,1,1,4
DHSY,0,0,0,1,1,4
HSYR,0,0,0,1,1,4
SYRV,0,0,0,1,1,4
YRVA,0,0,0,1,1,4
RVAF,0,0,0,1,1,4
VAFI,0,0,0,1,1,4
AFIT,0,0,0,1,1,4
FITL,0,0,0,1,1,4
ITLL,0,0,0,1,1,4
TLLL,0,0,0,1,1,4
SVEG,0,0,0,1,1,4
EGLQ,0,0,0,1,1,4
GLQE,0,0,0,1,1,4
LQEF,0,0,0,2,2,4
QEFV,0,0,0,1,1,4
EFVK,0,0,0,1,1,4
FVKN,0,0,0,1,1,4
VKNL,0,0,0,1,1,4
KNLV,0,0,0,1,1,4
LVGY,0,0,0,1,1,4
VGYY,0,0,0,1,1,4
GYYI,0,0,0,1,1,4
SVEK,0,0,0,1,1,4
VEKK,0,0,0,1,1,4
EKKV,0,0,0,1,1,4
KKVP,0,0,0,1,1,4
KVPL,0,0,0,1,1,4
VPLL,0,0,0,1,1,4
PLLH,0,0,0,1,1,4
LLHN,0,0,0,1,1,4
NFHS,0,0,0,1,1,4
FHSF,0,0,0,1,1,4
HSFL,0,0,0,1,1,4
SVEV,0,0,0,1,1,4
VEVA,0,0,0,1,1,4
EVAE,0,0,0,1,1,4
VAEL,0,0,0,2,2,4
AELW,0,0,0,1,1,4
ELWS,0,0,0,1,1,4
LWST,0,0,0,1,1,4
WSTF,0,0,0,1,1,4
STFM,0,0,0,1,1,4
TFMQ,0,0,0,1,1,4
MQKW,0,0,0,1,1,4
QKWI,0,0,0,1,1,4
WIAY,0,0,0,1,1,4
IAYT,0,0,0,1,1,4
AYTA,0,0,0,1,1,4
YTAA,0,0,0,1,1,4
TAAV,0,0,0,1,1,4
VIDA,0,0,0,1,1,4
IDAE,0,0,0,1,1,4
DAER,0,0,0,1,1,4
AERD,0,0,0,1,1,4
ERDR,0,0,0,1,1,4
SVLE,0,0,0,2,2,4
VLEN,0,0,0,1,1,4
LENH,0,0,0,1,1,4
ENHH,0,0,0,1,1,4
NHHL,0,0,0,1,1,4
HHLA,0,0,0,1,1,4
HLAV,0,0,0,1,1,4
AVGF,0,0,0,1,1,4
VGFK,0,0,0,1,1,4
GFKL,0,0,0,1,1,4
VNSE,0,0,0,1,1,4
NSEI,0,0,0,1,1,4
SEIY,0,0,0,1,1,4
IYQR,0,0,0,1,1,4
YQRV,0,0,0,1,1,4
QRVM,0,0,0,1,1,4
RVME,0,0,0,1,1,4
VMES,0,0,0,1,1,4
MESF,0,0,0,1,1,4
ESFK,0,0,0,1,1,4
SFKK,0,0,0,1,1,4
FKKE,0,0,0,1,1,4
KKEG,0,0,0,1,1,4
SVPY,0,0,0,1,1,4
VPYF,0,0,0,1,1,4
PYFI,0,0,0,1,1,4
YFIE,0,0,0,1,1,4
FIEN,0,0,0,1,1,4
IENL,0,0,0,1,1,4
ENLK,0,0,0,1,1,4
NLKQ,0,0,0,1,1,4
QHIE,0,0,0,1,1,4
HIEM,0,0,0,1,1,4
IEMN,0,0,0,1,1,4
SVRK,0,0,0,1,1,4
RKVF,0,0,0,1,1,4
KVFH,0,0,0,1,1,4
VFHL,0,0,0,1,1,4
FHLV,0,0,0,1,1,4
HLVR,0,0,0,1,1,4
VRIK,0,0,0,1,1,4
RIKQ,0,0,0,1,1,4
IKQV,0,0,0,1,1,4
QVAW,0,0,0,1,1,4
VAWA,0,0,0,1,1,4
AWAN,0,0,0,1,1,4
WANE,0,0,0,1,1,4
ANEG,0,0,0,1,1,4
SVSR,0,0,0,1,1,4
SRAA,0,0,0,1,1,4
RAAI,0,0,0,1,1,4
AAIT,0,0,0,1,1,4
AITA,0,0,0,2,2,4
ITAA,0,0,0,1,1,4
TAAY,0,0,0,1,1,4
SVSS,0,0,0,1,1,4
SSIK,0,0,0,1,1,4
KQAV,0,0,0,1,1,4
AVDF,0,0,0,1,1,4
FLSN,0,0,0,1,1,4
LSNE,0,0,0,1,1,4
SVTE,0,0,0,1,1,4
VTEL,0,0,0,1,1,4
TELI,0,0,0,1,1,4
ELIT,0,0,0,1,1,4
LITK,0,0,0,1,1,4
ITKA,0,0,0,1,1,4
TKAV,0,0,0,1,1,4
KAVS,0,0,0,1,1,4
AVSA,0,0,0,1,1,4
SVTK,0,0,0,1,1,4
VTKI,0,0,0,1,1,4
TKIL,0,0,0,1,1,4
KILQ,0,0,0,1,1,4
ILQR,0,0,0,1,1,4
LQRF,0,0,0,1,1,4
QRFE,0,0,0,1,1,4
RFED,0,0,0,1,1,4
FEDA,0,0,0,2,2,4
EDAG,0,0,0,1,1,4
DAGG,0,0,0,1,1,4
SVWA,0,0,0,1,1,4
VWAS,0,0,0,1,1,4
WASI,0,0,0,1,1,4
SISS,0,0,0,1,1,4
ISSY,0,0,0,1,1,4
SYLD,0,0,0,1,1,4
LDEL,0,0,0,1,1,4
DELT,0,0,0,1,1,4
ELTE,0,0,0,1,1,4
TEGL,0,0,0,1,1,4
SWQS,0,0,0,1,1,4
WQSL,0,0,0,1,1,4
QSLK,0,0,0,1,1,4
KDRY,0,0,0,1,1,4
DRYL,0,0,0,1,1,4
RYLK,0,0,0,1,1,4
YLKH,0,0,0,1,1,4
SYKD,0,0,0,1,1,4
YKDL,0,0,0,1,1,4
KDLF,0,0,0,1,1,4
FLEL,0,0,0,1,1,4
LELY,0,0,0,1,1,4
YGKI,0,0,0,1,1,4
GKIK,0,0,0,1,1,4
KIKD,0,0,0,1,1,4
TAAQ,0,0,0,1,1,4
AAQE,0,0,0,1,1,4
AQEL,0,0,0,2,2,4
QELM,0,0,0,1,1,4
ELMI,0,0,0,1,1,4
LMIQ,0,0,0,1,1,4
MIQQ,0,0,0,1,1,4
IQQL,0,0,0,1,1,4
QQLV,0,0,0,1,1,4
QLVA,0,0,0,1,1,4
TAEQ,0,0,0,1,1,4
AEQR,0,0,0,1,1,4
EQRR,0,0,0,1,1,4
QRRE,0,0,0,1,1,4
RREM,0,0,0,1,1,4
REML,0,0,0,1,1,4
EMLE,0,0,0,1,1,4
EAKR,0,0,0,1,1,4
AKRK,0,0,0,1,1,4
KRKQ,0,0,0,1,1,4
RKQI,0,0,0,1,1,4
KQII,0,0,0,1,1,4
QIIN,0,0,0,1,1,4
IINF,0,0,0,1,1,4
INFI,0,0,0,1,1,4
NFIS,0,0,0,1,1,4
FISR,0,0,0,1,1,4
ISRN,0,0,0,1,1,4
ESFY,0,0,0,1,1,4
SFYN,0,0,0,1,1,4
FYNQ,0,0,0,1,1,4
YNQG,0,0,0,1,1,4
NQGI,0,0,0,1,1,4
QGIR,0,0,0,1,1,4
GIRL,0,0,0,1,1,4
IRLS,0,0,0,1,1,4
RLSF,0,0,0,1,1,4
LSFE,0,0,0,1,1,4
SFEQ,0,0,0,1,1,4
FEQW,0,0,0,1,1,4
EQWG,0,0,0,1,1,4
TAHE,0,0,0,1,1,4
AHEA,0,0,0,1,1,4
HEAV,0,0,0,1,1,4
AVLD,0,0,0,1,1,4
VLDF,0,0,0,1,1,4
LDFL,0,0,0,1,1,4
DFLT,0,0,0,1,1,4
FLTG,0,0,0,1,1,4
LTGR,0,0,0,1,1,4
TGRV,0,0,0,1,1,4
GRVE,0,0,0,1,1,4
RVEV,0,0,0,1,1,4
VEVF,0,0,0,1,1,4
EVFT,0,0,0,1,1,4
TAKQ,0,0,0,1,1,4
AKQI,0,0,0,2,2,4
KQIQ,0,0,0,2,2,4
QIQA,0,0,0,1,1,4
QAAY,0,0,0,1,1,4
AAYL,0,0,0,1,1,4
YLLV,0,0,0,1,1,4
LLVE,0,0,0,1,1,4
VENE,0,0,0,1,1,4
ENEL,0,0,0,1,1,4
NELM,0,0,0,1,1,4
TAPE,0,0,0,1,1,4
APEM,0,0,0,1,1,4
PEMT,0,0,0,1,1,4
EMTA,0,0,0,1,1,4
MTAL,0,0,0,1,1,4
TALV,0,0,0,1,1,4
LVGG,0,0,0,1,1,4
VGGM,0,0,0,1,1,4
GGMR,0,0,0,1,1,4
GMRV,0,0,0,1,1,4
MRVL,0,0,0,1,1,4
TDAE,0,0,0,1,1,4
DAEA,0,0,0,1,1,4
AEAK,0,0,0,1,1,4
EAKQ,0,0,0,1,1,4
AQWI,0,0,0,1,1,4
QWIL,0,0,0,1,1,4
WILS,0,0,0,1,1,4
TDKQ,0,0,0,1,1,4
DKQF,0,0,0,1,1,4
KQFE,0,0,0,1,1,4
QFEN,0,0,0,1,1,4
FENR,0,0,0,1,1,4
ENRL,0,0,0,1,1,4
NRLN,0,0,0,1,1,4
RLND,0,0,0,1,1,4
LNDN,0,0,0,1,1,4
NDNL,0,0,0,1,1,4
DNLE,0,0,0,1,1,4
NLEE,0,0,0,1,1,4
EELI,0,0,0,1,1,4
TDLE,0,0,0,1,1,4
DLEI,0,0,0,1,1,4
LEIL,0,0,0,1,1,4
ILAL,0,0,0,1,1,4
ALLI,0,0,0,1,1,4
LLIA,0,0,0,1,1,4
LIAA,0,0,0,1,1,4
AALS,0,0,0,1,1,4
ALSH,0,0,0,1,1,4
DQQK,0,0,0,1,1,4
QQKV,0,0,0,1,1,4
QKVS,0,0,0,2,2,4
KVSE,0,0,0,1,1,4
VSEI,0,0,0,1,1,4
SEIF,0,0,0,1,1,4
EIFQ,0,0,0,1,1,4
FQSS,0,0,0,1,1,4
QSSK,0,0,0,1,1,4
EKLQ,0,0,0,1,1,4
KLQG,0,0,0,1,1,4
LQGD,0,0,0,1,1,4
QGDA,0,0,0,1,1,4
GDAK,0,0,0,1,1,4
DAKV,0,0,0,1,1,4
KVVS,0,0,0,1,1,4
VVSD,0,0,0,1,1,4
VSDA,0,0,0,2,2,4
SDAF,0,0,0,1,1,4
DAFK,0,0,0,2,2,4
TEAK,0,0,0,1,1,4
AKKE,0,0,0,1,1,4
LLRK,0,0,0,1,1,4
LRKL,0,0,0,1,1,4
RKLN,0,0,0,1,1,4
NILE,0,0,0,1,1,4
ILEV,0,0,0,1,1,4
LEVF,0,0,0,1,1,4
TEEE,0,0,0,1,1,4
EEML,0,0,0,1,1,4
EMLQ,0,0,0,1,1,4
LQAA,0,0,0,1,1,4
QAAH,0,0,0,1,1,4
AAHI,0,0,0,1,1,4
AHIT,0,0,0,1,1,4
HITA,0,0,0,1,1,4
ITAK,0,0,0,1,1,4
TAKL,0,0,0,1,1,4
KLAQ,0,0,0,1,1,4
AQAA,0,0,0,1,1,4
QAAE,0,0,0,1,1,4
TEKG,0,0,0,1,1,4
EKGK,0,0,0,1,1,4
KGKE,0,0,0,1,1,4
GKEI,0,0,0,1,1,4
KEIF,0,0,0,1,1,4
EIFG,0,0,0,1,1,4
IFGE,0,0,0,1,1,4
FGEI,0,0,0,1,1,4
EILS,0,0,0,1,1,4
ILSN,0,0,0,1,1,4
LSNF,0,0,0,1,1,4
SNFE,0,0,0,1,1,4
NFES,0,0,0,1,1,4
FESL,0,0,0,1,1,4
ESLL,0,0,0,1,1,4
LKSV,0,0,0,1,1,4
VLEK,0,0,0,1,1,4
TEQD,0,0,0,1,1,4
EQDI,0,0,0,1,1,4
QDII,0,0,0,1,1,4
IIDL,0,0,0,1,1,4
IDLK,0,0,0,1,1,4
DLKF,0,0,0,1,1,4
LKFA,0,0,0,1,1,4
KFAI,0,0,0,1,1,4
FAIA,0,0,0,1,1,4
TEQN,0,0,0,1,1,4
EQNF,0,0,0,1,1,4
QNFQ,0,0,0,1,1,4
NFQL,0,0,0,1,1,4
FQLA,0,0,0,1,1,4
QLAK,0,0,0,1,1,4
QIQS,0,0,0,1,1,4
IQSQ,0,0,0,1,1,4
QSQW,0,0,0,1,1,4
SQWK,0,0,0,1,1,4
QWKE,0,0,0,1,1,4
KEFG,0,0,0,1,1,4
TERE,0,0,0,1,1,4
REQA,0,0,0,1,1,4
EQAL,0,0,0,1,1,4
QALA,0,0,0,1,1,4
AYAE,0,0,0,1,1,4
YAEK,0,0,0,1,1,4
EKLT,0,0,0,1,1,4
KLTR,0,0,0,1,1,4
TESM,0,0,0,1,1,4
ESMK,0,0,0,1,1,4
SMKT,0,0,0,1,1,4
KTVR,0,0,0,1,1,4
TVRI,0,0,0,1,1,4
VRIR,0,0,0,1,1,4
RIRE,0,0,0,1,1,4
IREK,0,0,0,1,1,4
EKIK,0,0,0,1,1,4
KIKK,0,0,0,1,1,4
IKKF,0,0,0,1,1,4
TETQ,0,0,0,1,1,4
ETQI,0,0,0,1,1,4
TQIR,0,0,0,1,1,4
QIRE,0,0,0,1,1,4
LLFD,0,0,0,1,1,4
LFDL,0,0,0,1,1,4
FDLE,0,0,0,1,1,4
DLEL,0,0,0,1,1,4
LELA,0,0,0,1,1,4
ELAY,0,0,0,2,2,4
LAYK,0,0,0,1,1,4
YKSF,0,0,0,1,1,4
SFYA,0,0,0,1,1,4
FYAL,0,0,0,1,1,4
YALL,0,0,0,1,1,4
TEVY,0,0,0,1,1,4
EVYQ,0,0,0,1,1,4
VYQI,0,0,0,1,1,4
YQIL,0,0,0,1,1,4
QILN,0,0,0,1,1,4
ILNR,0,0,0,1,1,4
LNRV,0,0,0,1,1,4
NRVS,0,0,0,1,1,4
TFPD,0,0,0,1,1,4
FPDK,0,0,0,1,1,4
PDKA,0,0,0,1,1,4
DKAL,0,0,0,2,2,4
ALKG,0,0,0,1,1,4
LKGK,0,0,0,1,1,4
KGKK,0,0,0,1,1,4
GKKS,0,0,0,1,1,4
KKSI,0,0,0,1,1,4
KSIE,0,0,0,1,1,4
SIEN,0,0,0,1,1,4
ENIV,0,0,0,1,1,4
NIVV,0,0,0,1,1,4
TFPE,0,0,0,1,1,4
FPEW,0,0,0,1,1,4
PEWH,0,0,0,1,1,4
EWHR,0,0,0,1,1,4
WHRL,0,0,0,2,2,4
HRLY,0,0,0,1,1,4
RLYT,0,0,0,1,1,4
LYTV,0,0,0,1,1,4
YTVQ,0,0,0,1,1,4
TVQF,0,0,0,1,1,4
VQFE,0,0,0,1,1,4
QFED,0,0,0,1,1,4
EDAL,0,0,0,2,2,4
DALR,0,0,0,2,2,4
LRRH,0,0,0,1,1,4
TFPN,0,0,0,1,1,4
FPNW,0,0,0,1,1,4
PNWH,0,0,0,1,1,4
NWHR,0,0,0,1,1,4
HRLL,0,0,0,1,1,4
RLLT,0,0,0,1,1,4
LLTK,0,0,0,2,2,4
LTKQ,0,0,0,1,1,4
TKQM,0,0,0,1,1,4
QMED,0,0,0,1,1,4
MEDA,0,0,0,1,1,4
DALV,0,0,0,2,2,4
LVAK,0,0,0,1,1,4
TFSQ,0,0,0,1,1,4
FSQV,0,0,0,1,1,4
SQVL,0,0,0,1,1,4
VLDD,0,0,0,1,1,4
LDDL,0,0,0,1,1,4
DDLS,0,0,0,1,1,4
LSAR,0,0,0,2,2,4
SARF,0,0,0,1,1,4
ARFI,0,0,0,1,1,4
TGAL,0,0,0,1,1,4
GALR,0,0,0,1,1,4
LRTQ,0,0,0,1,1,4
RTQY,0,0,0,1,1,4
TQYD,0,0,0,1,1,4
QYDV,0,0,0,1,1,4
YDVS,0,0,0,1,1,4
DVSL,0,0,0,1,1,4
SLMT,0,0,0,1,1,4
LMTV,0,0,0,1,1,4
MTVK,0,0,0,1,1,4
TVKS,0,0,0,1,1,4
THAE,0,0,0,1,1,4
HAEM,0,0,0,1,1,4
AEML,0,0,0,1,1,4
EMLH,0,0,0,1,1,4
MLHA,0,0,0,1,1,4
LHAL,0,0,0,1,1,4
HALK,0,0,0,1,1,4
ALKE,0,0,0,1,1,4
LKER,0,0,0,1,1,4
KERY,0,0,0,1,1,4
THNK,0,0,0,1,1,4
HNKL,0,0,0,1,1,4
NKLL,0,0,0,1,1,4
KNVA,0,0,0,1,1,4
NVAF,0,0,0,1,1,4
VAFM,0,0,0,1,1,4
AFMK,0,0,0,1,1,4
FMKS,0,0,0,1,1,4
MKSY,0,0,0,1,1,4
SYIL,0,0,0,1,1,4
YILE,0,0,0,1,1,4
EKVK,0,0,0,1,1,4
KVKE,0,0,0,1,1,4
VKEH,0,0,0,1,1,4
KEHQ,0,0,0,1,1,4
EHQE,0,0,0,1,1,4
HQES,0,0,0,1,1,4
TIEE,0,0,0,1,1,4
IEEF,0,0,0,1,1,4
EEFH,0,0,0,1,1,4
EFHS,0,0,0,1,1,4
FHSK,0,0,0,1,1,4
HSKL,0,0,0,1,1,4
SKLQ,0,0,0,1,1,4
LQEA,0,0,0,1,1,4
QEAT,0,0,0,1,1,4
EATN,0,0,0,1,1,4
TIQS,0,0,0,1,1,4
IQSR,0,0,0,1,1,4
QSRF,0,0,0,1,1,4
SRFN,0,0,0,1,1,4
RFNY,0,0,0,1,1,4
FNYA,0,0,0,1,1,4
NYAW,0,0,0,1,1,4
YAWG,0,0,0,1,1,4
AWGL,0,0,0,1,1,4
WGLI,0,0,0,1,1,4
LIKS,0,0,0,1,1,4
TISL,0,0,0,1,1,4
ISLG,0,0,0,1,1,4
SLGV,0,0,0,1,1,4
LGVS,0,0,0,1,1,4
GVSI,0,0,0,1,1,4
SIAH,0,0,0,1,1,4
IAHV,0,0,0,1,1,4
AHVM,0,0,0,1,1,4
HVME,0,0,0,1,1,4
VMEA,0,0,0,1,1,4
MEAV,0,0,0,1,1,4
ITEM,0,0,0,1,1,4
TEMV,0,0,0,1,1,4
EMVF,0,0,0,1,1,4
MVFL,0,0,0,1,1,4
VFLA,0,0,0,1,1,4
LAEV,0,0,0,1,1,4
EVYK,0,0,0,1,1,4
VYKS,0,0,0,1,1,4
YKSG,0,0,0,1,1,4
KSGG,0,0,0,1,1,4
TIVE,0,0,0,1,1,4
IVEL,0,0,0,1,1,4
VELV,0,0,0,1,1,4
ELVV,0,0,0,1,1,4
LVVR,0,0,0,1,1,4
VVRV,0,0,0,1,1,4
VRVW,0,0,0,1,1,4
WRWF,0,0,0,1,1,4
RWFL,0,0,0,1,1,4
WFLV,0,0,0,1,1,4
FLVI,0,0,0,1,1,4
LVIW,0,0,0,1,1,4
VIWV,0,0,0,1,1,4
IWVL,0,0,0,1,1,4
WVLW,0,0,0,1,1,4
TKDE,0,0,0,2,2,4
KDEF,0,0,0,1,1,4
DEFM,0,0,0,1,1,4
EFMS,0,0,0,1,1,4
FMSG,0,0,0,1,1,4
MSGE,0,0,0,1,1,4
SGEP,0,0,0,1,1,4
GEPI,0,0,0,1,1,4
EPIF,0,0,0,1,1,4
PIFT,0,0,0,1,1,4
IFTK,0,0,0,1,1,4
FTKY,0,0,0,1,1,4
TKYF,0,0,0,1,1,4
KYFQ,0,0,0,1,1,4
YFQN,0,0,0,1,1,4
FQNL,0,0,0,1,1,4
QNLV,0,0,0,1,1,4
KDEQ,0,0,0,1,1,4
DEQV,0,0,0,1,1,4
QVEG,0,0,0,1,1,4
EGLL,0,0,0,1,1,4
GLLA,0,0,0,1,1,4
TKGE,0,0,0,1,1,4
KGER,0,0,0,1,1,4
REMI,0,0,0,1,1,4
EMIV,0,0,0,1,1,4
MIVV,0,0,0,1,1,4
IVVA,0,0,0,1,1,4
VATS,0,0,0,1,1,4
ATSA,0,0,0,1,1,4
SAAN,0,0,0,1,1,4
TKIW,0,0,0,1,1,4
KIWL,0,0,0,1,1,4
IWLN,0,0,0,1,1,4
WLNA,0,0,0,1,1,4
LNAA,0,0,0,1,1,4
NAAR,0,0,0,1,1,4
AARR,0,0,0,1,1,4
ARRT,0,0,0,1,1,4
RRTG,0,0,0,1,1,4
RTGK,0,0,0,1,1,4
TGKV,0,0,0,1,1,4
GKVP,0,0,0,1,1,4
KVPA,0,0,0,1,1,4
VPAR,0,0,0,1,1,4
PARI,0,0,0,1,1,4
ARIR,0,0,0,1,1,4
RIRK,0,0,0,1,1,4
IRKL,0,0,0,1,1,4
LDQM,0,0,0,1,1,4
DQMR,0,0,0,1,1,4
QMRS,0,0,0,1,1,4
MRSR,0,0,0,1,1,4
LAYD,0,0,0,1,1,4
AYDG,0,0,0,1,1,4
TLED,0,0,0,1,1,4
LEDY,0,0,0,1,1,4
EDYV,0,0,0,1,1,4
DYVR,0,0,0,1,1,4
YVRY,0,0,0,1,1,4
VRYV,0,0,0,1,1,4
RYVT,0,0,0,1,1,4
YVTL,0,0,0,1,1,4
VTLD,0,0,0,1,1,4
TLDM,0,0,0,1,1,4
TLIR,0,0,0,1,1,4
IREW,0,0,0,1,1,4
REWG,0,0,0,1,1,4
EWGD,0,0,0,1,1,4
WGDA,0,0,0,1,1,4
GDAV,0,0,0,1,1,4
DAVF,0,0,0,1,1,4
VFDI,0,0,0,1,1,4
FDIF,0,0,0,1,1,4
TMEG,0,0,0,1,1,4
MEGK,0,0,0,1,1,4
EGKF,0,0,0,1,1,4
GKFK,0,0,0,1,1,4
KFKA,0,0,0,1,1,4
FKAV,0,0,0,1,1,4
VAED,0,0,0,1,1,4
AQRY,0,0,0,1,1,4
QRYM,0,0,0,1,1,4
RYMT,0,0,0,1,1,4
TMVQ,0,0,0,1,1,4
MVQA,0,0,0,1,1,4
QAIT,0,0,0,1,1,4
AITD,0,0,0,1,1,4
ITDA,0,0,0,1,1,4
TDAL,0,0,0,1,1,4
ALRI,0,0,0,1,1,4
LRIE,0,0,0,1,1,4
RIEL,0,0,0,1,1,4
IELK,0,0,0,1,1,4
ELKN,0,0,0,1,1,4
LKND,0,0,0,1,1,4
TNDE,0,0,0,1,1,4
NDEI,0,0,0,1,1,4
EIFS,0,0,0,1,1,4
IFSI,0,0,0,1,1,4
FSIL,0,0,0,1,1,4
SILK,0,0,0,1,1,4
TPAK,0,0,0,1,1,4
PAKA,0,0,0,1,1,4
LKSA,0,0,0,1,1,4
KSAI,0,0,0,1,1,4
SAIH,0,0,0,1,1,4
AIHV,0,0,0,1,1,4
IHVA,0,0,0,1,1,4
HVAY,0,0,0,1,1,4
VAYI,0,0,0,1,1,4
AYIL,0,0,0,1,1,4
YILK,0,0,0,1,1,4
TPDQ,0,0,0,1,1,4
PDQQ,0,0,0,1,1,4
DQQT,0,0,0,1,1,4
QQTL,0,0,0,1,1,4
QTLL,0,0,0,1,1,4
TLLH,0,0,0,1,1,4
LLHF,0,0,0,1,1,4
LHFI,0,0,0,1,1,4
HFIM,0,0,0,1,1,4
FIMD,0,0,0,1,1,4
IMDS,0,0,0,1,1,4
MDSY,0,0,0,1,1,4
DSYN,0,0,0,1,1,4
TPEE,0,0,0,2,2,4
KKHY,0,0,0,1,1,4
KHYE,0,0,0,1,1,4
HYEI,0,0,0,1,1,4
EILV,0,0,0,1,1,4
ILVE,0,0,0,1,1,4
LVED,0,0,0,1,1,4
VEDI,0,0,0,1,1,4
EDIK,0,0,0,1,1,4
IKYI,0,0,0,1,1,4
KYIE,0,0,0,1,1,4
YIES,0,0,0,1,1,4
IESG,0,0,0,1,1,4
PEEY,0,0,0,1,1,4
EEYQ,0,0,0,1,1,4
EYQT,0,0,0,1,1,4
YQTY,0,0,0,1,1,4
QTYV,0,0,0,1,1,4
TYVA,0,0,0,1,1,4
YVAQ,0,0,0,1,1,4
VAQV,0,0,0,1,1,4
AQVD,0,0,0,1,1,4
QVDK,0,0,0,1,1,4
TPEK,0,0,0,2,2,4
PEKM,0,0,0,1,1,4
KMGE,0,0,0,1,1,4
MGEM,0,0,0,1,1,4
GEMA,0,0,0,1,1,4
EMAQ,0,0,0,1,1,4
MAQK,0,0,0,1,1,4
AQKF,0,0,0,1,1,4
QKFR,0,0,0,1,1,4
KFRE,0,0,0,1,1,4
PEKR,0,0,0,1,1,4
EKRV,0,0,0,1,1,4
KRVD,0,0,0,1,1,4
RVDR,0,0,0,1,1,4
VDRI,0,0,0,1,1,4
DRIF,0,0,0,1,1,4
RIFA,0,0,0,1,1,4
IFAM,0,0,0,1,1,4
FAMM,0,0,0,1,1,4
AMMD,0,0,0,1,1,4
TPER,0,0,0,1,1,4
PERL,0,0,0,1,1,4
RLEK,0,0,0,1,1,4
EKLV,0,0,0,1,1,4
LVKE,0,0,0,1,1,4
VKEV,0,0,0,1,1,4
TPET,0,0,0,1,1,4
PETI,0,0,0,1,1,4
TITH,0,0,0,1,1,4
ITHY,0,0,0,1,1,4
THYL,0,0,0,1,1,4
HYLE,0,0,0,1,1,4
YLET,0,0,0,1,1,4
LETV,0,0,0,1,1,4
ETVN,0,0,0,1,1,4
TVNH,0,0,0,1,1,4
VNHA,0,0,0,1,1,4
NHAM,0,0,0,1,1,4
TPEV,0,0,0,1,1,4
VVKE,0,0,0,1,1,4
VKER,0,0,0,1,1,4
RLLS,0,0,0,1,1,4
TPLG,0,0,0,1,1,4
PLGI,0,0,0,1,1,4
GIGI,0,0,0,1,1,4
IGIT,0,0,0,1,1,4
GITD,0,0,0,1,1,4
ITDY,0,0,0,1,1,4
TDYY,0,0,0,1,1,4
DYYI,0,0,0,1,1,4
YYIR,0,0,0,1,1,4
TPQD,0,0,0,1,1,4
PQDI,0,0,0,1,1,4
DIAD,0,0,0,1,1,4
IADR,0,0,0,1,1,4
ADRE,0,0,0,1,1,4
DRER,0,0,0,1,1,4
ERIF,0,0,0,1,1,4
RIFK,0,0,0,1,1,4
IFKR,0,0,0,1,1,4
FKRF,0,0,0,1,1,4
KRFD,0,0,0,1,1,4
TPSD,0,0,0,1,1,4
PSDI,0,0,0,1,1,4
DIKE,0,0,0,1,1,4
KELR,0,0,0,1,1,4
ELRD,0,0,0,1,1,4
LRDA,0,0,0,1,1,4
RDAM,0,0,0,1,1,4
DAMA,0,0,0,1,1,4
AMAK,0,0,0,1,1,4
MAKV,0,0,0,1,1,4
AKVQ,0,0,0,1,1,4
KVQA,0,0,0,1,1,4
VQAD,0,0,0,1,1,4
TPVY,0,0,0,1,1,4
PVYR,0,0,0,1,1,4
VYRT,0,0,0,1,1,4
YRTA,0,0,0,1,1,4
RTAI,0,0,0,1,1,4
TAIR,0,0,0,1,1,4
AIRY,0,0,0,1,1,4
IRYY,0,0,0,1,1,4
RYYL,0,0,0,1,1,4
YYLQ,0,0,0,1,1,4
YLQM,0,0,0,1,1,4
QMLF,0,0,0,1,1,4
TPWS,0,0,0,1,1,4
PWSK,0,0,0,1,1,4
WSKG,0,0,0,1,1,4
SKGF,0,0,0,1,1,4
GFLA,0,0,0,1,1,4
FLAS,0,0,0,1,1,4
LASS,0,0,0,1,1,4
ASSY,0,0,0,1,1,4
SSYA,0,0,0,1,1,4
SYAS,0,0,0,1,1,4
YASR,0,0,0,1,1,4
TPYD,0,0,0,1,1,4
PYDA,0,0,0,1,1,4
DAKG,0,0,0,1,1,4
AKGL,0,0,0,1,1,4
KGLL,0,0,0,1,1,4
ISAI,0,0,0,1,1,4
AIRD,0,0,0,1,1,4
TQAQ,0,0,0,1,1,4
QAQE,0,0,0,1,1,4
AQET,0,0,0,1,1,4
QETQ,0,0,0,1,1,4
ETQG,0,0,0,1,1,4
TQGQ,0,0,0,1,1,4
QGQA,0,0,0,1,1,4
GQAA,0,0,0,1,1,4
QAAA,0,0,0,1,1,4
ARAA,0,0,0,1,1,4
AAAD,0,0,0,1,1,4
AADL,0,0,0,1,1,4
ADLA,0,0,0,1,1,4
LAAG,0,0,0,1,1,4
TQDL,0,0,0,1,1,4
QDLR,0,0,0,1,1,4
DLRS,0,0,0,1,1,4
LRSH,0,0,0,1,1,4
RSHL,0,0,0,1,1,4
SHLV,0,0,0,1,1,4
HLVH,0,0,0,1,1,4
HKLV,0,0,0,1,1,4
KLVQ,0,0,0,1,1,4
QAIF,0,0,0,1,1,4
TQGL,0,0,0,1,1,4
QGLL,0,0,0,1,1,4
GLLS,0,0,0,1,1,4
LLSE,0,0,0,1,1,4
LSEI,0,0,0,1,1,4
ILRK,0,0,0,1,1,4
TQGM,0,0,0,1,1,4
QGMQ,0,0,0,1,1,4
GMQN,0,0,0,1,1,4
MQNA,0,0,0,1,1,4
QNAM,0,0,0,1,1,4
NAMG,0,0,0,1,1,4
AMGE,0,0,0,1,1,4
MGER,0,0,0,1,1,4
ERFA,0,0,0,1,1,4
RFAQ,0,0,0,1,1,4
FAQY,0,0,0,1,1,4
AQYA,0,0,0,1,1,4
YALS,0,0,0,1,1,4
ALSS,0,0,0,1,1,4
LSSE,0,0,0,1,1,4
SSEK,0,0,0,1,1,4
SEKL,0,0,0,1,1,4
EKLY,0,0,0,1,1,4
TQSD,0,0,0,1,1,4
QSDV,0,0,0,1,1,4
SDVY,0,0,0,1,1,4
DVYA,0,0,0,1,1,4
VYAM,0,0,0,1,1,4
YAMV,0,0,0,1,1,4
AMVG,0,0,0,1,1,4
MVGY,0,0,0,1,1,4
VGYI,0,0,0,1,1,4
GYIH,0,0,0,1,1,4
YIHE,0,0,0,1,1,4
HELW,0,0,0,1,1,4
TREL,0,0,0,1,1,4
RELA,0,0,0,1,1,4
LAYM,0,0,0,1,1,4
AYMI,0,0,0,1,1,4
YMIK,0,0,0,1,1,4
MIKK,0,0,0,1,1,4
TRTQ,0,0,0,1,1,4
RTQR,0,0,0,1,1,4
TQRR,0,0,0,1,1,4
RRIA,0,0,0,1,1,4
RIAV,0,0,0,1,1,4
IAVV,0,0,0,1,1,4
AVVE,0,0,0,1,1,4
VVEF,0,0,0,1,1,4
VEFI,0,0,0,1,1,4
EFIF,0,0,0,1,1,4
FIFS,0,0,0,1,1,4
IFSL,0,0,0,1,1,4
FSLL,0,0,0,1,1,4
TSAQ,0,0,0,2,2,4
SAQT,0,0,0,1,1,4
AQTK,0,0,0,1,1,4
QTKV,0,0,0,1,1,4
TKVV,0,0,0,1,1,4
KVVV,0,0,0,1,1,4
VVVD,0,0,0,1,1,4
VVDA,0,0,0,1,1,4
SFDE,0,0,0,1,1,4
FDEY,0,0,0,1,1,4
DEYV,0,0,0,1,1,4
EYVA,0,0,0,1,1,4
AELD,0,0,0,1,1,4
LDSK,0,0,0,1,1,4
TSHL,0,0,0,1,1,4
SHLM,0,0,0,1,1,4
HLMG,0,0,0,1,1,4
LMGM,0,0,0,1,1,4
MGMF,0,0,0,1,1,4
GMFY,0,0,0,1,1,4
MFYR,0,0,0,1,1,4
FYRT,0,0,0,1,1,4
YRTI,0,0,0,1,1,4
RTIR,0,0,0,1,1,4
TIRM,0,0,0,1,1,4
IRMM,0,0,0,1,1,4
RMME,0,0,0,1,1,4
MMEN,0,0,0,1,1,4
TTDE,0,0,0,1,1,4
TDEI,0,0,0,1,1,4
DEIN,0,0,0,1,1,4
EINA,0,0,0,1,1,4
INAM,0,0,0,1,1,4
NAMD,0,0,0,1,1,4
AMDK,0,0,0,1,1,4
MDKA,0,0,0,1,1,4
KALI,0,0,0,1,1,4
ALIL,0,0,0,1,1,4
LILY,0,0,0,1,1,4
ILYT,0,0,0,1,1,4
TTGN,0,0,0,1,1,4
GNFE,0,0,0,1,1,4
NFEK,0,0,0,1,1,4
KLFV,0,0,0,1,1,4
LFVA,0,0,0,1,1,4
FVAL,0,0,0,1,1,4
VALV,0,0,0,1,1,4
ALVE,0,0,0,1,1,4
LVEY,0,0,0,1,1,4
VEYM,0,0,0,1,1,4
EYMR,0,0,0,1,1,4
YMRA,0,0,0,1,1,4
MRAS,0,0,0,1,1,4
TVEE,0,0,0,1,1,4
VEEV,0,0,0,1,1,4
EEVN,0,0,0,1,1,4
EVNA,0,0,0,1,1,4
VNAL,0,0,0,1,1,4
LKNE,0,0,0,1,1,4
KNEI,0,0,0,1,1,4
NEIL,0,0,0,1,1,4
EILK,0,0,0,1,1,4
LKAH,0,0,0,1,1,4
KAHA,0,0,0,1,1,4
TVFG,0,0,0,1,1,4
VFGT,0,0,0,1,1,4
FGTA,0,0,0,1,1,4
GTAL,0,0,0,1,1,4
TALN,0,0,0,1,1,4
ALNY,0,0,0,1,1,4
LNYV,0,0,0,1,1,4
NYVS,0,0,0,1,1,4
YVSL,0,0,0,1,1,4
VSLR,0,0,0,1,1,4
SLRI,0,0,0,1,1,4
TVLA,0,0,0,1,1,4
ALFL,0,0,0,1,1,4
LAGS,0,0,0,1,1,4
TYYA,0,0,0,1,1,4
YYAK,0,0,0,1,1,4
YAKD,0,0,0,1,1,4
AKDI,0,0,0,1,1,4
KDIA,0,0,0,1,1,4
IAFQ,0,0,0,1,1,4
AFQF,0,0,0,1,1,4
FQFW,0,0,0,1,1,4
QFWK,0,0,0,1,1,4
FWKM,0,0,0,1,1,4
VADI,0,0,0,1,1,4
ADIA,0,0,0,1,1,4
IAKL,0,0,0,1,1,4
KLKV,0,0,0,1,1,4
LKVN,0,0,0,1,1,4
KVNI,0,0,0,1,1,4
NIIK,0,0,0,1,1,4
IIKN,0,0,0,1,1,4
NVRI,0,0,0,1,1,4
VRII,0,0,0,1,1,4
VADP,0,0,0,1,1,4
ADPV,0,0,0,1,1,4
DPVA,0,0,0,1,1,4
PVAA,0,0,0,1,1,4
VAAF,0,0,0,1,1,4
AAFK,0,0,0,1,1,4
AFKW,0,0,0,1,1,4
FKWR,0,0,0,1,1,4
KWRA,0,0,0,1,1,4
WRAQ,0,0,0,1,1,4
VDDN,0,0,0,1,1,4
DDNL,0,0,0,1,1,4
NLYP,0,0,0,1,1,4
LYPQ,0,0,0,1,1,4
YPQL,0,0,0,1,1,4
PQLE,0,0,0,1,1,4
ERAS,0,0,0,1,1,4
RASR,0,0,0,1,1,4
KIFE,0,0,0,1,1,4
IFEF,0,0,0,1,1,4
FEFL,0,0,0,1,1,4
EFLE,0,0,0,1,1,4
VEAI,0,0,0,1,1,4
LKGN,0,0,0,1,1,4
VFWP,0,0,0,1,1,4
FWPT,0,0,0,1,1,4
WPTM,0,0,0,1,1,4
PTML,0,0,0,1,1,4
TMLK,0,0,0,1,1,4
MLKA,0,0,0,1,1,4
VGVL,0,0,0,1,1,4
LQLL,0,0,0,1,1,4
VGYE,0,0,0,1,1,4
GYET,0,0,0,1,1,4
YETA,0,0,0,1,1,4
ETAA,0,0,0,1,1,4
KLAR,0,0,0,1,1,4
AREA,0,0,0,1,1,4
VHVL,0,0,0,1,1,4
HVLA,0,0,0,1,1,4
ADAF,0,0,0,1,1,4
FKRY,0,0,0,1,1,4
KRYL,0,0,0,1,1,4
RYLL,0,0,0,1,1,4
VIDP,0,0,0,1,1,4
IDPL,0,0,0,1,1,4
DPLH,0,0,0,1,1,4
PLHT,0,0,0,1,1,4
LHTH,0,0,0,1,1,4
HTHL,0,0,0,1,1,4
THLT,0,0,0,1,1,4
HLTR,0,0,0,1,1,4
TRLV,0,0,0,1,1,4
RLVA,0,0,0,1,1,4
VAAY,0,0,0,1,1,4
AAYT,0,0,0,1,1,4
AYTG,0,0,0,1,1,4
VKYA,0,0,0,1,1,4
KYAV,0,0,0,1,1,4
YAVF,0,0,0,1,1,4
VFEA,0,0,0,1,1,4
EAAL,0,0,0,1,1,4
AALT,0,0,0,1,1,4
LTKA,0,0,0,1,1,4
TKAI,0,0,0,1,1,4
KAIT,0,0,0,1,1,4
ITAM,0,0,0,1,1,4
TAMS,0,0,0,1,1,4
AMSE,0,0,0,1,1,4
MSEV,0,0,0,1,1,4
SEVQ,0,0,0,1,1,4
KVSQ,0,0,0,1,1,4
VLSF,0,0,0,1,1,4
LSFK,0,0,0,1,1,4
SFKT,0,0,0,1,1,4
FKTG,0,0,0,1,1,4
KTGI,0,0,0,1,1,4
TGII,0,0,0,1,1,4
GIIS,0,0,0,1,1,4
IISL,0,0,0,1,1,4
VMEL,0,0,0,1,1,4
LTKT,0,0,0,1,1,4
TKTL,0,0,0,1,1,4
KTLG,0,0,0,1,1,4
TLGW,0,0,0,1,1,4
LGWD,0,0,0,1,1,4
GWDI,0,0,0,1,1,4
WDIQ,0,0,0,1,1,4
DIQE,0,0,0,1,1,4
ELNK,0,0,0,1,1,4
LNKL,0,0,0,1,1,4
NKLT,0,0,0,1,1,4
VMGQ,0,0,0,1,1,4
MGQN,0,0,0,1,1,4
GQNL,0,0,0,1,1,4
QNLI,0,0,0,1,1,4
NLIL,0,0,0,1,1,4
LILN,0,0,0,1,1,4
ILNM,0,0,0,1,1,4
LNMN,0,0,0,1,1,4
NMND,0,0,0,1,1,4
VMPS,0,0,0,1,1,4
MPSL,0,0,0,1,1,4
PSLL,0,0,0,1,1,4
LQAF,0,0,0,1,1,4
QAFD,0,0,0,1,1,4
AFDL,0,0,0,1,1,4
FDLT,0,0,0,1,1,4
DLTA,0,0,0,1,1,4
VMQW,0,0,0,1,1,4
MQWV,0,0,0,1,1,4
QWVI,0,0,0,1,1,4
WVIR,0,0,0,1,1,4
VIRI,0,0,0,1,1,4
IRIL,0,0,0,1,1,4
RILG,0,0,0,1,1,4
ILGG,0,0,0,1,1,4
LGGG,0,0,0,1,1,4
GGGL,0,0,0,1,1,4
GGLQ,0,0,0,1,1,4
GLQK,0,0,0,1,1,4
LQKA,0,0,0,1,1,4
QKAL,0,0,0,1,1,4
NFLV,0,0,0,1,1,4
FLVA,0,0,0,1,1,4
VADA,0,0,0,1,1,4
KQHR,0,0,0,1,1,4
QHRH,0,0,0,1,1,4
HRHR,0,0,0,1,1,4
RHRR,0,0,0,1,1,4
HRRD,0,0,0,1,1,4
RRDD,0,0,0,1,1,4
RDDV,0,0,0,1,1,4
DDVI,0,0,0,1,1,4
DVIV,0,0,0,1,1,4
VIVM,0,0,0,1,1,4
IVML,0,0,0,1,1,4
VMLS,0,0,0,1,1,4
MLSA,0,0,0,1,1,4
VNQF,0,0,0,1,1,4
NQFL,0,0,0,1,1,4
FLDY,0,0,0,1,1,4
LDYL,0,0,0,1,1,4
DYLQ,0,0,0,1,1,4
YLQE,0,0,0,1,1,4
QEFL,0,0,0,1,1,4
EFLG,0,0,0,2,2,4
FLGV,0,0,0,1,1,4
LGVM,0,0,0,1,1,4
GVMN,0,0,0,1,1,4
VMNT,0,0,0,1,1,4
VPMQ,0,0,0,1,1,4
PMQR,0,0,0,1,1,4
MQRV,0,0,0,1,1,4
QRVL,0,0,0,1,1,4
RVLK,0,0,0,1,1,4
VLKY,0,0,0,1,1,4
LKYH,0,0,0,1,1,4
KYHL,0,0,0,1,1,4
YHLL,0,0,0,1,1,4
LLLQ,0,0,0,1,1,4
LQEL,0,0,0,1,1,4
QELV,0,0,0,1,1,4
ELVK,0,0,0,1,1,4
QEVN,0,0,0,1,1,4
VNRF,0,0,0,1,1,4
NRFI,0,0,0,1,1,4
RFIK,0,0,0,1,1,4
FIKA,0,0,0,1,1,4
FEEM,0,0,0,1,1,4
EEMK,0,0,0,1,1,4
EMKA,0,0,0,1,1,4
MKAL,0,0,0,1,1,4
KALM,0,0,0,1,1,4
ALMK,0,0,0,1,1,4
LMKS,0,0,0,1,1,4
MKSL,0,0,0,1,1,4
SDAR,0,0,0,1,1,4
DARS,0,0,0,1,1,4
ARSA,0,0,0,1,1,4
SAIT,0,0,0,1,1,4
AITS,0,0,0,1,1,4
SAQE,0,0,0,1,1,4
VWHY,0,0,0,1,1,4
WHYA,0,0,0,1,1,4
HYAL,0,0,0,1,1,4
YALW,0,0,0,1,1,4
ALWS,0,0,0,1,1,4
LWSL,0,0,0,1,1,4
WSLI,0,0,0,1,1,4
SLIQ,0,0,0,1,1,4
IQQS,0,0,0,1,1,4
QQSE,0,0,0,1,1,4
EILF,0,0,0,1,1,4
ILFA,0,0,0,1,1,4
LFAQ,0,0,0,1,1,4
VYGP,0,0,0,1,1,4
YGPF,0,0,0,1,1,4
GPFW,0,0,0,1,1,4
PFWK,0,0,0,1,1,4
FWKN,0,0,0,1,1,4
WKNW,0,0,0,1,1,4
KNWQ,0,0,0,1,1,4
NWQA,0,0,0,1,1,4
WATL,0,0,0,1,1,4
ATLL,0,0,0,1,1,4
TLLA,0,0,0,1,1,4
AQWA,0,0,0,1,1,4
QWAD,0,0,0,1,1,4
WADR,0,0,0,1,1,4
ADRA,0,0,0,1,1,4
DRAL,0,0,0,1,1,4
WDDI,0,0,0,1,1,4
DDIR,0,0,0,1,1,4
DIRN,0,0,0,1,1,4
IRND,0,0,0,1,1,4
RNDL,0,0,0,1,1,4
NDLF,0,0,0,2,2,4
DLFR,0,0,0,1,1,4
LFRI,0,0,0,1,1,4
FRIQ,0,0,0,1,1,4
RIQN,0,0,0,1,1,4
IQND,0,0,0,1,1,4
QNDL,0,0,0,1,1,4
DLFV,0,0,0,1,1,4
FVLG,0,0,0,1,1,4
LGED,0,0,0,1,1,4
GEDV,0,0,0,1,1,4
EDVS,0,0,0,1,1,4
DVST,0,0,0,1,1,4
YAKG,0,0,0,1,1,4
AKGA,0,0,0,1,1,4
KGAL,0,0,0,1,1,4
GALQ,0,0,0,1,1,4
ALQY,0,0,0,1,1,4
LQYL,0,0,0,1,1,4
QYLV,0,0,0,1,1,4
YLVP,0,0,0,1,1,4
LVPI,0,0,0,1,1,4
VPIL,0,0,0,1,1,4
PILT,0,0,0,1,1,4
ILTQ,0,0,0,1,1,4
LTQT,0,0,0,1,1,4
TQTL,0,0,0,1,1,4
YDDI,0,0,0,1,1,4
DDII,0,0,0,1,1,4
IEAA,0,0,0,1,1,4
AAGE,0,0,0,1,1,4
AGEL,0,0,0,1,1,4
GELG,0,0,0,1,1,4
YDLL,0,0,0,1,1,4
DLLK,0,0,0,1,1,4
LKDL,0,0,0,1,1,4
KDLE,0,0,0,1,1,4
DLEE,0,0,0,1,1,4
LEEG,0,0,0,1,1,4
EGIQ,0,0,0,1,1,4
GIQT,0,0,0,1,1,4
QTLM,0,0,0,1,1,4
TLMG,0,0,0,1,1,4
LMGR,0,0,0,1,1,4
MGRL,0,0,0,1,1,4
YEDK,0,0,0,1,1,4
EDKA,0,0,0,1,1,4
DKAV,0,0,0,1,1,4
KAVE,0,0,0,1,1,4
AVEL,0,0,0,1,1,4
VELY,0,0,0,1,1,4
LYSR,0,0,0,1,1,4
YSRT,0,0,0,1,1,4
SRTA,0,0,0,1,1,4
RTAR,0,0,0,1,1,4
TLEF,0,0,0,1,1,4
LEFL,0,0,0,1,1,4
FLGD,0,0,0,1,1,4
LGDA,0,0,0,1,1,4
GDAL,0,0,0,1,1,4
ALVN,0,0,0,1,1,4
LVNF,0,0,0,1,1,4
VNFF,0,0,0,1,1,4
NFFI,0,0,0,1,1,4
FFIV,0,0,0,1,1,4
FIVD,0,0,0,1,1,4
IVDL,0,0,0,1,1,4
VDLL,0,0,0,1,1,4
DLLV,0,0,0,1,1,4
LVQY,0,0,0,1,1,4
VQYS,0,0,0,1,1,4
YFSK,0,0,0,1,1,4
FSKG,0,0,0,1,1,4
SKGI,0,0,0,1,1,4
KGIP,0,0,0,1,1,4
GIPN,0,0,0,1,1,4
IPNV,0,0,0,1,1,4
PNVL,0,0,0,1,1,4
VLRR,0,0,0,1,1,4
YGSI,0,0,0,1,1,4
GSIG,0,0,0,1,1,4
IGLT,0,0,0,1,1,4
GLTN,0,0,0,1,1,4
TNFG,0,0,0,1,1,4
NFGY,0,0,0,1,1,4
FGYL,0,0,0,1,1,4
YLDK,0,0,0,2,2,4
LDKE,0,0,0,2,2,4
YKEP,0,0,0,1,1,4
KEPL,0,0,0,1,1,4
EPLK,0,0,0,1,1,4
LKAV,0,0,0,1,1,4
KAVV,0,0,0,1,1,4
VVKK,0,0,0,1,1,4
VKKL,0,0,0,1,1,4
KLLE,0,0,0,1,1,4
LEKE,0,0,0,1,1,4
YKKF,0,0,0,1,1,4
KKFR,0,0,0,1,1,4
KFRQ,0,0,0,1,1,4
FRQL,0,0,0,1,1,4
RQLI,0,0,0,1,1,4
QLIQ,0,0,0,1,1,4
LIQV,0,0,0,1,1,4
IQVN,0,0,0,1,1,4
YLAD,0,0,0,1,1,4
FLAP,0,0,0,1,1,4
LAPQ,0,0,0,1,1,4
APQI,0,0,0,1,1,4
PQIH,0,0,0,1,1,4
IHGA,0,0,0,1,1,4
HGAI,0,0,0,1,1,4
GAIN,0,0,0,1,1,4
AINR,0,0,0,1,1,4
INRF,0,0,0,1,1,4
NRFQ,0,0,0,1,1,4
DKEV,0,0,0,1,1,4
KEVK,0,0,0,1,1,4
EVKL,0,0,0,1,1,4
IKKM,0,0,0,1,1,4
KKMG,0,0,0,1,1,4
KMGN,0,0,0,1,1,4
MGNH,0,0,0,1,1,4
GNHL,0,0,0,1,1,4
NHLT,0,0,0,1,1,4
HLTN,0,0,0,1,1,4
LTNL,0,0,0,1,1,4
TNLR,0,0,0,1,1,4
NLRR,0,0,0,1,1,4
RRVA,0,0,0,1,1,4
YLSE,0,0,0,1,1,4
LSES,0,0,0,1,1,4
SESV,0,0,0,1,1,4
ESVE,0,0,0,1,1,4
SVET,0,0,0,1,1,4
VETI,0,0,0,1,1,4
ETIK,0,0,0,1,1,4
TIKK,0,0,0,1,1,4
KLGD,0,0,0,1,1,4
LGDH,0,0,0,1,1,4
GDHI,0,0,0,1,1,4
DHIT,0,0,0,1,1,4
HITS,0,0,0,1,1,4
ITSL,0,0,0,1,1,4
TSLK,0,0,0,1,1,4
KKLW,0,0,0,1,1,4
YPIV,0,0,0,1,1,4
PIVD,0,0,0,1,1,4
IVDA,0,0,0,1,1,4
VDAA,0,0,0,1,1,4
DAAM,0,0,0,1,1,4
AAMR,0,0,0,1,1,4
AMRQ,0,0,0,1,1,4
MRQL,0,0,0,1,1,4
RQLT,0,0,0,1,1,4
QLTE,0,0,0,1,1,4
LTET,0,0,0,1,1,4
TETG,0,0,0,1,1,4
YQNI,0,0,0,1,1,4
QNIV,0,0,0,1,1,4
VKAV,0,0,0,1,1,4
KAVQ,0,0,0,1,1,4
AVQY,0,0,0,1,1,4
VQYA,0,0,0,1,1,4
QYAA,0,0,0,1,1,4
YAAR,0,0,0,1,1,4
AARK,0,0,0,1,1,4
ARKL,0,0,0,1,1,4
RKLQ,0,0,0,1,1,4
YQQQ,0,0,0,1,1,4
QQQK,0,0,0,1,1,4
QQKK,0,0,0,1,1,4
QKKY,0,0,0,1,1,4
KYLG,0,0,0,1,1,4
YLGR,0,0,0,1,1,4
LGRM,0,0,0,1,1,4
GRMT,0,0,0,1,1,4
RMTE,0,0,0,1,1,4
