Sequence,Frequency Very Active,Frequency Mod. Active,Frequency Inactive - Exp,Frequency Inactive - Virtual,Frequency Total,Sequence Length
AI,4,5,2,82,93,2
IG,15,22,1,26,64,2
GK,5,11,2,40,58,2
KF,17,27,8,33,85,2
FL,16,24,4,70,114,2
LH,9,9,1,27,46,2
HS,0,7,1,14,22,2
SA,3,11,2,59,75,2
AK,21,93,102,72,288,2
KK,46,117,73,81,317,2
FG,0,4,1,21,26,2
KA,9,49,37,83,178,2
AF,5,9,4,37,55,2
FV,1,4,1,27,33,2
VG,1,5,3,35,44,2
GE,0,3,1,33,37,2
EI,0,4,0,68,72,2
IM,0,4,0,15,19,2
MN,0,4,0,13,17,2
NS,0,4,0,20,24,2
FA,6,41,41,37,125,2
AL,4,67,55,167,293,2
LA,13,62,75,146,296,2
KL,22,89,95,102,308,2
LL,11,18,24,172,225,2
LK,20,55,38,119,232,2
KI,9,14,8,47,78,2
II,3,1,1,44,49,2
IA,0,9,4,76,89,2
IL,0,0,4,88,92,2
FK,17,25,10,49,101,2
AA,1,7,4,141,153,2
KW,11,18,4,17,50,2
WK,11,15,4,10,40,2
LI,6,2,1,95,104,2
GA,2,9,0,31,42,2
AV,3,14,2,87,106,2
VL,7,11,2,96,116,2
KV,4,25,9,56,94,2
LF,7,36,4,52,99,2
KG,1,3,1,33,38,2
GL,6,26,2,61,95,2
KS,10,6,1,51,68,2
SL,4,2,3,83,92,2
LW,0,2,1,22,25,2
WA,0,5,2,22,29,2
GI,7,11,2,27,47,2
LR,3,1,2,82,88,2
RA,1,0,2,73,76,2
IK,6,22,2,52,82,2
KR,0,4,1,52,57,2
RR,2,1,2,56,61,2
RG,0,0,1,23,24,2
GV,0,1,1,27,29,2
VR,0,0,1,50,51,2
RK,0,1,1,41,43,2
VA,3,17,3,108,131,2
KD,0,0,1,36,37,2
DL,0,0,1,61,62,2
RL,3,3,0,103,109,2
VK,2,6,6,59,73,2
LG,2,9,2,65,78,2
FH,0,1,0,8,9,2
HA,0,2,0,28,30,2
LS,1,3,1,55,60,2
SK,0,2,0,44,46,2
SH,0,1,0,11,12,2
HL,4,1,0,41,46,2
GM,2,0,0,9,11,2
MI,2,0,0,19,21,2
IP,3,1,1,13,18,2
PG,1,0,0,6,7,2
GG,2,5,1,21,29,2
IS,7,4,1,44,56,2
PK,2,2,1,14,19,2
GW,0,2,0,14,16,2
WL,0,4,0,29,33,2
AW,0,2,0,23,25,2
AG,1,6,1,42,50,2
KN,0,1,0,29,30,2
NF,0,1,0,30,31,2
LP,1,2,1,11,15,2
PT,1,0,0,7,8,2
TI,1,0,0,30,31,2
IC,1,0,0,0,1,2
CK,2,0,0,0,2,2
SY,1,0,0,22,23,2
YK,1,0,1,20,22,2
KC,3,0,0,0,3,2
LV,1,0,1,87,89,2
PS,0,0,1,9,10,2
GS,0,3,1,17,21,2
SI,0,3,1,48,52,2
WW,8,3,1,8,20,2
LT,0,2,0,72,74,2
TT,0,3,0,15,18,2
TG,0,2,0,29,31,2
PA,0,2,1,23,26,2
SW,0,1,0,10,11,2
WI,0,1,0,18,19,2
RQ,0,1,0,33,34,2
QQ,0,1,0,38,39,2
AE,0,3,0,115,118,2
IN,1,0,0,34,35,2
NN,1,0,0,16,17,2
VI,4,26,0,47,77,2
IR,0,2,1,50,53,2
AS,1,9,0,52,62,2
SV,1,8,0,45,54,2
FD,0,12,0,30,42,2
DI,0,6,0,49,55,2
ES,0,1,0,44,45,2
SF,5,4,0,31,40,2
IV,0,8,1,44,53,2
GH,0,3,0,10,13,2
HI,0,3,0,13,16,2
SS,5,5,0,29,39,2
VS,0,2,0,39,41,2
VV,0,1,1,50,52,2
DV,0,6,0,29,35,2
PW,4,1,3,4,12,2
WP,4,1,2,4,11,2
WR,0,0,1,10,11,2
FP,5,1,0,13,19,2
PF,4,1,0,5,10,2
VF,0,1,2,42,45,2
KT,10,8,0,26,44,2
TK,0,2,0,34,36,2
AT,0,1,0,47,48,2
TF,5,4,0,21,30,2
TV,5,3,0,37,45,2
HT,5,3,0,12,20,2
TA,2,3,0,52,57,2
AH,0,2,0,23,25,2
TL,3,0,0,60,63,2
KY,0,0,1,29,30,2
VD,0,1,0,30,31,2
DF,0,1,0,25,26,2
IE,0,1,1,72,74,2
EK,0,1,1,78,80,2
GR,1,1,1,20,23,2
RN,0,2,2,17,21,2
NI,0,1,1,39,41,2
NG,0,1,1,14,16,2
GP,0,1,1,7,9,2
EA,0,1,1,103,105,2
MP,0,0,1,4,5,2
LQ,1,0,0,79,80,2
QF,1,0,0,16,17,2
PV,1,0,0,14,15,2
AD,0,0,0,49,49,2
IF,0,0,0,36,36,2
FS,0,0,0,31,31,2
DM,0,0,0,21,21,2
ME,0,0,0,33,33,2
EV,0,0,0,69,69,2
AQ,0,0,0,62,62,2
QK,0,0,0,30,30,2
DN,0,0,0,23,23,2
NV,0,0,0,26,26,2
SQ,0,0,0,23,23,2
QR,0,0,0,44,44,2
QA,0,0,0,79,79,2
LM,0,0,0,40,40,2
MS,0,0,0,16,16,2
AY,0,0,0,51,51,2
YA,0,0,0,30,30,2
LY,0,0,0,42,42,2
YE,0,0,0,29,29,2
AP,0,0,0,12,12,2
HE,0,0,0,19,19,2
HD,0,0,0,8,8,2
DS,0,0,0,32,32,2
EG,0,0,0,40,40,2
ER,0,0,0,79,79,2
RE,0,0,0,77,77,2
AR,0,0,0,72,72,2
RV,0,0,0,54,54,2
FT,0,0,0,18,18,2
LN,0,0,0,51,51,2
DP,0,0,0,17,17,2
PL,0,0,0,22,22,2
MR,0,0,0,23,23,2
KQ,0,0,0,40,40,2
QL,0,0,0,68,68,2
EH,0,0,0,20,20,2
MD,0,0,0,16,16,2
VW,0,0,0,17,17,2
WD,0,0,0,10,10,2
EL,0,0,0,120,120,2
ST,0,0,0,24,24,2
YQ,0,0,0,17,17,2
YD,0,0,0,18,18,2
DE,0,0,0,58,58,2
FF,0,0,0,29,29,2
LD,0,0,0,75,75,2
FR,0,0,0,35,35,2
RH,0,0,0,19,19,2
KE,0,0,0,71,71,2
EE,0,0,0,100,100,2
NY,0,0,0,15,15,2
YI,0,0,0,23,23,2
LE,0,0,0,114,114,2
RF,0,0,0,41,41,2
PN,0,0,0,9,9,2
NR,0,0,0,25,25,2
GD,0,0,0,11,11,2
HN,0,0,0,7,7,2
QM,0,0,0,24,24,2
ML,0,0,0,31,31,2
EM,0,0,0,43,43,2
MV,0,0,0,27,27,2
RI,0,0,0,61,61,2
TS,0,0,0,27,27,2
SD,0,0,0,29,29,2
VN,0,0,0,33,33,2
NA,0,0,0,39,39,2
DA,0,0,0,76,76,2
GN,0,0,0,17,17,2
NL,0,0,0,53,53,2
MT,0,0,0,14,14,2
RM,0,0,0,14,14,2
MA,0,0,0,30,30,2
QS,0,0,0,28,28,2
SM,0,0,0,12,12,2
QE,0,0,0,48,48,2
IQ,0,0,0,44,44,2
QV,0,0,0,41,41,2
ND,0,0,0,21,21,2
IT,0,0,0,31,31,2
TH,0,0,0,11,11,2
HV,0,0,0,17,17,2
VE,0,0,0,45,45,2
RT,0,0,0,27,27,2
ED,0,0,0,43,43,2
KP,0,0,0,11,11,2
WG,0,0,0,14,14,2
GT,0,0,0,17,17,2
YG,0,0,0,12,12,2
MG,0,0,0,17,17,2
AM,0,0,0,36,36,2
MF,0,0,0,13,13,2
FE,0,0,0,39,39,2
EQ,0,0,0,54,54,2
AN,0,0,0,40,40,2
PD,0,0,0,10,10,2
VY,0,0,0,20,20,2
YW,0,0,0,6,6,2
NK,0,0,0,21,21,2
QG,0,0,0,17,17,2
YH,0,0,0,5,5,2
PE,0,0,0,42,42,2
RD,0,0,0,32,32,2
YL,0,0,0,52,52,2
YS,0,0,0,18,18,2
QT,0,0,0,24,24,2
SR,0,0,0,53,53,2
RW,0,0,0,12,12,2
MQ,0,0,0,18,18,2
QI,0,0,0,25,25,2
FI,0,0,0,31,31,2
EY,0,0,0,24,24,2
VH,0,0,0,11,11,2
DT,0,0,0,19,19,2
HK,0,0,0,14,14,2
EN,0,0,0,38,38,2
WM,0,0,0,4,4,2
GQ,0,0,0,18,18,2
VM,0,0,0,20,20,2
TQ,0,0,0,22,22,2
MM,0,0,0,9,9,2
RY,0,0,0,20,20,2
YV,0,0,0,26,26,2
DK,0,0,0,31,31,2
TM,0,0,0,14,14,2
SE,0,0,0,40,40,2
DD,0,0,0,23,23,2
ET,0,0,0,43,43,2
MW,0,0,0,3,3,2
DR,0,0,0,30,30,2
RS,0,0,0,33,33,2
IH,0,0,0,28,28,2
TR,0,0,0,23,23,2
VQ,0,0,0,40,40,2
VT,0,0,0,17,17,2
DY,0,0,0,19,19,2
HM,0,0,0,7,7,2
MK,0,0,0,21,21,2
QY,0,0,0,25,25,2
FQ,0,0,0,15,15,2
SN,0,0,0,20,20,2
EF,0,0,0,36,36,2
QH,0,0,0,19,19,2
NT,0,0,0,16,16,2
TY,0,0,0,13,13,2
YR,0,0,0,31,31,2
KM,0,0,0,18,18,2
EP,0,0,0,9,9,2
PQ,0,0,0,16,16,2
EW,0,0,0,14,14,2
HR,0,0,0,12,12,2
YF,0,0,0,22,22,2
DG,0,0,0,11,11,2
GF,0,0,0,24,24,2
KH,0,0,0,19,19,2
HP,0,0,0,6,6,2
DH,0,0,0,11,11,2
TP,0,0,0,19,19,2
FM,0,0,0,10,10,2
TE,0,0,0,43,43,2
GY,0,0,0,14,14,2
FW,0,0,0,12,12,2
NM,0,0,0,12,12,2
IY,0,0,0,16,16,2
HH,0,0,0,15,15,2
WQ,0,0,0,15,15,2
QW,0,0,0,14,14,2
WS,0,0,0,15,15,2
MY,0,0,0,3,3,2
YY,0,0,0,18,18,2
ID,0,0,0,34,34,2
IW,0,0,0,18,18,2
NQ,0,0,0,21,21,2
TN,0,0,0,14,14,2
NH,0,0,0,10,10,2
PY,0,0,0,5,5,2
DQ,0,0,0,28,28,2
QD,0,0,0,19,19,2
PR,0,0,0,8,8,2
QN,0,0,0,23,23,2
YM,0,0,0,12,12,2
MH,0,0,0,5,5,2
HQ,0,0,0,10,10,2
SG,0,0,0,26,26,2
FN,0,0,0,20,20,2
DW,0,0,0,8,8,2
PP,0,0,0,1,1,2
PI,0,0,0,14,14,2
WY,0,0,0,6,6,2
HG,0,0,0,8,8,2
YT,0,0,0,13,13,2
QP,0,0,0,4,4,2
SP,0,0,0,18,18,2
WF,0,0,0,9,9,2
WN,0,0,0,1,1,2
NE,0,0,0,31,31,2
YN,0,0,0,10,10,2
HY,0,0,0,9,9,2
TD,0,0,0,16,16,2
FY,0,0,0,19,19,2
VP,0,0,0,9,9,2
WH,0,0,0,7,7,2
YP,0,0,0,4,4,2
PM,0,0,0,4,4,2
PH,0,0,0,3,3,2
HF,0,0,0,11,11,2
WV,0,0,0,12,12,2
HW,0,0,0,2,2,2
NW,0,0,0,9,9,2
WE,0,0,0,6,6,2
WT,0,0,0,5,5,2
TW,0,0,0,2,2,2
NP,0,0,0,10,10,2
RP,0,0,0,6,6,2
AIG,0,1,0,2,3,3
IGK,5,7,1,4,17,3
GKF,5,6,1,2,14,3
KFL,6,11,2,8,27,3
FLH,4,8,1,1,14,3
LHS,0,7,1,1,9,3
HSA,0,7,1,1,9,3
SAK,2,9,1,3,15,3
AKK,11,48,46,7,112,3
KKF,11,16,4,5,36,3
KFG,0,2,1,0,3,3
FGK,0,3,1,0,4,3
GKA,0,2,1,3,6,3
KAF,3,4,2,5,14,3
AFV,1,4,1,0,6,3
FVG,0,2,0,0,2,3
VGE,0,2,0,1,3,3
GEI,0,2,0,4,6,3
EIM,0,4,0,1,5,3
IMN,0,4,0,1,5,3
MNS,0,4,0,0,4,3
FAK,4,25,32,3,64,3
AKA,2,12,7,12,33,3
KAL,1,38,29,12,80,3
ALA,0,11,11,23,45,3
LAK,11,45,58,9,123,3
AKL,5,24,43,7,79,3
KLA,7,40,51,10,108,3
KKL,7,48,40,10,105,3
KLL,5,15,20,13,53,3
ALK,3,29,23,16,71,3
LKA,4,14,8,11,37,3
ALL,0,1,4,11,16,3
LLK,4,4,4,17,29,3
AKF,1,4,0,3,8,3
FLA,0,1,0,7,8,3
FLK,8,7,1,8,24,3
LKK,7,30,23,16,76,3
KKA,1,17,19,6,43,3
AKI,1,2,3,3,9,3
KII,2,0,1,6,9,3
IIA,0,0,1,4,5,3
IAK,0,2,3,4,9,3
KIA,0,4,2,5,11,3
KKI,5,12,4,4,25,3
KIL,0,0,3,6,9,3
KFA,1,9,2,4,16,3
KFK,1,1,2,2,6,3
FKK,8,13,2,4,27,3
FAF,0,2,0,0,2,3
AFA,0,1,0,1,2,3
KAA,0,0,3,7,10,3
AAL,0,0,1,16,17,3
LAL,1,13,14,15,43,3
KLK,0,11,9,7,27,3
KKW,0,1,0,2,3,3
KWK,11,13,3,0,27,3
WKL,5,9,2,1,17,3
KLI,3,1,0,12,16,3
LIG,1,1,0,1,3,3
IGA,2,5,0,1,8,3
GAV,1,4,0,7,12,3
AVL,1,5,1,7,14,3
VLK,2,4,0,6,12,3
LKV,1,4,0,6,11,3
LLA,2,8,13,15,38,3
LKL,2,3,7,5,17,3
KLF,5,11,3,2,21,3
LFA,3,4,1,4,12,3
FAL,0,9,8,4,21,3
KAK,1,2,2,3,8,3
KKG,1,0,1,1,3,3
KGL,0,2,1,3,6,3
KKS,0,0,1,5,6,3
KSL,3,0,1,8,12,3
KKV,2,13,2,10,27,3
KVL,1,5,1,10,17,3
LLF,0,0,1,3,4,3
LFK,4,18,2,3,27,3
FKA,0,2,1,5,8,3
LAA,1,2,1,15,19,3
AAK,1,4,2,7,14,3
KLW,0,1,1,2,4,3
LWA,0,1,1,3,5,3
WAK,0,3,1,4,8,3
LAF,0,1,1,0,2,3
AFG,0,2,0,0,2,3
GKG,0,1,0,0,1,3
KGI,0,1,0,3,4,3
GIG,7,9,1,1,18,3
GKV,0,1,0,6,7,3
KVG,0,2,1,0,3,3
VGK,0,1,0,6,7,3
GKK,0,1,0,3,4,3
FAV,2,4,1,3,10,3
AVG,0,0,1,3,4,3
VGL,0,0,1,2,3,3
GLR,0,0,1,3,4,3
LRA,0,0,1,7,8,3
RAI,0,0,1,7,8,3
AIK,0,0,1,5,6,3
IKR,0,2,1,2,5,3
KRA,0,0,1,10,11,3
RAL,0,0,1,15,16,3
KLR,0,0,1,2,3,3
LRR,2,0,1,7,10,3
RRG,0,0,1,3,4,3
RGV,0,0,1,1,2,3
GVR,0,0,1,0,1,3
VRK,0,0,1,6,7,3
RKV,0,0,1,1,2,3
KVA,2,11,1,5,19,3
VAK,2,2,2,5,11,3
AKD,0,0,1,3,4,3
KDL,0,0,1,4,5,3
FKL,1,0,2,4,7,3
AFK,3,0,2,5,10,3
AFL,1,1,1,6,9,3
FKR,0,1,0,6,7,3
KRL,0,1,0,8,9,3
RLA,0,2,0,10,12,3
KIK,0,2,1,5,8,3
IKV,0,1,0,1,2,3
VLR,0,1,0,11,12,3
LRL,0,1,0,9,10,3
FKV,0,2,3,1,6,3
KVK,0,0,4,4,8,3
VKF,0,0,2,1,3,3
VKV,0,0,1,2,3,3
FLG,2,6,0,5,13,3
LGA,0,3,0,3,6,3
GAL,0,3,0,4,7,3
ALF,0,3,0,5,8,3
LFH,0,1,0,0,1,3
FHA,0,1,0,0,1,3
HAL,0,1,0,4,5,3
ALS,0,3,0,7,10,3
LSK,0,2,0,5,7,3
SKL,0,2,0,8,10,3
LSH,0,1,0,1,2,3
SHL,0,1,0,2,3,3
HLL,0,1,0,6,7,3
LGM,2,0,0,0,2,3
GMI,2,0,0,1,3,3
MIP,2,0,0,0,2,3
IPG,1,0,0,0,1,3
PGL,1,0,0,1,2,3
GLI,2,0,0,6,8,3
IGG,2,4,0,0,6,3
GGL,2,4,0,4,10,3
LIS,2,1,0,9,12,3
ISA,1,0,1,4,6,3
SAF,1,0,1,0,2,3
IPK,2,1,0,2,5,3
PKL,2,0,0,1,3,3
LIK,2,0,0,5,7,3
IKK,4,16,0,12,32,3
IKA,2,1,0,10,13,3
LGW,0,2,0,4,6,3
GWL,0,2,0,1,3,3
WLF,0,4,0,2,6,3
FKW,0,4,0,1,5,3
KWA,0,4,0,2,6,3
WAW,0,2,0,0,2,3
AWK,0,2,0,1,3,3
LAG,0,1,0,4,5,3
AGL,1,1,0,4,6,3
GLL,0,1,0,9,10,3
LKN,0,1,0,8,9,3
KNF,0,1,0,2,3,3
NFA,0,1,0,4,5,3
FLP,1,0,0,0,1,3
LPT,1,0,0,1,2,3
PTI,1,0,0,0,1,3
TII,1,0,0,1,2,3
IIC,1,0,0,0,1,3
ICK,1,0,0,0,1,3
CKI,1,0,0,0,1,3
KIS,1,0,0,1,2,3
ISY,1,0,0,1,2,3
SYK,1,0,0,2,3,3
YKC,1,0,0,0,1,3
LKW,0,1,0,1,2,3
KWL,0,1,0,0,1,3
FLS,1,0,1,3,5,3
LSL,1,0,1,4,6,3
SLI,1,0,1,4,6,3
LIP,1,0,1,1,3,3
KLV,1,0,0,7,8,3
LVK,1,0,0,7,8,3
VKK,1,5,0,11,17,3
IIK,1,1,0,5,7,3
IPS,0,0,1,0,1,3
PSL,0,0,1,2,3,3
SLV,0,0,1,6,7,3
LVG,0,0,1,6,7,3
VGG,0,0,1,3,4,3
GGS,0,0,1,1,2,3
GSI,0,1,1,3,5,3
SIS,0,0,1,4,5,3
FLW,0,1,0,2,3,3
LWW,0,1,0,0,1,3
WWL,0,1,0,4,5,3
VLT,0,2,0,2,4,3
LTT,0,2,0,1,3,3
TTG,0,2,0,1,3,3
TGL,0,1,0,2,3,3
GLP,0,1,0,0,1,3
LPA,0,1,0,1,2,3
PAL,0,1,0,5,6,3
ALI,0,1,0,11,12,3
ISW,0,1,0,0,1,3
SWI,0,1,0,1,2,3
WIK,0,1,0,2,3,3
KRK,0,1,0,3,4,3
RKR,0,1,0,3,4,3
KRQ,0,1,0,1,2,3
RQQ,0,1,0,4,5,3
LHA,0,1,0,1,2,3
HAA,0,1,0,4,5,3
FVA,0,2,0,3,5,3
VAE,0,2,0,14,16,3
AEI,0,2,0,6,8,3
FVK,1,0,1,3,5,3
VKI,1,0,1,0,2,3
IIN,1,0,0,3,4,3
INN,1,0,0,2,3,3
ILK,0,0,1,13,14,3
GLF,2,18,0,6,26,3
AVI,2,7,0,5,14,3
VIK,3,18,0,3,24,3
VAA,0,3,0,14,17,3
AAV,0,3,0,7,10,3
VIR,0,1,0,1,2,3
IRR,0,1,0,6,7,3
RRL,2,1,0,3,6,3
AKV,1,2,0,4,7,3
KVI,1,4,0,5,10,3
VAS,1,8,0,4,13,3
ASV,1,8,0,4,13,3
SVI,1,8,0,2,11,3
VIG,1,6,0,1,8,3
IKG,0,2,0,0,2,3
LFD,0,12,0,6,18,3
FDI,0,6,0,1,7,3
DIA,0,1,0,7,8,3
IGV,0,1,0,2,3,3
GVI,0,1,0,2,3,3
IGS,0,1,0,1,2,3
GSL,0,2,0,3,5,3
DII,0,1,0,6,7,3
IAE,0,1,0,6,7,3
AES,0,1,0,6,7,3
ESF,0,1,0,4,5,3
DIV,0,4,0,3,7,3
IVK,0,5,1,5,11,3
IAG,0,4,0,3,7,3
AGH,0,3,0,2,5,3
GHI,0,3,0,1,4,3
HIA,0,2,0,0,2,3
AGS,0,1,0,1,2,3
IAS,0,1,0,4,5,3
ASS,0,1,0,2,3,3
SSI,0,2,0,2,4,3
HIV,0,1,0,1,2,3
IVS,0,2,0,1,3,3
VSS,0,1,0,2,3,3
KVV,0,1,1,5,7,3
VVG,0,1,0,3,4,3
VGA,0,1,0,4,5,3
GAF,1,2,0,2,5,3
FGS,0,1,0,1,2,3
FDV,0,6,0,2,8,3
DVI,0,6,0,5,11,3
VIA,0,1,0,4,5,3
KAV,0,1,0,6,7,3
AVA,0,1,0,15,16,3
ILP,0,0,1,0,1,3
LPW,0,0,1,0,1,3
PWK,0,0,1,0,1,3
WKW,0,0,1,0,1,3
KWP,0,0,1,0,1,3
WPW,0,0,2,0,2,3
PWW,4,1,1,0,6,3
WWP,4,1,1,1,7,3
PWR,0,0,1,0,1,3
WRR,0,0,1,1,2,3
KKK,11,3,0,3,17,3
KFP,4,1,0,1,6,3
FPW,4,1,0,0,5,3
WWW,4,1,0,0,5,3
WPF,4,1,0,0,5,3
PFK,4,1,0,0,5,3
KKC,2,0,0,0,2,3
KCK,1,0,0,0,1,3
CKK,1,0,0,0,1,3
VVF,0,0,1,1,2,3
VFK,0,1,2,2,5,3
KTK,0,2,0,0,2,3
TKL,0,2,0,7,9,3
WKK,1,0,0,2,3,3
LKI,1,0,0,4,5,3
KIG,6,5,0,0,11,3
IGI,6,4,0,1,11,3
LHL,4,0,0,3,7,3
HLA,4,0,0,5,9,3
SAT,0,1,0,1,2,3
ATT,0,1,0,0,1,3
TTF,0,1,0,2,3,3
IKF,0,0,1,2,3,3
KIP,0,1,0,1,2,3
PKF,0,1,0,1,2,3
KKT,5,4,0,2,11,3
WKS,5,3,0,1,9,3
KSF,5,3,0,3,11,3
SFA,0,1,0,4,5,3
AKT,0,1,0,0,1,3
KTF,5,3,0,2,10,3
TFK,5,3,0,2,10,3
FKS,5,3,0,4,12,3
KSA,2,3,0,1,6,3
KTV,5,3,0,3,11,3
TVL,5,1,0,5,11,3
VLH,5,1,0,2,8,3
LHT,5,1,0,2,8,3
HTA,2,3,0,0,5,3
TAL,2,2,0,8,12,3
KAI,4,3,0,5,12,3
AIS,4,3,0,3,10,3
ISS,5,3,0,4,12,3
SFL,5,2,0,4,11,3
LKT,5,2,0,5,12,3
TVA,0,2,0,7,9,3
VAH,0,2,0,0,2,3
AHT,0,2,0,0,2,3
TAA,0,1,0,7,8,3
HTL,3,0,0,0,3,3
TLL,3,0,0,6,9,3
SLK,3,0,0,6,9,3
KYK,0,0,1,1,2,3
YKK,0,0,1,2,3,3
LGG,0,1,0,2,3,3
GGI,0,1,0,2,3,3
GIV,0,2,1,1,4,3
VSA,0,1,0,2,3,3
SAV,0,1,0,6,7,3
AVK,0,1,0,2,3,3
KIV,0,1,0,3,4,3
IVD,0,1,0,4,5,3
VDF,0,1,0,3,4,3
DFL,0,1,0,8,9,3
LPK,0,1,0,1,2,3
PKW,0,1,1,1,3,3
WKV,0,1,1,0,2,3
KVF,0,1,1,3,5,3
KIE,0,1,1,0,2,3
IEK,0,1,1,9,11,3
EKV,0,1,1,5,7,3
VGR,1,1,1,2,5,3
GRN,0,1,1,0,2,3
RNI,0,1,1,0,2,3
NIR,0,1,1,3,5,3
IRN,0,1,1,2,4,3
RNG,0,1,1,0,2,3
NGI,0,1,1,0,2,3
VKA,0,1,1,7,9,3
KAG,0,1,1,3,5,3
AGP,0,1,1,0,2,3
GPA,0,1,1,1,3,3
PAI,0,1,1,0,2,3
AIA,0,1,1,15,17,3
IAV,0,1,1,5,7,3
VLG,0,1,1,6,8,3
LGE,0,1,1,7,9,3
GEA,0,1,1,6,8,3
EAK,0,1,1,7,9,3
ALG,0,1,1,13,15,3
MPK,0,0,1,0,1,3
RAG,1,0,0,0,1,3
GLQ,1,0,0,2,3,3
LQF,1,0,0,1,2,3
QFP,1,0,0,0,1,3
FPV,1,0,0,0,1,3
PVG,1,0,0,0,1,3
GRL,1,0,0,4,5,3
RLL,3,0,0,15,18,3
LLR,3,0,0,6,9,3
VAL,0,0,1,11,12,3
WAL,0,0,1,2,3,3
AAD,0,0,0,3,3,3
ADI,0,0,0,3,3,3
DIF,0,0,0,5,5,3
IFS,0,0,0,3,3,3
FSK,0,0,0,3,3,3
SKF,0,0,0,1,1,3
KKD,0,0,0,4,4,3
KDM,0,0,0,2,2,3
DME,0,0,0,3,3,3
MEV,0,0,0,3,3,3
EVK,0,0,0,9,9,3
AAQ,0,0,0,7,7,3
AQK,0,0,0,5,5,3
QKD,0,0,0,1,1,3
KDN,0,0,0,2,2,3
DNV,0,0,0,3,3,3
NVK,0,0,0,3,3,3
VKS,0,0,0,4,4,3
KSS,0,0,0,5,5,3
SSW,0,0,0,3,3,3
SWA,0,0,0,1,1,3
KAS,0,0,0,7,7,3
ASA,0,0,0,5,5,3
AAS,0,0,0,3,3,3
ASQ,0,0,0,1,1,3
SQR,0,0,0,2,2,3
QRK,0,0,0,3,3,3
RKL,0,0,0,10,10,3
LIA,0,0,0,7,7,3
AEK,0,0,0,11,11,3
EKF,0,0,0,7,7,3
FAQ,0,0,0,3,3,3
AQA,0,0,0,6,6,3
QAL,0,0,0,10,10,3
ALM,0,0,0,6,6,3
LMS,0,0,0,3,3,3
MSS,0,0,0,1,1,3
SSL,0,0,0,6,6,3
AAY,0,0,0,8,8,3
AYA,0,0,0,5,5,3
YAT,0,0,0,2,2,3
ATL,0,0,0,7,7,3
TLY,0,0,0,5,5,3
LYE,0,0,0,3,3,3
YEA,0,0,0,3,3,3
EAL,0,0,0,21,21,3
ALV,0,0,0,11,11,3
LVL,0,0,0,5,5,3
VLV,0,0,0,2,2,3
LVA,0,0,0,14,14,3
VAT,0,0,0,8,8,3
TLA,0,0,0,7,7,3
AAP,0,0,0,2,2,3
AEA,0,0,0,14,14,3
EAH,0,0,0,1,1,3
AHE,0,0,0,4,4,3
HES,0,0,0,1,1,3
ESI,0,0,0,5,5,3
SIR,0,0,0,3,3,3
IRL,0,0,0,5,5,3
RLV,0,0,0,4,4,3
LVF,0,0,0,1,1,3
VFH,0,0,0,3,3,3
FHD,0,0,0,2,2,3
HDS,0,0,0,1,1,3
AEG,0,0,0,5,5,3
EGE,0,0,0,2,2,3
GER,0,0,0,6,6,3
ERE,0,0,0,8,8,3
REA,0,0,0,9,9,3
EAR,0,0,0,7,7,3
ARV,0,0,0,8,8,3
RVF,0,0,0,3,3,3
VFT,0,0,0,4,4,3
FTL,0,0,0,2,2,3
TLW,0,0,0,1,1,3
LWL,0,0,0,4,4,3
WLN,0,0,0,3,3,3
LNS,0,0,0,3,3,3
NSL,0,0,0,5,5,3
EGV,0,0,0,2,2,3
GVA,0,0,0,3,3,3
ATA,0,0,0,5,5,3
TAD,0,0,0,2,2,3
ADP,0,0,0,2,2,3
DPL,0,0,0,4,4,3
PLM,0,0,0,1,1,3
LMR,0,0,0,4,4,3
MRL,0,0,0,2,2,3
AKQ,0,0,0,6,6,3
KQL,0,0,0,4,4,3
QLK,0,0,0,5,5,3
AEH,0,0,0,3,3,3
EHA,0,0,0,2,2,3
HAK,0,0,0,1,1,3
VLM,0,0,0,5,5,3
LMD,0,0,0,2,2,3
MDS,0,0,0,2,2,3
DSL,0,0,0,2,2,3
SLT,0,0,0,1,1,3
LTG,0,0,0,8,8,3
TGV,0,0,0,2,2,3
GVW,0,0,0,2,2,3
VWD,0,0,0,1,1,3
WDN,0,0,0,1,1,3
DNF,0,0,0,3,3,3
NFL,0,0,0,5,5,3
FLT,0,0,0,6,6,3
EHL,0,0,0,6,6,3
KAE,0,0,0,3,3,3
AEL,0,0,0,11,11,3
ELT,0,0,0,5,5,3
TTV,0,0,0,3,3,3
TVF,0,0,0,3,3,3
VFS,0,0,0,2,2,3
FST,0,0,0,2,2,3
STL,0,0,0,7,7,3
LYQ,0,0,0,2,2,3
YQK,0,0,0,1,1,3
QKF,0,0,0,2,2,3
EKA,0,0,0,5,5,3
AKY,0,0,0,3,3,3
KYD,0,0,0,2,2,3
YDE,0,0,0,4,4,3
DEI,0,0,0,5,5,3
EIF,0,0,0,7,7,3
IFL,0,0,0,2,2,3
AFF,0,0,0,2,2,3
FFT,0,0,0,2,2,3
FTI,0,0,0,1,1,3
TIA,0,0,0,3,3,3
IAA,0,0,0,8,8,3
VAR,0,0,0,7,7,3
RVL,0,0,0,7,7,3
VLD,0,0,0,7,7,3
AFR,0,0,0,3,3,3
FRH,0,0,0,1,1,3
RHS,0,0,0,2,2,3
HSV,0,0,0,2,2,3
SVK,0,0,0,1,1,3
VKE,0,0,0,8,8,3
KEE,0,0,0,10,10,3
EEL,0,0,0,20,20,3
ELN,0,0,0,4,4,3
LNY,0,0,0,3,3,3
NYI,0,0,0,2,2,3
YIR,0,0,0,3,3,3
RRR,0,0,0,9,9,3
RLE,0,0,0,6,6,3
LER,0,0,0,14,14,3
ERF,0,0,0,5,5,3
RFP,0,0,0,2,2,3
FPN,0,0,0,3,3,3
PNR,0,0,0,1,1,3
NRL,0,0,0,4,4,3
AGD,0,0,0,1,1,3
GDV,0,0,0,1,1,3
DVL,0,0,0,4,4,3
LHN,0,0,0,3,3,3
HNV,0,0,0,2,2,3
NVL,0,0,0,4,4,3
VLQ,0,0,0,7,7,3
LQM,0,0,0,4,4,3
QML,0,0,0,5,5,3
MLI,0,0,0,1,1,3
LII,0,0,0,3,3,3
IIE,0,0,0,7,7,3
IES,0,0,0,4,4,3
ESH,0,0,0,1,1,3
SHS,0,0,0,1,1,3
AGE,0,0,0,3,3,3
GEM,0,0,0,2,2,3
EMV,0,0,0,5,5,3
MVR,0,0,0,4,4,3
VRQ,0,0,0,2,2,3
RQA,0,0,0,4,4,3
QAR,0,0,0,5,5,3
ARI,0,0,0,7,7,3
RIL,0,0,0,11,11,3
ILA,0,0,0,4,4,3
LAQ,0,0,0,13,13,3
QAT,0,0,0,1,1,3
ATS,0,0,0,4,4,3
TSD,0,0,0,1,1,3
SDL,0,0,0,1,1,3
DLV,0,0,0,4,4,3
LVN,0,0,0,5,5,3
VNA,0,0,0,5,5,3
NAI,0,0,0,6,6,3
KAD,0,0,0,3,3,3
ADA,0,0,0,7,7,3
AGN,0,0,0,3,3,3
GNL,0,0,0,3,3,3
NLD,0,0,0,3,3,3
LDI,0,0,0,6,6,3
DIM,0,0,0,2,2,3
IMT,0,0,0,1,1,3
MTS,0,0,0,1,1,3
TSA,0,0,0,6,6,3
SAA,0,0,0,7,7,3
LAT,0,0,0,4,4,3
TAE,0,0,0,6,6,3
AER,0,0,0,9,9,3
ERM,0,0,0,2,2,3
RMA,0,0,0,1,1,3
MAQ,0,0,0,2,2,3
AQS,0,0,0,1,1,3
QSM,0,0,0,1,1,3
SML,0,0,0,3,3,3
MLN,0,0,0,2,2,3
AHA,0,0,0,8,8,3
HAI,0,0,0,1,1,3
GVL,0,0,0,7,7,3
VLL,0,0,0,7,7,3
LLD,0,0,0,15,15,3
LDN,0,0,0,1,1,3
DNL,0,0,0,6,6,3
AIE,0,0,0,11,11,3
EKE,0,0,0,7,7,3
KEI,0,0,0,3,3,3
EIL,0,0,0,16,16,3
ILI,0,0,0,5,5,3
LIE,0,0,0,10,10,3
IEA,0,0,0,10,10,3
EAI,0,0,0,11,11,3
KQE,0,0,0,3,3,3
QEK,0,0,0,3,3,3
EKI,0,0,0,7,7,3
III,0,0,0,1,1,3
IIQ,0,0,0,4,4,3
IQV,0,0,0,3,3,3
QVA,0,0,0,11,11,3
ALN,0,0,0,5,5,3
LND,0,0,0,2,2,3
NDI,0,0,0,2,2,3
DIT,0,0,0,1,1,3
ITH,0,0,0,2,2,3
THV,0,0,0,1,1,3
HVV,0,0,0,2,2,3
VVE,0,0,0,3,3,3
VEL,0,0,0,4,4,3
ELL,0,0,0,22,22,3
VVR,0,0,0,5,5,3
VRT,0,0,0,5,5,3
RTA,0,0,0,5,5,3
ALE,0,0,0,10,10,3
LED,0,0,0,5,5,3
EDA,0,0,0,7,7,3
DAA,0,0,0,7,7,3
SVA,0,0,0,5,5,3
VAG,0,0,0,3,3,3
LLI,0,0,0,12,12,3
LIT,0,0,0,6,6,3
LAV,0,0,0,6,6,3
AKP,0,0,0,1,1,3
KPF,0,0,0,1,1,3
PFL,0,0,0,1,1,3
LGK,0,0,0,5,5,3
KWG,0,0,0,2,2,3
WGT,0,0,0,1,1,3
GTT,0,0,0,3,3,3
ALY,0,0,0,3,3,3
LYG,0,0,0,3,3,3
YGL,0,0,0,1,1,3
LKE,0,0,0,10,10,3
EEM,0,0,0,8,8,3
EMG,0,0,0,3,3,3
MGE,0,0,0,3,3,3
AMF,0,0,0,1,1,3
MFE,0,0,0,5,5,3
FEQ,0,0,0,4,4,3
EQM,0,0,0,3,3,3
QMR,0,0,0,2,2,3
MRA,0,0,0,6,6,3
RAN,0,0,0,1,1,3
ANV,0,0,0,1,1,3
NVG,0,0,0,2,2,3
GKL,0,0,0,7,7,3
LKG,0,0,0,6,6,3
APD,0,0,0,2,2,3
PDA,0,0,0,1,1,3
DAE,0,0,0,6,6,3
EGR,0,0,0,2,2,3
GRA,0,0,0,3,3,3
AIQ,0,0,0,3,3,3
IQA,0,0,0,6,6,3
QAV,0,0,0,5,5,3
AVY,0,0,0,3,3,3
VYW,0,0,0,1,1,3
YWA,0,0,0,2,2,3
WAN,0,0,0,2,2,3
ANK,0,0,0,3,3,3
NKW,0,0,0,1,1,3
AKE,0,0,0,5,5,3
KEQ,0,0,0,2,2,3
EQG,0,0,0,2,2,3
PDL,0,0,0,1,1,3
DLL,0,0,0,7,7,3
ISL,0,0,0,4,4,3
SLA,0,0,0,5,5,3
ATV,0,0,0,4,4,3
VLY,0,0,0,1,1,3
LYH,0,0,0,2,2,3
YHL,0,0,0,2,2,3
HLQ,0,0,0,1,1,3
LQQ,0,0,0,9,9,3
APE,0,0,0,2,2,3
PED,0,0,0,4,4,3
EDV,0,0,0,6,6,3
DVR,0,0,0,2,2,3
RKS,0,0,0,2,2,3
SSK,0,0,0,2,2,3
SKE,0,0,0,5,5,3
KEV,0,0,0,5,5,3
EVL,0,0,0,13,13,3
APL,0,0,0,3,3,3
PLL,0,0,0,5,5,3
LLN,0,0,0,6,6,3
LNF,0,0,0,1,1,3
NFV,0,0,0,2,2,3
FVR,0,0,0,2,2,3
VRD,0,0,0,3,3,3
RDF,0,0,0,3,3,3
DFV,0,0,0,2,2,3
VRE,0,0,0,8,8,3
RED,0,0,0,2,2,3
DAK,0,0,0,5,5,3
KYL,0,0,0,7,7,3
YLY,0,0,0,1,1,3
LYS,0,0,0,5,5,3
YSS,0,0,0,1,1,3
AQT,0,0,0,7,7,3
QTS,0,0,0,2,2,3
TSR,0,0,0,4,4,3
SRW,0,0,0,2,2,3
RWA,0,0,0,1,1,3
WAA,0,0,0,1,1,3
AAM,0,0,0,7,7,3
AMQ,0,0,0,3,3,3
MQI,0,0,0,1,1,3
QIG,0,0,0,2,2,3
IGM,0,0,0,2,2,3
GMS,0,0,0,1,1,3
MSF,0,0,0,2,2,3
SFI,0,0,0,1,1,3
FIS,0,0,0,3,3,3
SAY,0,0,0,1,1,3
ARD,0,0,0,2,2,3
RDE,0,0,0,3,3,3
DEA,0,0,0,7,7,3
EAE,0,0,0,7,7,3
AEM,0,0,0,4,4,3
EME,0,0,0,3,3,3
MEY,0,0,0,1,1,3
EYL,0,0,0,2,2,3
YLK,0,0,0,7,7,3
IAQ,0,0,0,4,4,3
ASL,0,0,0,9,9,3
SLP,0,0,0,2,2,3
LPE,0,0,0,4,4,3
PEA,0,0,0,4,4,3
ALT,0,0,0,10,10,3
LTK,0,0,0,13,13,3
TKG,0,0,0,4,4,3
TLK,0,0,0,4,4,3
KNL,0,0,0,2,2,3
NLG,0,0,0,3,3,3
LGS,0,0,0,4,4,3
GSV,0,0,0,1,1,3
SVH,0,0,0,1,1,3
VHV,0,0,0,3,3,3
HVS,0,0,0,1,1,3
VSK,0,0,0,4,4,3
SKG,0,0,0,3,3,3
AVD,0,0,0,6,6,3
VDT,0,0,0,2,2,3
DTL,0,0,0,4,4,3
TLV,0,0,0,4,4,3
VLA,0,0,0,13,13,3
LAE,0,0,0,21,21,3
EAT,0,0,0,7,7,3
AAA,0,0,0,16,16,3
LFR,0,0,0,5,5,3
FRL,0,0,0,3,3,3
RLH,0,0,0,6,6,3
LHK,0,0,0,3,3,3
HKF,0,0,0,1,1,3
TKW,0,0,0,1,1,3
AAG,0,0,0,12,12,3
GLA,0,0,0,5,5,3
LAS,0,0,0,8,8,3
ASR,0,0,0,8,8,3
SRH,0,0,0,1,1,3
RHK,0,0,0,2,2,3
HKG,0,0,0,1,1,3
AEN,0,0,0,5,5,3
ENR,0,0,0,2,2,3
NRD,0,0,0,2,2,3
RDL,0,0,0,6,6,3
DLF,0,0,0,7,7,3
LFL,0,0,0,8,8,3
LLS,0,0,0,8,8,3
LSV,0,0,0,3,3,3
DAH,0,0,0,1,1,3
HAW,0,0,0,1,1,3
AWM,0,0,0,2,2,3
WMI,0,0,0,1,1,3
MIG,0,0,0,1,1,3
IGQ,0,0,0,2,2,3
GQL,0,0,0,3,3,3
DAL,0,0,0,19,19,3
LEI,0,0,0,5,5,3
IFK,0,0,0,8,8,3
FKT,0,0,0,3,3,3
KTL,0,0,0,3,3,3
TLF,0,0,0,2,2,3
LFS,0,0,0,2,2,3
FSL,0,0,0,3,3,3
LVM,0,0,0,1,1,3
VMR,0,0,0,2,2,3
MRF,0,0,0,3,3,3
RFS,0,0,0,3,3,3
FSS,0,0,0,1,1,3
SSY,0,0,0,3,3,3
SYL,0,0,0,5,5,3
DAM,0,0,0,3,3,3
AML,0,0,0,3,3,3
MLR,0,0,0,1,1,3
LRT,0,0,0,4,4,3
RTS,0,0,0,3,3,3
TSM,0,0,0,2,2,3
SMV,0,0,0,2,2,3
MVA,0,0,0,6,6,3
ATQ,0,0,0,2,2,3
TQL,0,0,0,2,2,3
QLV,0,0,0,7,7,3
LAM,0,0,0,2,2,3
AMM,0,0,0,2,2,3
MMR,0,0,0,1,1,3
MRY,0,0,0,1,1,3
RYV,0,0,0,3,3,3
DAR,0,0,0,3,3,3
ARA,0,0,0,8,8,3
RAK,0,0,0,2,2,3
LDK,0,0,0,7,7,3
DKW,0,0,0,1,1,3
AKW,0,0,0,3,3,3
KWI,0,0,0,3,3,3
WIN,0,0,0,1,1,3
ING,0,0,0,1,1,3
DAT,0,0,0,2,2,3
LTM,0,0,0,1,1,3
TMA,0,0,0,2,2,3
TLI,0,0,0,4,4,3
ISE,0,0,0,3,3,3
SEL,0,0,0,3,3,3
ELQ,0,0,0,4,4,3
QQM,0,0,0,1,1,3
DDA,0,0,0,2,2,3
DAD,0,0,0,1,1,3
ADL,0,0,0,8,8,3
DLE,0,0,0,7,7,3
LEK,0,0,0,13,13,3
KFV,0,0,0,1,1,3
FVI,0,0,0,2,2,3
VIE,0,0,0,7,7,3
IEY,0,0,0,2,2,3
DDE,0,0,0,2,2,3
DET,0,0,0,4,4,3
ETL,0,0,0,9,9,3
TLG,0,0,0,4,4,3
LGV,0,0,0,5,5,3
LMW,0,0,0,1,1,3
MWI,0,0,0,1,1,3
WIL,0,0,0,2,2,3
ILD,0,0,0,6,6,3
LDR,0,0,0,5,5,3
DRS,0,0,0,1,1,3
RSI,0,0,0,2,2,3
SIH,0,0,0,2,2,3
ETR,0,0,0,2,2,3
TRE,0,0,0,5,5,3
REE,0,0,0,6,6,3
ELE,0,0,0,5,5,3
LEE,0,0,0,18,18,3
LIQ,0,0,0,10,10,3
DDR,0,0,0,1,1,3
DRV,0,0,0,4,4,3
RVQ,0,0,0,3,3,3
VQS,0,0,0,3,3,3
QSH,0,0,0,1,1,3
SHI,0,0,0,1,1,3
HIL,0,0,0,4,4,3
ILH,0,0,0,2,2,3
HLE,0,0,0,3,3,3
LEH,0,0,0,2,2,3
EHD,0,0,0,1,1,3
HDL,0,0,0,3,3,3
LVH,0,0,0,5,5,3
HVT,0,0,0,1,1,3
VTR,0,0,0,1,1,3
TRK,0,0,0,2,2,3
RKN,0,0,0,2,2,3
DDY,0,0,0,1,1,3
DYL,0,0,0,3,3,3
EQV,0,0,0,8,8,3
QVL,0,0,0,8,8,3
LHM,0,0,0,1,1,3
HMK,0,0,0,2,2,3
MKQ,0,0,0,2,2,3
KQY,0,0,0,1,1,3
QYV,0,0,0,2,2,3
YVS,0,0,0,4,4,3
VSD,0,0,0,5,5,3
SDN,0,0,0,3,3,3
EAA,0,0,0,13,13,3
AAF,0,0,0,5,5,3
AFQ,0,0,0,2,2,3
FQK,0,0,0,1,1,3
QKL,0,0,0,2,2,3
KLM,0,0,0,2,2,3
MSN,0,0,0,1,1,3
SNL,0,0,0,2,2,3
EAG,0,0,0,1,1,3
GLM,0,0,0,2,2,3
MRE,0,0,0,3,3,3
REL,0,0,0,15,15,3
ELR,0,0,0,5,5,3
RLF,0,0,0,5,5,3
FRR,0,0,0,2,2,3
RRI,0,0,0,7,7,3
RIM,0,0,0,2,2,3
IMV,0,0,0,1,1,3
VRI,0,0,0,8,8,3
RIA,0,0,0,5,5,3
IAW,0,0,0,3,3,3
AWA,0,0,0,6,6,3
WAQ,0,0,0,1,1,3
QTL,0,0,0,8,8,3
DEE,0,0,0,3,3,3
EET,0,0,0,3,3,3
ETM,0,0,0,3,3,3
TME,0,0,0,2,2,3
MER,0,0,0,3,3,3
ERI,0,0,0,7,7,3
IMR,0,0,0,1,1,3
ELK,0,0,0,7,7,3
DEF,0,0,0,4,4,3
EFT,0,0,0,1,1,3
FTK,0,0,0,3,3,3
TKQ,0,0,0,2,2,3
KQH,0,0,0,5,5,3
QHI,0,0,0,3,3,3
IVG,0,0,0,6,6,3
DEK,0,0,0,5,5,3
FKN,0,0,0,4,4,3
KNT,0,0,0,2,2,3
NTY,0,0,0,2,2,3
TYR,0,0,0,1,1,3
YRQ,0,0,0,3,3,3
QAM,0,0,0,2,2,3
AMN,0,0,0,1,1,3
MND,0,0,0,2,2,3
EKK,0,0,0,3,3,3
LKD,0,0,0,6,6,3
KDF,0,0,0,2,2,3
FLI,0,0,0,8,8,3
EKS,0,0,0,5,5,3
KSI,0,0,0,6,6,3
SII,0,0,0,2,2,3
IIT,0,0,0,2,2,3
ITY,0,0,0,1,1,3
TYV,0,0,0,3,3,3
SLY,0,0,0,3,3,3
LYD,0,0,0,3,3,3
YDA,0,0,0,3,3,3
DEL,0,0,0,13,13,3
SKM,0,0,0,1,1,3
KMR,0,0,0,4,4,3
RFA,0,0,0,3,3,3
DEP,0,0,0,1,1,3
EPQ,0,0,0,1,1,3
PQV,0,0,0,3,3,3
QVQ,0,0,0,2,2,3
VQA,0,0,0,9,9,3
QAK,0,0,0,4,4,3
KIM,0,0,0,1,1,3
IMA,0,0,0,3,3,3
MAY,0,0,0,2,2,3
AYL,0,0,0,9,9,3
YLQ,0,0,0,4,4,3
QQE,0,0,0,2,2,3
QEQ,0,0,0,2,2,3
EQS,0,0,0,1,1,3
QSN,0,0,0,1,1,3
SNR,0,0,0,2,2,3
DEQ,0,0,0,2,2,3
EQY,0,0,0,3,3,3
QYR,0,0,0,1,1,3
YRE,0,0,0,5,5,3
REG,0,0,0,2,2,3
EGA,0,0,0,2,2,3
AVR,0,0,0,3,3,3
RTV,0,0,0,3,3,3
ASF,0,0,0,3,3,3
SFR,0,0,0,1,1,3
FRE,0,0,0,5,5,3
RER,0,0,0,8,8,3
ERL,0,0,0,17,17,3
RLD,0,0,0,4,4,3
DER,0,0,0,2,2,3
LLQ,0,0,0,14,14,3
LQK,0,0,0,3,3,3
QKY,0,0,0,1,1,3
KYR,0,0,0,3,3,3
YRA,0,0,0,3,3,3
RAQ,0,0,0,4,4,3
AQV,0,0,0,4,4,3
QVF,0,0,0,1,1,3
VFE,0,0,0,4,4,3
FEW,0,0,0,1,1,3
EWG,0,0,0,2,2,3
DEV,0,0,0,3,3,3
AEQ,0,0,0,4,4,3
EQL,0,0,0,8,8,3
QLG,0,0,0,2,2,3
LGT,0,0,0,3,3,3
DFA,0,0,0,5,5,3
FAA,0,0,0,4,4,3
QTA,0,0,0,2,2,3
TAH,0,0,0,2,2,3
AHR,0,0,0,3,3,3
HRL,0,0,0,4,4,3
RLK,0,0,0,5,5,3
KGV,0,0,0,2,2,3
GVF,0,0,0,3,3,3
VFA,0,0,0,2,2,3
FAM,0,0,0,2,2,3
FLE,0,0,0,5,5,3
EEQ,0,0,0,2,2,3
QYK,0,0,0,2,2,3
YKG,0,0,0,2,2,3
KGQ,0,0,0,2,2,3
GQR,0,0,0,3,3,3
QRD,0,0,0,5,5,3
DLA,0,0,0,6,6,3
AGK,0,0,0,3,3,3
AST,0,0,0,4,4,3
DFP,0,0,0,1,1,3
FPA,0,0,0,1,1,3
IKQ,0,0,0,5,5,3
KQA,0,0,0,6,6,3
QAS,0,0,0,4,4,3
SLD,0,0,0,2,2,3
LDA,0,0,0,8,8,3
DFS,0,0,0,1,1,3
FSE,0,0,0,3,3,3
SET,0,0,0,3,3,3
ETI,0,0,0,5,5,3
TIN,0,0,0,2,2,3
INA,0,0,0,3,3,3
NAY,0,0,0,1,1,3
AYF,0,0,0,4,4,3
YFV,0,0,0,2,2,3
DGA,0,0,0,2,2,3
LKR,0,0,0,8,8,3
RAE,0,0,0,5,5,3
AEE,0,0,0,10,10,3
KTQ,0,0,0,1,1,3
TQA,0,0,0,5,5,3
QAN,0,0,0,3,3,3
AND,0,0,0,4,4,3
NDY,0,0,0,2,2,3
DYF,0,0,0,2,2,3
YFK,0,0,0,2,2,3
DGF,0,0,0,2,2,3
GFS,0,0,0,2,2,3
FSV,0,0,0,2,2,3
SVL,0,0,0,8,8,3
RAM,0,0,0,1,1,3
MQQ,0,0,0,1,1,3
DGG,0,0,0,1,1,3
GGG,0,0,0,2,2,3
GGF,0,0,0,3,3,3
GFV,0,0,0,2,2,3
VIS,0,0,0,4,4,3
ISK,0,0,0,3,3,3
SKH,0,0,0,1,1,3
KHP,0,0,0,1,1,3
HPV,0,0,0,1,1,3
PVR,0,0,0,4,4,3
VRL,0,0,0,2,2,3
KLN,0,0,0,6,6,3
LNR,0,0,0,5,5,3
DHA,0,0,0,1,1,3
HAV,0,0,0,4,4,3
VLE,0,0,0,8,8,3
LEV,0,0,0,4,4,3
ATP,0,0,0,1,1,3
TPV,0,0,0,3,3,3
LAR,0,0,0,12,12,3
ARF,0,0,0,3,3,3
RFG,0,0,0,1,1,3
IFD,0,0,0,2,2,3
FDF,0,0,0,2,2,3
DFM,0,0,0,1,1,3
FME,0,0,0,2,2,3
ERW,0,0,0,1,1,3
RWI,0,0,0,3,3,3
WIE,0,0,0,2,2,3
KLE,0,0,0,7,7,3
LEY,0,0,0,3,3,3
EYS,0,0,0,1,1,3
YSA,0,0,0,3,3,3
SAS,0,0,0,5,5,3
ASH,0,0,0,1,1,3
DIH,0,0,0,2,2,3
IHA,0,0,0,2,2,3
AAI,0,0,0,9,9,3
IEM,0,0,0,2,2,3
EML,0,0,0,7,7,3
MLL,0,0,0,3,3,3
LLG,0,0,0,6,6,3
IIG,0,0,0,4,4,3
IGT,0,0,0,2,2,3
GTE,0,0,0,1,1,3
TEI,0,0,0,3,3,3
EIT,0,0,0,1,1,3
ITS,0,0,0,5,5,3
SAL,0,0,0,8,8,3
KNV,0,0,0,6,6,3
NVY,0,0,0,2,2,3
VYS,0,0,0,3,3,3
YSI,0,0,0,1,1,3
SIA,0,0,0,4,4,3
IAI,0,0,0,4,4,3
AWI,0,0,0,2,2,3
WIR,0,0,0,3,3,3
IRG,0,0,0,2,2,3
RGY,0,0,0,1,1,3
GYE,0,0,0,2,2,3
YES,0,0,0,2,2,3
ESR,0,0,0,1,1,3
SRK,0,0,0,6,6,3
DIL,0,0,0,5,5,3
ILR,0,0,0,8,8,3
LRE,0,0,0,7,7,3
REI,0,0,0,4,4,3
EIG,0,0,0,2,2,3
MIA,0,0,0,3,3,3
IAR,0,0,0,10,10,3
ALD,0,0,0,5,5,3
LDS,0,0,0,10,10,3
DSI,0,0,0,5,5,3
ISN,0,0,0,5,5,3
SNI,0,0,0,1,1,3
NIE,0,0,0,2,2,3
IEF,0,0,0,3,3,3
DIR,0,0,0,3,3,3
IRA,0,0,0,2,2,3
RAV,0,0,0,10,10,3
LRD,0,0,0,3,3,3
DLS,0,0,0,5,5,3
LSF,0,0,0,3,3,3
SFH,0,0,0,1,1,3
FHL,0,0,0,2,2,3
HLN,0,0,0,2,2,3
LNG,0,0,0,1,1,3
NGH,0,0,0,1,1,3
HSI,0,0,0,1,1,3
SIF,0,0,0,3,3,3
IFW,0,0,0,2,2,3
FWP,0,0,0,2,2,3
WPN,0,0,0,1,1,3
PNM,0,0,0,1,1,3
IRT,0,0,0,1,1,3
TSL,0,0,0,5,5,3
LAN,0,0,0,7,7,3
NDM,0,0,0,2,2,3
DMA,0,0,0,3,3,3
MAI,0,0,0,3,3,3
AIY,0,0,0,3,3,3
IYG,0,0,0,1,1,3
YGD,0,0,0,1,1,3
GDI,0,0,0,2,2,3
ATR,0,0,0,4,4,3
REH,0,0,0,2,2,3
EHT,0,0,0,1,1,3
HTE,0,0,0,1,1,3
TEL,0,0,0,7,7,3
ELA,0,0,0,13,13,3
ENL,0,0,0,6,6,3
DIY,0,0,0,2,2,3
IYQ,0,0,0,3,3,3
YQQ,0,0,0,4,4,3
QQV,0,0,0,1,1,3
QVR,0,0,0,2,2,3
RAS,0,0,0,4,4,3
DKE,0,0,0,4,4,3
KET,0,0,0,3,3,3
TMN,0,0,0,1,1,3
MNI,0,0,0,1,1,3
NIH,0,0,0,3,3,3
IHH,0,0,0,1,1,3
HHT,0,0,0,2,2,3
HTK,0,0,0,1,1,3
AAN,0,0,0,7,7,3
ANN,0,0,0,2,2,3
NNG,0,0,0,1,1,3
NGG,0,0,0,1,1,3
GGW,0,0,0,1,1,3
GWQ,0,0,0,3,3,3
WQW,0,0,0,1,1,3
QWS,0,0,0,2,2,3
RIE,0,0,0,7,7,3
IEQ,0,0,0,6,6,3
EQF,0,0,0,2,2,3
QFL,0,0,0,3,3,3
FLD,0,0,0,6,6,3
ALW,0,0,0,2,2,3
WLE,0,0,0,3,3,3
LEA,0,0,0,14,14,3
KKM,0,0,0,3,3,3
KMY,0,0,0,1,1,3
MYF,0,0,0,1,1,3
YFD,0,0,0,4,4,3
FDA,0,0,0,5,5,3
DAV,0,0,0,5,5,3
AVQ,0,0,0,6,6,3
QAI,0,0,0,6,6,3
IET,0,0,0,3,3,3
ETH,0,0,0,1,1,3
THL,0,0,0,2,2,3
LES,0,0,0,5,5,3
ESD,0,0,0,2,2,3
SDA,0,0,0,4,4,3
WQY,0,0,0,2,2,3
QYI,0,0,0,3,3,3
YIT,0,0,0,1,1,3
ITG,0,0,0,2,2,3
DLG,0,0,0,2,2,3
LGR,0,0,0,4,4,3
GRK,0,0,0,2,2,3
RKI,0,0,0,6,6,3
KIT,0,0,0,1,1,3
ALR,0,0,0,12,12,3
LRS,0,0,0,9,9,3
RSL,0,0,0,6,6,3
SLS,0,0,0,1,1,3
LSN,0,0,0,4,4,3
DLK,0,0,0,4,4,3
LKQ,0,0,0,10,10,3
QAE,0,0,0,6,6,3
ESW,0,0,0,1,1,3
SWL,0,0,0,1,1,3
WLH,0,0,0,2,2,3
HKQ,0,0,0,1,1,3
QAQ,0,0,0,5,5,3
QKE,0,0,0,2,2,3
KEG,0,0,0,3,3,3
EGW,0,0,0,2,2,3
GWS,0,0,0,1,1,3
WSK,0,0,0,4,4,3
SKA,0,0,0,3,3,3
AAR,0,0,0,8,8,3
ARL,0,0,0,8,8,3
ESM,0,0,0,3,3,3
MLQ,0,0,0,3,3,3
QQA,0,0,0,6,6,3
KTM,0,0,0,1,1,3
TMT,0,0,0,2,2,3
MTE,0,0,0,3,3,3
TER,0,0,0,3,3,3
RLR,0,0,0,5,5,3
DLQ,0,0,0,5,5,3
LQL,0,0,0,6,6,3
QLN,0,0,0,2,2,3
LNA,0,0,0,4,4,3
NAN,0,0,0,2,2,3
ANA,0,0,0,4,4,3
NAE,0,0,0,3,3,3
RIN,0,0,0,5,5,3
INV,0,0,0,2,2,3
VYY,0,0,0,1,1,3
DLR,0,0,0,5,5,3
ELI,0,0,0,8,8,3
RVR,0,0,0,4,4,3
VRA,0,0,0,2,2,3
LIR,0,0,0,7,7,3
RRK,0,0,0,2,2,3
LSA,0,0,0,9,9,3
SRS,0,0,0,2,2,3
RSA,0,0,0,5,5,3
SAI,0,0,0,8,8,3
AID,0,0,0,3,3,3
IDS,0,0,0,2,2,3
SLN,0,0,0,3,3,3
LNN,0,0,0,4,4,3
NNR,0,0,0,1,1,3
NRM,0,0,0,4,4,3
RML,0,0,0,1,1,3
MLS,0,0,0,2,2,3
LSQ,0,0,0,3,3,3
SQI,0,0,0,3,3,3
QIW,0,0,0,1,1,3
IWS,0,0,0,2,2,3
WSH,0,0,0,1,1,3
LVD,0,0,0,7,7,3
AVE,0,0,0,9,9,3
VEY,0,0,0,2,2,3
EYF,0,0,0,3,3,3
YFT,0,0,0,1,1,3
FTR,0,0,0,2,2,3
TRL,0,0,0,3,3,3
ARR,0,0,0,7,7,3
RGL,0,0,0,5,5,3
GLE,0,0,0,6,6,3
EHH,0,0,0,1,1,3
HHH,0,0,0,4,4,3
MAS,0,0,0,2,2,3
SLQ,0,0,0,6,6,3
QQQ,0,0,0,3,3,3
QQR,0,0,0,5,5,3
QRQ,0,0,0,3,3,3
RQE,0,0,0,5,5,3
DMN,0,0,0,1,1,3
MNQ,0,0,0,1,1,3
NQV,0,0,0,1,1,3
DAY,0,0,0,2,2,3
AYE,0,0,0,5,5,3
YEN,0,0,0,3,3,3
DNA,0,0,0,2,2,3
NAM,0,0,0,3,3,3
AMA,0,0,0,6,6,3
MAN,0,0,0,1,1,3
ANQ,0,0,0,4,4,3
NQY,0,0,0,1,1,3
QYE,0,0,0,1,1,3
YET,0,0,0,3,3,3
NAR,0,0,0,1,1,3
ARQ,0,0,0,5,5,3
RQK,0,0,0,2,2,3
QKG,0,0,0,1,1,3
GIE,0,0,0,2,2,3
EKY,0,0,0,5,5,3
DNK,0,0,0,1,1,3
NKT,0,0,0,1,1,3
KTR,0,0,0,1,1,3
TRF,0,0,0,1,1,3
RFK,0,0,0,4,4,3
FKI,0,0,0,2,2,3
IKE,0,0,0,5,5,3
KEK,0,0,0,3,3,3
EKL,0,0,0,16,16,3
KEF,0,0,0,2,2,3
DNT,0,0,0,1,1,3
TYL,0,0,0,2,2,3
YLN,0,0,0,3,3,3
LNT,0,0,0,2,2,3
NTA,0,0,0,2,2,3
ESL,0,0,0,7,7,3
NVV,0,0,0,3,3,3
VVL,0,0,0,3,3,3
QLQ,0,0,0,5,5,3
LQV,0,0,0,6,6,3
RFL,0,0,0,5,5,3
FLM,0,0,0,2,2,3
LMK,0,0,0,3,3,3
MKT,0,0,0,2,2,3
VAQ,0,0,0,7,7,3
DPA,0,0,0,3,3,3
PAR,0,0,0,3,3,3
AMS,0,0,0,3,3,3
MSQ,0,0,0,1,1,3
PAT,0,0,0,2,2,3
TVK,0,0,0,4,4,3
VVN,0,0,0,2,2,3
VNF,0,0,0,3,3,3
PAW,0,0,0,1,1,3
AWQ,0,0,0,1,1,3
WQG,0,0,0,1,1,3
QGF,0,0,0,1,1,3
GFR,0,0,0,5,5,3
DPE,0,0,0,3,3,3
PEK,0,0,0,5,5,3
VLF,0,0,0,4,4,3
NLL,0,0,0,7,7,3
RLT,0,0,0,4,4,3
LTE,0,0,0,12,12,3
PET,0,0,0,3,3,3
TLE,0,0,0,5,5,3
ETN,0,0,0,2,2,3
TNI,0,0,0,2,2,3
NIN,0,0,0,3,3,3
INI,0,0,0,2,2,3
NIG,0,0,0,2,2,3
GTS,0,0,0,2,2,3
TSY,0,0,0,2,2,3
LQY,0,0,0,2,2,3
YVY,0,0,0,1,1,3
VYQ,0,0,0,2,2,3
QQF,0,0,0,2,2,3
DPK,0,0,0,1,1,3
PKR,0,0,0,1,1,3
RLQ,0,0,0,9,9,3
LQA,0,0,0,10,10,3
LQT,0,0,0,1,1,3
QTI,0,0,0,2,2,3
TIV,0,0,0,4,4,3
VGM,0,0,0,2,2,3
GMV,0,0,0,2,2,3
MVV,0,0,0,3,3,3
VVY,0,0,0,1,1,3
YSW,0,0,0,2,2,3
PLR,0,0,0,1,1,3
ERQ,0,0,0,2,2,3
RQV,0,0,0,3,3,3
EKQ,0,0,0,1,1,3
QLA,0,0,0,7,7,3
LGD,0,0,0,4,4,3
ILS,0,0,0,5,5,3
PLW,0,0,0,1,1,3
LWK,0,0,0,2,2,3
KKE,0,0,0,6,6,3
KEM,0,0,0,4,4,3
EMF,0,0,0,4,4,3
FEK,0,0,0,6,6,3
YLS,0,0,0,4,4,3
DPQ,0,0,0,2,2,3
PQK,0,0,0,2,2,3
QKA,0,0,0,4,4,3
VAV,0,0,0,2,2,3
AVN,0,0,0,3,3,3
QKR,0,0,0,3,3,3
AVV,0,0,0,7,7,3
VNQ,0,0,0,3,3,3
NQR,0,0,0,4,4,3
QRL,0,0,0,5,5,3
RLY,0,0,0,4,4,3
LYF,0,0,0,2,2,3
FDM,0,0,0,3,3,3
DMG,0,0,0,1,1,3
MGT,0,0,0,1,1,3
DPT,0,0,0,1,1,3
PTK,0,0,0,3,3,3
LNH,0,0,0,3,3,3
NHA,0,0,0,2,2,3
DPY,0,0,0,1,1,3
PYV,0,0,0,1,1,3
YVI,0,0,0,1,1,3
VIL,0,0,0,6,6,3
ITE,0,0,0,3,3,3
ILL,0,0,0,5,5,3
DQD,0,0,0,2,2,3
QDK,0,0,0,1,1,3
DKI,0,0,0,3,3,3
KIQ,0,0,0,3,3,3
IQK,0,0,0,4,4,3
DQE,0,0,0,3,3,3
QED,0,0,0,1,1,3
DVA,0,0,0,3,3,3
TIR,0,0,0,2,2,3
IRD,0,0,0,5,5,3
RDY,0,0,0,3,3,3
DYD,0,0,0,1,1,3
DQG,0,0,0,1,1,3
QGT,0,0,0,1,1,3
GTL,0,0,0,2,2,3
LFE,0,0,0,2,2,3
FEL,0,0,0,4,4,3
LIL,0,0,0,6,6,3
ANY,0,0,0,1,1,3
NYL,0,0,0,4,4,3
YLD,0,0,0,6,6,3
DQH,0,0,0,1,1,3
QHL,0,0,0,4,4,3
HLM,0,0,0,2,2,3
LMA,0,0,0,5,5,3
MAE,0,0,0,2,2,3
AEY,0,0,0,1,1,3
EYR,0,0,0,2,2,3
ELP,0,0,0,1,1,3
LPR,0,0,0,1,1,3
PRV,0,0,0,1,1,3
VFG,0,0,0,3,3,3
FGA,0,0,0,1,1,3
RKH,0,0,0,3,3,3
KHV,0,0,0,2,2,3
HVA,0,0,0,5,5,3
VAN,0,0,0,7,7,3
ANG,0,0,0,2,2,3
DQN,0,0,0,2,2,3
QNG,0,0,0,1,1,3
NGE,0,0,0,2,2,3
EIY,0,0,0,4,4,3
IYM,0,0,0,1,1,3
YMW,0,0,0,1,1,3
MWP,0,0,0,1,1,3
WPV,0,0,0,1,1,3
PVA,0,0,0,2,2,3
DQQ,0,0,0,7,7,3
QQG,0,0,0,1,1,3
QGV,0,0,0,2,2,3
VFV,0,0,0,1,1,3
VKG,0,0,0,3,3,3
KGY,0,0,0,2,2,3
GYA,0,0,0,2,2,3
YAM,0,0,0,3,3,3
DRA,0,0,0,5,5,3
ASY,0,0,0,1,1,3
SYE,0,0,0,1,1,3
ARE,0,0,0,7,7,3
ERH,0,0,0,3,3,3
RHV,0,0,0,1,1,3
LLM,0,0,0,1,1,3
LMH,0,0,0,2,2,3
MHL,0,0,0,2,2,3
IEH,0,0,0,1,1,3
EHN,0,0,0,1,1,3
HNL,0,0,0,2,2,3
ASK,0,0,0,3,3,3
DRQ,0,0,0,1,1,3
RQL,0,0,0,7,7,3
QLR,0,0,0,3,3,3
RSS,0,0,0,1,1,3
SIE,0,0,0,4,4,3
IER,0,0,0,8,8,3
ERV,0,0,0,8,8,3
RVI,0,0,0,5,5,3
ISI,0,0,0,4,4,3
IFQ,0,0,0,3,3,3
FQS,0,0,0,4,4,3
DRT,0,0,0,1,1,3
TSF,0,0,0,2,2,3
SFD,0,0,0,5,5,3
FDK,0,0,0,4,4,3
DKL,0,0,0,8,8,3
ANS,0,0,0,1,1,3
DSE,0,0,0,2,2,3
SEQ,0,0,0,2,2,3
QVV,0,0,0,1,1,3
VVH,0,0,0,2,2,3
VHQ,0,0,0,1,1,3
HQL,0,0,0,2,2,3
QLE,0,0,0,7,7,3
RLI,0,0,0,9,9,3
DSG,0,0,0,2,2,3
SGY,0,0,0,2,2,3
GYR,0,0,0,1,1,3
YRS,0,0,0,2,2,3
SAM,0,0,0,2,2,3
MSV,0,0,0,1,1,3
SVQ,0,0,0,3,3,3
QSS,0,0,0,2,2,3
DSM,0,0,0,2,2,3
QRA,0,0,0,4,4,3
RAY,0,0,0,3,3,3
YEI,0,0,0,2,2,3
ILM,0,0,0,2,2,3
LMT,0,0,0,3,3,3
MTI,0,0,0,1,1,3
TIM,0,0,0,1,1,3
IME,0,0,0,2,2,3
DSS,0,0,0,1,1,3
SSV,0,0,0,1,1,3
VII,0,0,0,2,2,3
IIS,0,0,0,5,5,3
KTY,0,0,0,1,1,3
YLV,0,0,0,2,2,3
LVS,0,0,0,5,5,3
VSG,0,0,0,2,2,3
DSV,0,0,0,6,6,3
SLL,0,0,0,13,13,3
LDV,0,0,0,1,1,3
DVV,0,0,0,3,3,3
VVK,0,0,0,6,6,3
KST,0,0,0,4,4,3
STG,0,0,0,4,4,3
SVT,0,0,0,4,4,3
VTN,0,0,0,2,2,3
TND,0,0,0,2,2,3
IFN,0,0,0,3,3,3
FNV,0,0,0,3,3,3
NVA,0,0,0,2,2,3
ASI,0,0,0,3,3,3
EKH,0,0,0,1,1,3
KHI,0,0,0,2,2,3
HIW,0,0,0,1,1,3
IWM,0,0,0,1,1,3
WML,0,0,0,1,1,3
DTA,0,0,0,2,2,3
TAF,0,0,0,2,2,3
LME,0,0,0,3,3,3
MEQ,0,0,0,3,3,3
LEL,0,0,0,7,7,3
ELD,0,0,0,4,4,3
LDE,0,0,0,8,8,3
EIE,0,0,0,3,3,3
EQA,0,0,0,5,5,3
DTM,0,0,0,3,3,3
TMK,0,0,0,2,2,3
MKD,0,0,0,2,2,3
KDA,0,0,0,7,7,3
DAG,0,0,0,3,3,3
AGM,0,0,0,1,1,3
GMQ,0,0,0,2,2,3
MQM,0,0,0,2,2,3
QMK,0,0,0,3,3,3
MKK,0,0,0,2,2,3
DTR,0,0,0,2,2,3
TRA,0,0,0,2,2,3
RAW,0,0,0,3,3,3
LFG,0,0,0,6,6,3
LAD,0,0,0,10,10,3
ADS,0,0,0,2,2,3
DSF,0,0,0,2,2,3
DVE,0,0,0,3,3,3
VEA,0,0,0,3,3,3
EAV,0,0,0,8,8,3
VEI,0,0,0,4,4,3
IMQ,0,0,0,1,1,3
MQR,0,0,0,3,3,3
QRI,0,0,0,3,3,3
RIH,0,0,0,1,1,3
IHV,0,0,0,2,2,3
HVL,0,0,0,2,2,3
RSQ,0,0,0,3,3,3
SQG,0,0,0,1,1,3
QGG,0,0,0,1,1,3
GFN,0,0,0,1,1,3
AED,0,0,0,8,8,3
EDT,0,0,0,1,1,3
DTI,0,0,0,3,3,3
TIT,0,0,0,4,4,3
ITA,0,0,0,4,4,3
LLH,0,0,0,4,4,3
VRV,0,0,0,3,3,3
RVK,0,0,0,5,5,3
KEY,0,0,0,1,1,3
FDD,0,0,0,1,1,3
DDI,0,0,0,5,5,3
ARY,0,0,0,1,1,3
RYF,0,0,0,2,2,3
YFS,0,0,0,2,2,3
FSI,0,0,0,3,3,3
SIG,0,0,0,3,3,3
IGL,0,0,0,4,4,3
LNL,0,0,0,1,1,3
NLI,0,0,0,4,4,3
LIH,0,0,0,4,4,3
IHL,0,0,0,4,4,3
HLF,0,0,0,3,3,3
DWG,0,0,0,1,1,3
WGE,0,0,0,2,2,3
EAF,0,0,0,4,4,3
AFT,0,0,0,1,1,3
FTA,0,0,0,5,5,3
TAI,0,0,0,3,3,3
AIN,0,0,0,3,3,3
INL,0,0,0,4,4,3
DWL,0,0,0,2,2,3
WLK,0,0,0,1,1,3
QKI,0,0,0,3,3,3
KIF,0,0,0,5,5,3
IFP,0,0,0,1,1,3
FPP,0,0,0,1,1,3
PPI,0,0,0,1,1,3
PIL,0,0,0,2,2,3
LSI,0,0,0,2,2,3
DWY,0,0,0,2,2,3
WYR,0,0,0,1,1,3
YRT,0,0,0,3,3,3
RTY,0,0,0,2,2,3
TYA,0,0,0,1,1,3
YAE,0,0,0,2,2,3
RET,0,0,0,2,2,3
ETA,0,0,0,4,4,3
DYE,0,0,0,1,1,3
YER,0,0,0,2,2,3
KSY,0,0,0,3,3,3
SYI,0,0,0,2,2,3
YIQ,0,0,0,4,4,3
IQT,0,0,0,3,3,3
VHK,0,0,0,2,2,3
HKL,0,0,0,2,2,3
KLT,0,0,0,3,3,3
EAQ,0,0,0,2,2,3
KID,0,0,0,2,2,3
IDR,0,0,0,1,1,3
DRL,0,0,0,7,7,3
LVQ,0,0,0,7,7,3
QSF,0,0,0,2,2,3
SFS,0,0,0,2,2,3
FSG,0,0,0,2,2,3
SGA,0,0,0,2,2,3
GAY,0,0,0,2,2,3
YFQ,0,0,0,2,2,3
FQQ,0,0,0,1,1,3
QQN,0,0,0,3,3,3
EDD,0,0,0,2,2,3
IMY,0,0,0,1,1,3
MYL,0,0,0,1,1,3
YLM,0,0,0,1,1,3
DDS,0,0,0,2,2,3
DSK,0,0,0,2,2,3
RKY,0,0,0,1,1,3
KYA,0,0,0,2,2,3
YAR,0,0,0,3,3,3
RII,0,0,0,6,6,3
EDK,0,0,0,5,5,3
KEA,0,0,0,10,10,3
AVF,0,0,0,6,6,3
VFD,0,0,0,3,3,3
VVD,0,0,0,4,4,3
TLT,0,0,0,4,4,3
LTA,0,0,0,6,6,3
TAV,0,0,0,4,4,3
ATG,0,0,0,4,4,3
IST,0,0,0,5,5,3
EDL,0,0,0,4,4,3
DLP,0,0,0,1,1,3
KWS,0,0,0,2,2,3
WSG,0,0,0,1,1,3
GYF,0,0,0,2,2,3
YFE,0,0,0,1,1,3
KKN,0,0,0,2,2,3
EDM,0,0,0,1,1,3
DMI,0,0,0,2,2,3
MIF,0,0,0,1,1,3
IFE,0,0,0,2,2,3
FEI,0,0,0,1,1,3
KNY,0,0,0,1,1,3
YLT,0,0,0,5,5,3
TKV,0,0,0,2,2,3
VAY,0,0,0,4,4,3
AYY,0,0,0,2,2,3
YYA,0,0,0,2,2,3
EMN,0,0,0,3,3,3
EDN,0,0,0,1,1,3
LRQ,0,0,0,4,4,3
QKV,0,0,0,4,4,3
ELH,0,0,0,2,2,3
HTS,0,0,0,2,2,3
LVE,0,0,0,7,7,3
VEE,0,0,0,3,3,3
EMI,0,0,0,3,3,3
AEF,0,0,0,3,3,3
EFK,0,0,0,4,4,3
AFD,0,0,0,2,2,3
DMF,0,0,0,1,1,3
EER,0,0,0,6,6,3
VKN,0,0,0,2,2,3
KNG,0,0,0,1,1,3
NGL,0,0,0,4,4,3
IKS,0,0,0,4,4,3
KSG,0,0,0,3,3,3
SGK,0,0,0,2,2,3
GKQ,0,0,0,1,1,3
KQS,0,0,0,3,3,3
QST,0,0,0,1,1,3
EES,0,0,0,6,6,3
SDI,0,0,0,5,5,3
DIK,0,0,0,5,5,3
IKY,0,0,0,2,2,3
YKT,0,0,0,3,3,3
KTS,0,0,0,1,1,3
TSK,0,0,0,1,1,3
SKN,0,0,0,2,2,3
NFI,0,0,0,3,3,3
FIN,0,0,0,3,3,3
INK,0,0,0,2,2,3
NKV,0,0,0,2,2,3
KVY,0,0,0,1,1,3
EEV,0,0,0,10,10,3
KKH,0,0,0,4,4,3
KHG,0,0,0,1,1,3
HGT,0,0,0,1,1,3
GRI,0,0,0,2,2,3
EFP,0,0,0,1,1,3
FPE,0,0,0,2,2,3
PEM,0,0,0,4,4,3
MLA,0,0,0,3,3,3
EII,0,0,0,4,4,3
EFR,0,0,0,2,2,3
FRD,0,0,0,1,1,3
DLH,0,0,0,1,1,3
AAE,0,0,0,13,13,3
AET,0,0,0,4,4,3
EVA,0,0,0,4,4,3
VAD,0,0,0,9,9,3
ADE,0,0,0,3,3,3
EGD,0,0,0,1,1,3
GDQ,0,0,0,1,1,3
QQL,0,0,0,3,3,3
QLL,0,0,0,12,12,3
KRV,0,0,0,6,6,3
LVR,0,0,0,4,4,3
EGH,0,0,0,1,1,3
GHV,0,0,0,1,1,3
VEV,0,0,0,3,3,3
LRG,0,0,0,4,4,3
RGI,0,0,0,3,3,3
GIH,0,0,0,3,3,3
IHR,0,0,0,2,2,3
HRI,0,0,0,2,2,3
IAD,0,0,0,7,7,3
ADM,0,0,0,4,4,3
DMS,0,0,0,2,2,3
EGK,0,0,0,2,2,3
GKD,0,0,0,3,3,3
KDR,0,0,0,5,5,3
DRE,0,0,0,2,2,3
ELY,0,0,0,7,7,3
YGK,0,0,0,3,3,3
KLH,0,0,0,2,2,3
LHE,0,0,0,2,2,3
HET,0,0,0,1,1,3
KVT,0,0,0,1,1,3
VTE,0,0,0,3,3,3
TED,0,0,0,1,1,3
EGN,0,0,0,2,2,3
GNK,0,0,0,1,1,3
NKR,0,0,0,2,2,3
SVN,0,0,0,6,6,3
VNS,0,0,0,2,2,3
NSI,0,0,0,1,1,3
SIV,0,0,0,2,2,3
EGQ,0,0,0,2,2,3
GQQ,0,0,0,1,1,3
QRR,0,0,0,7,7,3
RIR,0,0,0,5,5,3
IRQ,0,0,0,2,2,3
GKW,0,0,0,2,2,3
WIA,0,0,0,2,2,3
ADN,0,0,0,3,3,3
DNQ,0,0,0,1,1,3
VAW,0,0,0,2,2,3
AWL,0,0,0,3,3,3
EHE,0,0,0,1,1,3
HEI,0,0,0,2,2,3
EIQ,0,0,0,2,2,3
IQE,0,0,0,6,6,3
QEW,0,0,0,2,2,3
EWY,0,0,0,1,1,3
WYK,0,0,0,1,1,3
KGF,0,0,0,3,3,3
GFL,0,0,0,3,3,3
FLR,0,0,0,5,5,3
KFR,0,0,0,7,7,3
FRV,0,0,0,2,2,3
RVW,0,0,0,4,4,3
VWI,0,0,0,2,2,3
WIS,0,0,0,2,2,3
SIL,0,0,0,3,3,3
EIS,0,0,0,5,5,3
SEM,0,0,0,2,2,3
VRM,0,0,0,1,1,3
RMR,0,0,0,2,2,3
HLG,0,0,0,2,2,3
KMI,0,0,0,1,1,3
MIS,0,0,0,3,3,3
SWK,0,0,0,1,1,3
WKD,0,0,0,1,1,3
DAI,0,0,0,6,6,3
ETF,0,0,0,3,3,3
TFR,0,0,0,2,2,3
REK,0,0,0,3,3,3
KFM,0,0,0,1,1,3
FMQ,0,0,0,3,3,3
MQH,0,0,0,1,1,3
EKN,0,0,0,2,2,3
KNS,0,0,0,1,1,3
NSY,0,0,0,1,1,3
SYR,0,0,0,3,3,3
YRK,0,0,0,2,2,3
VGN,0,0,0,3,3,3
NLY,0,0,0,3,3,3
FVY,0,0,0,1,1,3
AME,0,0,0,2,2,3
MEE,0,0,0,3,3,3
EEE,0,0,0,8,8,3
EMA,0,0,0,4,4,3
MAK,0,0,0,3,3,3
KVQ,0,0,0,3,3,3
VQY,0,0,0,3,3,3
QYL,0,0,0,3,3,3
LTR,0,0,0,6,6,3
TRS,0,0,0,2,2,3
AIR,0,0,0,6,6,3
MNY,0,0,0,1,1,3
NYY,0,0,0,1,1,3
YYT,0,0,0,1,1,3
YTV,0,0,0,2,2,3
FGV,0,0,0,2,2,3
GVS,0,0,0,3,3,3
VSR,0,0,0,5,5,3
SRA,0,0,0,6,6,3
AQL,0,0,0,7,7,3
QLI,0,0,0,5,5,3
LIW,0,0,0,3,3,3
WSR,0,0,0,1,1,3
EPE,0,0,0,2,2,3
PEE,0,0,0,6,6,3
EVF,0,0,0,4,4,3
KSV,0,0,0,4,4,3
MEG,0,0,0,2,2,3
KVD,0,0,0,2,2,3
VDK,0,0,0,4,4,3
KLQ,0,0,0,5,5,3
LQE,0,0,0,11,11,3
QEP,0,0,0,1,1,3
EPL,0,0,0,2,2,3
LLE,0,0,0,11,11,3
LYA,0,0,0,1,1,3
EPG,0,0,0,1,1,3
PGQ,0,0,0,2,2,3
IVM,0,0,0,2,2,3
VMH,0,0,0,1,1,3
MHK,0,0,0,1,1,3
EQE,0,0,0,3,3,3
QEI,0,0,0,3,3,3
QVK,0,0,0,1,1,3
KAY,0,0,0,10,10,3
AYD,0,0,0,4,4,3
YDR,0,0,0,1,1,3
RAA,0,0,0,9,9,3
RLG,0,0,0,1,1,3
QEV,0,0,0,4,4,3
EVY,0,0,0,4,4,3
VYA,0,0,0,5,5,3
YAQ,0,0,0,2,2,3
EQP,0,0,0,1,1,3
QPS,0,0,0,1,1,3
RTL,0,0,0,2,2,3
TLD,0,0,0,4,4,3
LDQ,0,0,0,7,7,3
DQL,0,0,0,5,5,3
VKQ,0,0,0,1,1,3
KQM,0,0,0,4,4,3
QMV,0,0,0,1,1,3
VVA,0,0,0,8,8,3
MEK,0,0,0,4,4,3
RRY,0,0,0,3,3,3
RYE,0,0,0,1,1,3
YEE,0,0,0,5,5,3
ESP,0,0,0,1,1,3
SPV,0,0,0,2,2,3
LRI,0,0,0,5,5,3
RIV,0,0,0,2,2,3
IVF,0,0,0,7,7,3
HDA,0,0,0,2,2,3
IRV,0,0,0,5,5,3
RVA,0,0,0,5,5,3
VKR,0,0,0,7,7,3
KRR,0,0,0,5,5,3
RRF,0,0,0,1,1,3
FPT,0,0,0,1,1,3
KLG,0,0,0,6,6,3
GAW,0,0,0,2,2,3
IWW,0,0,0,2,2,3
WLL,0,0,0,4,4,3
KRS,0,0,0,3,3,3
RSV,0,0,0,1,1,3
VNR,0,0,0,7,7,3
KWF,0,0,0,2,2,3
WFL,0,0,0,2,2,3
LIV,0,0,0,7,7,3
VFI,0,0,0,2,2,3
EVN,0,0,0,4,4,3
NRN,0,0,0,2,2,3
RNF,0,0,0,1,1,3
NFG,0,0,0,2,2,3
FGE,0,0,0,2,2,3
IND,0,0,0,2,2,3
NDL,0,0,0,3,3,3
LLL,0,0,0,18,18,3
EVV,0,0,0,7,7,3
GRV,0,0,0,2,2,3
RVS,0,0,0,2,2,3
LWN,0,0,0,1,1,3
WNE,0,0,0,1,1,3
NEW,0,0,0,1,1,3
EWW,0,0,0,1,1,3
WLI,0,0,0,1,1,3
EWQ,0,0,0,2,2,3
WQT,0,0,0,1,1,3
QTM,0,0,0,2,2,3
TMV,0,0,0,2,2,3
ALQ,0,0,0,3,3,3
EYK,0,0,0,1,1,3
YKY,0,0,0,1,1,3
KYY,0,0,0,1,1,3
YYK,0,0,0,1,1,3
YKL,0,0,0,2,2,3
EMQ,0,0,0,1,1,3
FAD,0,0,0,4,4,3
FDP,0,0,0,1,1,3
DPV,0,0,0,2,2,3
PVI,0,0,0,1,1,3
VIQ,0,0,0,2,2,3
QER,0,0,0,2,2,3
RRV,0,0,0,3,3,3
VIN,0,0,0,1,1,3
INR,0,0,0,2,2,3
NRI,0,0,0,1,1,3
RIG,0,0,0,1,1,3
GQA,0,0,0,4,4,3
QAW,0,0,0,1,1,3
AWR,0,0,0,1,1,3
FEV,0,0,0,1,1,3
EVI,0,0,0,1,1,3
VID,0,0,0,5,5,3
IDT,0,0,0,5,5,3
TIK,0,0,0,3,3,3
VEN,0,0,0,7,7,3
ENA,0,0,0,1,1,3
FFS,0,0,0,1,1,3
FSF,0,0,0,1,1,3
SFE,0,0,0,2,2,3
ELV,0,0,0,6,6,3
VES,0,0,0,2,2,3
SIN,0,0,0,2,2,3
NDV,0,0,0,2,2,3
DVK,0,0,0,2,2,3
SLR,0,0,0,4,4,3
FGL,0,0,0,1,1,3
GLK,0,0,0,4,4,3
GWY,0,0,0,1,1,3
WYS,0,0,0,1,1,3
YSE,0,0,0,1,1,3
EMK,0,0,0,4,4,3
MKR,0,0,0,2,2,3
KRN,0,0,0,2,2,3
RNV,0,0,0,2,2,3
NVQ,0,0,0,1,1,3
VQR,0,0,0,4,4,3
ERA,0,0,0,6,6,3
IEE,0,0,0,5,5,3
FHS,0,0,0,3,3,3
FIA,0,0,0,2,2,3
AVH,0,0,0,2,2,3
VHE,0,0,0,3,3,3
HEM,0,0,0,1,1,3
MLD,0,0,0,2,2,3
LDG,0,0,0,1,1,3
FRT,0,0,0,2,2,3
LID,0,0,0,6,6,3
IDH,0,0,0,2,2,3
DHL,0,0,0,1,1,3
HLD,0,0,0,3,3,3
LDT,0,0,0,2,2,3
KAT,0,0,0,2,2,3
ATI,0,0,0,2,2,3
SKK,0,0,0,3,3,3
KKR,0,0,0,4,4,3
FKE,0,0,0,2,2,3
ESA,0,0,0,4,4,3
FKG,0,0,0,3,3,3
KGK,0,0,0,3,3,3
GKI,0,0,0,4,4,3
TGA,0,0,0,2,2,3
GAK,0,0,0,1,1,3
SIY,0,0,0,3,3,3
IYR,0,0,0,3,3,3
YRF,0,0,0,1,1,3
RFF,0,0,0,4,4,3
FFE,0,0,0,3,3,3
FEH,0,0,0,1,1,3
EHG,0,0,0,1,1,3
HGL,0,0,0,2,2,3
VQN,0,0,0,3,3,3
QNS,0,0,0,1,1,3
LQR,0,0,0,5,5,3
ILY,0,0,0,5,5,3
LYL,0,0,0,2,2,3
YLW,0,0,0,1,1,3
WAI,0,0,0,2,2,3
IRH,0,0,0,1,1,3
QNM,0,0,0,2,2,3
NML,0,0,0,2,2,3
IDE,0,0,0,6,6,3
ELM,0,0,0,5,5,3
LMQ,0,0,0,2,2,3
MQA,0,0,0,2,2,3
FLL,0,0,0,2,2,3
TGF,0,0,0,2,2,3
GFA,0,0,0,3,3,3
AKG,0,0,0,3,3,3
AKS,0,0,0,3,3,3
SSA,0,0,0,4,4,3
SAE,0,0,0,3,3,3
FNQ,0,0,0,2,2,3
RIS,0,0,0,1,1,3
GEL,0,0,0,2,2,3
LYN,0,0,0,2,2,3
YNY,0,0,0,1,1,3
FNR,0,0,0,2,2,3
RMF,0,0,0,2,2,3
STH,0,0,0,2,2,3
THH,0,0,0,2,2,3
HHY,0,0,0,2,2,3
HYT,0,0,0,2,2,3
YTD,0,0,0,3,3,3
TDS,0,0,0,2,2,3
SVG,0,0,0,3,3,3
GIL,0,0,0,4,4,3
FPL,0,0,0,1,1,3
LLV,0,0,0,10,10,3
VDH,0,0,0,1,1,3
DHT,0,0,0,1,1,3
SRE,0,0,0,6,6,3
EAD,0,0,0,3,3,3
ADY,0,0,0,2,2,3
YFR,0,0,0,2,2,3
FRK,0,0,0,4,4,3
IQL,0,0,0,4,4,3
LNE,0,0,0,6,6,3
NEG,0,0,0,2,2,3
PNL,0,0,0,1,1,3
NLA,0,0,0,3,3,3
AFY,0,0,0,1,1,3
FYW,0,0,0,1,1,3
YWS,0,0,0,2,2,3
KEN,0,0,0,2,2,3
FPQ,0,0,0,2,2,3
PQL,0,0,0,3,3,3
QLT,0,0,0,5,5,3
LTQ,0,0,0,4,4,3
TQN,0,0,0,1,1,3
QNN,0,0,0,1,1,3
NNS,0,0,0,1,1,3
NSR,0,0,0,2,2,3
FSA,0,0,0,3,3,3
LNI,0,0,0,6,6,3
NIA,0,0,0,2,2,3
HEL,0,0,0,3,3,3
ELS,0,0,0,4,4,3
LSD,0,0,0,2,2,3
SDV,0,0,0,3,3,3
DVG,0,0,0,1,1,3
AIV,0,0,0,3,3,3
IVR,0,0,0,1,1,3
VRN,0,0,0,1,1,3
SEF,0,0,0,3,3,3
EFI,0,0,0,3,3,3
FIQ,0,0,0,2,2,3
VTS,0,0,0,1,1,3
SRG,0,0,0,1,1,3
FTE,0,0,0,1,1,3
LRN,0,0,0,5,5,3
TRI,0,0,0,1,1,3
FVP,0,0,0,2,2,3
VPV,0,0,0,1,1,3
PVF,0,0,0,1,1,3
VFF,0,0,0,4,4,3
FFV,0,0,0,2,2,3
FVV,0,0,0,2,2,3
VVV,0,0,0,4,4,3
VRR,0,0,0,4,4,3
FYQ,0,0,0,3,3,3
YQT,0,0,0,3,3,3
QTF,0,0,0,1,1,3
TFF,0,0,0,1,1,3
FFD,0,0,0,1,1,3
FDE,0,0,0,2,2,3
EQH,0,0,0,2,2,3
LDL,0,0,0,4,4,3
LQS,0,0,0,4,4,3
QSA,0,0,0,2,2,3
GAG,0,0,0,2,2,3
AGT,0,0,0,1,1,3
TSV,0,0,0,1,1,3
VNM,0,0,0,2,2,3
NMN,0,0,0,2,2,3
MNT,0,0,0,2,2,3
NTN,0,0,0,1,1,3
TNE,0,0,0,2,2,3
NEV,0,0,0,4,4,3
ANI,0,0,0,2,2,3
GAP,0,0,0,1,1,3
PLA,0,0,0,1,1,3
ARM,0,0,0,2,2,3
RME,0,0,0,1,1,3
EVT,0,0,0,1,1,3
VTL,0,0,0,3,3,3
SLF,0,0,0,1,1,3
FGR,0,0,0,1,1,3
GRF,0,0,0,3,3,3
GAQ,0,0,0,1,1,3
AQY,0,0,0,5,5,3
QAA,0,0,0,9,9,3
AGV,0,0,0,2,2,3
LGL,0,0,0,3,3,3
LKM,0,0,0,3,3,3
VAI,0,0,0,3,3,3
FSY,0,0,0,2,2,3
EIA,0,0,0,4,4,3
LKS,0,0,0,9,9,3
KSQ,0,0,0,1,1,3
QIR,0,0,0,2,2,3
EAY,0,0,0,5,5,3
YLL,0,0,0,4,4,3
ERY,0,0,0,3,3,3
YVA,0,0,0,5,5,3
VAF,0,0,0,3,3,3
GED,0,0,0,2,2,3
AIL,0,0,0,6,6,3
EEA,0,0,0,6,6,3
TLM,0,0,0,2,2,3
SKD,0,0,0,3,3,3
GEG,0,0,0,1,1,3
GWA,0,0,0,1,1,3
ILF,0,0,0,3,3,3
LFN,0,0,0,1,1,3
GEK,0,0,0,1,1,3
EKR,0,0,0,3,3,3
EEI,0,0,0,8,8,3
EIK,0,0,0,3,3,3
GFF,0,0,0,1,1,3
FFG,0,0,0,2,2,3
FGW,0,0,0,1,1,3
GWF,0,0,0,1,1,3
WFN,0,0,0,1,1,3
GFK,0,0,0,2,2,3
KNE,0,0,0,2,2,3
EVR,0,0,0,6,6,3
RTP,0,0,0,1,1,3
PVT,0,0,0,1,1,3
VTK,0,0,0,3,3,3
TKF,0,0,0,1,1,3
FRI,0,0,0,2,2,3
GFM,0,0,0,1,1,3
FMI,0,0,0,1,1,3
MIW,0,0,0,1,1,3
IWH,0,0,0,3,3,3
WHP,0,0,0,1,1,3
HPK,0,0,0,1,1,3
PKM,0,0,0,1,1,3
KMD,0,0,0,1,1,3
MDE,0,0,0,3,3,3
DEY,0,0,0,3,3,3
EYM,0,0,0,3,3,3
YME,0,0,0,1,1,3
EID,0,0,0,3,3,3
IDG,0,0,0,1,1,3
DGY,0,0,0,1,1,3
GYL,0,0,0,2,2,3
DEM,0,0,0,2,2,3
EMS,0,0,0,1,1,3
MSE,0,0,0,2,2,3
SER,0,0,0,2,2,3
ITL,0,0,0,4,4,3
RLW,0,0,0,3,3,3
WLA,0,0,0,4,4,3
GFY,0,0,0,1,1,3
FYP,0,0,0,1,1,3
YPM,0,0,0,1,1,3
PMV,0,0,0,1,1,3
AQR,0,0,0,5,5,3
RRA,0,0,0,4,4,3
GGK,0,0,0,1,1,3
GKE,0,0,0,2,2,3
LAI,0,0,0,3,3,3
IEN,0,0,0,6,6,3
ENF,0,0,0,2,2,3
GSS,0,0,0,2,2,3
SSG,0,0,0,1,1,3
SGV,0,0,0,2,2,3
MSI,0,0,0,1,1,3
IFF,0,0,0,2,2,3
AGQ,0,0,0,2,2,3
GQK,0,0,0,1,1,3
LEQ,0,0,0,7,7,3
GHN,0,0,0,1,1,3
VLS,0,0,0,4,4,3
LSG,0,0,0,1,1,3
IHE,0,0,0,2,2,3
FAE,0,0,0,5,5,3
EEH,0,0,0,2,2,3
YSK,0,0,0,1,1,3
SKY,0,0,0,3,3,3
ISQ,0,0,0,1,1,3
SQL,0,0,0,3,3,3
LLY,0,0,0,2,2,3
YHV,0,0,0,1,1,3
HVQ,0,0,0,1,1,3
VQV,0,0,0,1,1,3
QVM,0,0,0,1,1,3
VMM,0,0,0,2,2,3
MMV,0,0,0,1,1,3
ARG,0,0,0,3,3,3
KGP,0,0,0,1,1,3
GPK,0,0,0,3,3,3
KFI,0,0,0,2,2,3
GKS,0,0,0,1,1,3
KSN,0,0,0,1,1,3
SNM,0,0,0,1,1,3
NMM,0,0,0,2,2,3
MMD,0,0,0,3,3,3
MDA,0,0,0,3,3,3
ISF,0,0,0,1,1,3
SFV,0,0,0,1,1,3
FVL,0,0,0,4,4,3
GKT,0,0,0,3,3,3
KTT,0,0,0,3,3,3
TTA,0,0,0,2,2,3
ELF,0,0,0,5,5,3
TFV,0,0,0,1,1,3
KRH,0,0,0,3,3,3
RHL,0,0,0,2,2,3
HLT,0,0,0,4,4,3
TTI,0,0,0,1,1,3
TIL,0,0,0,4,4,3
LYR,0,0,0,5,5,3
YRL,0,0,0,6,6,3
QVG,0,0,0,1,1,3
DKV,0,0,0,4,4,3
LVP,0,0,0,2,2,3
VPK,0,0,0,1,1,3
PKI,0,0,0,1,1,3
GSQ,0,0,0,1,1,3
SQA,0,0,0,2,2,3
QAG,0,0,0,3,3,3
AGG,0,0,0,5,5,3
GGA,0,0,0,1,1,3
GAA,0,0,0,2,2,3
APH,0,0,0,1,1,3
PHF,0,0,0,2,2,3
HFL,0,0,0,1,1,3
KSP,0,0,0,1,1,3
SPG,0,0,0,1,1,3
PGA,0,0,0,1,1,3
GLG,0,0,0,2,2,3
GLV,0,0,0,2,2,3
NAF,0,0,0,1,1,3
GGN,0,0,0,1,1,3
GNA,0,0,0,1,1,3
GHA,0,0,0,3,3,3
GLN,0,0,0,1,1,3
TRY,0,0,0,1,1,3
RYT,0,0,0,1,1,3
YTL,0,0,0,1,1,3
TLS,0,0,0,2,2,3
SLM,0,0,0,5,5,3
LMV,0,0,0,2,2,3
MVL,0,0,0,2,2,3
ERK,0,0,0,2,2,3
KLS,0,0,0,2,2,3
LSS,0,0,0,2,2,3
GLT,0,0,0,4,4,3
LTS,0,0,0,3,3,3
IDK,0,0,0,2,2,3
GLW,0,0,0,3,3,3
FIW,0,0,0,1,1,3
IWI,0,0,0,2,2,3
SLG,0,0,0,2,2,3
RVE,0,0,0,3,3,3
VEG,0,0,0,4,4,3
EGL,0,0,0,5,5,3
LWV,0,0,0,1,1,3
WVG,0,0,0,1,1,3
GNF,0,0,0,3,3,3
LAH,0,0,0,5,5,3
AHS,0,0,0,2,2,3
HSD,0,0,0,3,3,3
SDG,0,0,0,1,1,3
DGL,0,0,0,3,3,3
IKN,0,0,0,4,4,3
KNI,0,0,0,4,4,3
NIS,0,0,0,1,1,3
ISD,0,0,0,3,3,3
SDD,0,0,0,1,1,3
DDL,0,0,0,4,4,3
GNY,0,0,0,3,3,3
YLR,0,0,0,3,3,3
GPD,0,0,0,1,1,3
PDM,0,0,0,1,1,3
DMT,0,0,0,1,1,3
MTA,0,0,0,3,3,3
TAM,0,0,0,4,4,3
AMV,0,0,0,4,4,3
PKD,0,0,0,1,1,3
VFN,0,0,0,3,3,3
NQW,0,0,0,1,1,3
QWG,0,0,0,2,2,3
PKK,0,0,0,1,1,3
KAQ,0,0,0,4,4,3
VGW,0,0,0,1,1,3
GWR,0,0,0,3,3,3
WRE,0,0,0,1,1,3
LHG,0,0,0,1,1,3
GSD,0,0,0,1,1,3
SDF,0,0,0,1,1,3
IHF,0,0,0,1,1,3
HFI,0,0,0,2,2,3
FID,0,0,0,1,1,3
GSH,0,0,0,1,1,3
SHA,0,0,0,2,2,3
HAN,0,0,0,2,2,3
ANE,0,0,0,3,3,3
NEF,0,0,0,3,3,3
EFF,0,0,0,3,3,3
FFF,0,0,0,5,5,3
FFR,0,0,0,2,2,3
FRA,0,0,0,1,1,3
TLR,0,0,0,1,1,3
LRH,0,0,0,3,3,3
RHA,0,0,0,1,1,3
NAA,0,0,0,7,7,3
AFI,0,0,0,4,4,3
FIM,0,0,0,2,2,3
IML,0,0,0,1,1,3
MLE,0,0,0,4,4,3
TTT,0,0,0,2,2,3
AQG,0,0,0,2,2,3
QGL,0,0,0,3,3,3
LIN,0,0,0,3,3,3
SGL,0,0,0,2,2,3
WQN,0,0,0,1,1,3
QNE,0,0,0,2,2,3
NEL,0,0,0,6,6,3
LRY,0,0,0,1,1,3
RYL,0,0,0,3,3,3
DEN,0,0,0,1,1,3
GYK,0,0,0,2,2,3
KVS,0,0,0,5,5,3
SKS,0,0,0,3,3,3
SYT,0,0,0,1,1,3
YTG,0,0,0,3,3,3
TGE,0,0,0,2,2,3
GEW,0,0,0,1,1,3
EWK,0,0,0,1,1,3
KKY,0,0,0,3,3,3
HAH,0,0,0,1,1,3
HAS,0,0,0,1,1,3
YAS,0,0,0,3,3,3
ASE,0,0,0,2,2,3
SEI,0,0,0,9,9,3
IAF,0,0,0,4,4,3
AFE,0,0,0,5,5,3
FEA,0,0,0,3,3,3
NQA,0,0,0,1,1,3
IQI,0,0,0,1,1,3
QIH,0,0,0,3,3,3
IHG,0,0,0,4,4,3
RTI,0,0,0,2,2,3
LLT,0,0,0,7,7,3
TRH,0,0,0,2,2,3
HDK,0,0,0,1,1,3
DKH,0,0,0,1,1,3
HIE,0,0,0,2,2,3
IEI,0,0,0,3,3,3
EIV,0,0,0,2,2,3
IVV,0,0,0,3,3,3
RQM,0,0,0,2,2,3
LVT,0,0,0,2,2,3
VTD,0,0,0,1,1,3
TDG,0,0,0,1,1,3
LYI,0,0,0,2,2,3
YIE,0,0,0,3,3,3
ETK,0,0,0,2,2,3
HFG,0,0,0,1,1,3
AAW,0,0,0,2,2,3
GHP,0,0,0,1,1,3
HPL,0,0,0,2,2,3
PLK,0,0,0,3,3,3
LGH,0,0,0,1,1,3
HHK,0,0,0,2,2,3
HKA,0,0,0,3,3,3
AYV,0,0,0,4,4,3
YVD,0,0,0,1,1,3
VDG,0,0,0,3,3,3
GAN,0,0,0,2,2,3
ANT,0,0,0,2,2,3
RDK,0,0,0,1,1,3
HKE,0,0,0,1,1,3
FEE,0,0,0,4,4,3
EEW,0,0,0,2,2,3
DLI,0,0,0,2,2,3
INM,0,0,0,1,1,3
MMS,0,0,0,1,1,3
MSR,0,0,0,3,3,3
SRL,0,0,0,7,7,3
VHH,0,0,0,1,1,3
HHE,0,0,0,1,1,3
HEQ,0,0,0,2,2,3
RLM,0,0,0,2,2,3
MKM,0,0,0,1,1,3
MRS,0,0,0,3,3,3
IVL,0,0,0,2,2,3
QEH,0,0,0,1,1,3
HLR,0,0,0,2,2,3
HPA,0,0,0,1,1,3
PAF,0,0,0,1,1,3
IAH,0,0,0,5,5,3
HAD,0,0,0,2,2,3
ADR,0,0,0,3,3,3
GLD,0,0,0,1,1,3
HPF,0,0,0,1,1,3
PFY,0,0,0,1,1,3
YQA,0,0,0,2,2,3
LGQ,0,0,0,2,2,3
LTL,0,0,0,2,2,3
AQW,0,0,0,4,4,3
QWQ,0,0,0,2,2,3
WQA,0,0,0,3,3,3
HQA,0,0,0,1,1,3
MLK,0,0,0,3,3,3
INE,0,0,0,5,5,3
NEE,0,0,0,3,3,3
AEW,0,0,0,2,2,3
EWD,0,0,0,1,1,3
WDR,0,0,0,2,2,3
MLV,0,0,0,2,2,3
INT,0,0,0,1,1,3
SDW,0,0,0,2,2,3
DWI,0,0,0,1,1,3
SNA,0,0,0,1,1,3
KVR,0,0,0,4,4,3
VIY,0,0,0,2,2,3
IYW,0,0,0,1,1,3
YWQ,0,0,0,1,1,3
WQM,0,0,0,1,1,3
QMT,0,0,0,1,1,3
HSR,0,0,0,1,1,3
SRR,0,0,0,2,2,3
KMV,0,0,0,2,2,3
MVG,0,0,0,2,2,3
GKR,0,0,0,2,2,3
LAY,0,0,0,6,6,3
RNK,0,0,0,2,2,3
HTF,0,0,0,2,2,3
TFL,0,0,0,3,3,3
LDD,0,0,0,2,2,3
GAI,0,0,0,2,2,3
HSY,0,0,0,2,2,3
SYH,0,0,0,1,1,3
YHD,0,0,0,1,1,3
VDE,0,0,0,2,2,3
KAR,0,0,0,3,3,3
LIY,0,0,0,1,1,3
IYE,0,0,0,2,2,3
YED,0,0,0,4,4,3
HWD,0,0,0,1,1,3
WDK,0,0,0,1,1,3
DMV,0,0,0,1,1,3
ANF,0,0,0,2,2,3
FAH,0,0,0,1,1,3
DTY,0,0,0,2,2,3
TYG,0,0,0,1,1,3
IAM,0,0,0,1,1,3
MVN,0,0,0,2,2,3
VNG,0,0,0,1,1,3
LMG,0,0,0,4,4,3
MGV,0,0,0,1,1,3
AHL,0,0,0,3,3,3
HLI,0,0,0,1,1,3
IAT,0,0,0,3,3,3
ATN,0,0,0,3,3,3
TNS,0,0,0,2,2,3
IDD,0,0,0,3,3,3
LRV,0,0,0,2,2,3
REN,0,0,0,2,2,3
NLE,0,0,0,6,6,3
ERR,0,0,0,1,1,3
VNN,0,0,0,2,2,3
NNL,0,0,0,4,4,3
IPF,0,0,0,1,1,3
PFM,0,0,0,1,1,3
MQK,0,0,0,4,4,3
QKH,0,0,0,1,1,3
ATE,0,0,0,3,3,3
TEF,0,0,0,1,1,3
EFY,0,0,0,2,2,3
FYE,0,0,0,2,2,3
END,0,0,0,2,2,3
RKA,0,0,0,4,4,3
GVQ,0,0,0,1,1,3
VQQ,0,0,0,2,2,3
QQH,0,0,0,2,2,3
QHA,0,0,0,1,1,3
ADK,0,0,0,1,1,3
IHN,0,0,0,1,1,3
IKP,0,0,0,1,1,3
KPL,0,0,0,2,2,3
PLN,0,0,0,1,1,3
NNF,0,0,0,2,2,3
AEV,0,0,0,6,6,3
EVG,0,0,0,1,1,3
KIR,0,0,0,2,2,3
RDS,0,0,0,1,1,3
MEL,0,0,0,2,2,3
GTV,0,0,0,1,1,3
TVI,0,0,0,3,3,3
IQH,0,0,0,1,1,3
QHE,0,0,0,4,4,3
HEG,0,0,0,1,1,3
EGI,0,0,0,5,5,3
IHQ,0,0,0,1,1,3
HQG,0,0,0,1,1,3
QGQ,0,0,0,2,2,3
GQY,0,0,0,1,1,3
QYY,0,0,0,2,2,3
YYV,0,0,0,1,1,3
QSG,0,0,0,1,1,3
IPA,0,0,0,2,2,3
PAA,0,0,0,2,2,3
KIN,0,0,0,1,1,3
INW,0,0,0,2,2,3
NWD,0,0,0,2,2,3
DRD,0,0,0,1,1,3
RDI,0,0,0,3,3,3
DIE,0,0,0,2,2,3
YMA,0,0,0,2,2,3
MAG,0,0,0,1,1,3
AGI,0,0,0,2,2,3
ILE,0,0,0,8,8,3
LEN,0,0,0,4,4,3
PAV,0,0,0,3,3,3
ANW,0,0,0,1,1,3
NWI,0,0,0,1,1,3
IPE,0,0,0,2,2,3
SFY,0,0,0,3,3,3
FYG,0,0,0,1,1,3
YGF,0,0,0,1,1,3
GFQ,0,0,0,1,1,3
FQI,0,0,0,1,1,3
QIM,0,0,0,1,1,3
IMI,0,0,0,1,1,3
MIE,0,0,0,1,1,3
ENI,0,0,0,3,3,3
IHS,0,0,0,1,1,3
HSE,0,0,0,1,1,3
ETY,0,0,0,2,2,3
TYS,0,0,0,2,2,3
YSL,0,0,0,2,2,3
TYI,0,0,0,1,1,3
RVN,0,0,0,2,2,3
NAT,0,0,0,1,1,3
ATK,0,0,0,1,1,3
TKA,0,0,0,3,3,3
YEM,0,0,0,1,1,3
MAL,0,0,0,2,2,3
ENH,0,0,0,2,2,3
NHK,0,0,0,1,1,3
KSH,0,0,0,1,1,3
DFE,0,0,0,2,2,3
FET,0,0,0,1,1,3
KLP,0,0,0,1,1,3
KMF,0,0,0,2,2,3
FED,0,0,0,3,3,3
EDR,0,0,0,1,1,3
KDT,0,0,0,1,1,3
DTV,0,0,0,2,2,3
IED,0,0,0,2,2,3
EDI,0,0,0,5,5,3
IID,0,0,0,3,3,3
DKT,0,0,0,1,1,3
TFE,0,0,0,1,1,3
KED,0,0,0,3,3,3
HRS,0,0,0,1,1,3
TKI,0,0,0,4,4,3
EEG,0,0,0,4,4,3
EGY,0,0,0,3,3,3
YFY,0,0,0,1,1,3
FYF,0,0,0,1,1,3
FRS,0,0,0,3,3,3
RSR,0,0,0,5,5,3
RLS,0,0,0,3,3,3
EVQ,0,0,0,6,6,3
VQK,0,0,0,2,2,3
EKM,0,0,0,3,3,3
MVE,0,0,0,2,2,3
GRM,0,0,0,2,2,3
RMK,0,0,0,2,2,3
KFT,0,0,0,1,1,3
FTG,0,0,0,1,1,3
GEV,0,0,0,1,1,3
KWE,0,0,0,2,2,3
WEG,0,0,0,1,1,3
GIW,0,0,0,1,1,3
IWA,0,0,0,2,2,3
WAT,0,0,0,2,2,3
ATF,0,0,0,2,2,3
FKP,0,0,0,1,1,3
KPA,0,0,0,1,1,3
LRF,0,0,0,2,2,3
RFI,0,0,0,3,3,3
FIL,0,0,0,2,2,3
WFK,0,0,0,1,1,3
VIF,0,0,0,3,3,3
NIV,0,0,0,6,6,3
IVA,0,0,0,2,2,3
IRI,0,0,0,2,2,3
RIW,0,0,0,3,3,3
WWV,0,0,0,1,1,3
WVI,0,0,0,2,2,3
GQE,0,0,0,1,1,3
QEY,0,0,0,1,1,3
EYI,0,0,0,3,3,3
YIN,0,0,0,2,2,3
NNI,0,0,0,2,2,3
KHF,0,0,0,2,2,3
HFD,0,0,0,1,1,3
EFN,0,0,0,2,2,3
FNA,0,0,0,1,1,3
NAK,0,0,0,3,3,3
KAN,0,0,0,1,1,3
KHH,0,0,0,1,1,3
HHA,0,0,0,1,1,3
YVN,0,0,0,2,2,3
NLN,0,0,0,3,3,3
NNA,0,0,0,2,2,3
NAL,0,0,0,3,3,3
IPD,0,0,0,1,1,3
PDD,0,0,0,1,1,3
QAD,0,0,0,3,3,3
ADF,0,0,0,3,3,3
DFN,0,0,0,1,1,3
FNK,0,0,0,2,2,3
NKF,0,0,0,2,2,3
TVV,0,0,0,3,3,3
VDQ,0,0,0,1,1,3
DQA,0,0,0,2,2,3
KDV,0,0,0,3,3,3
VKL,0,0,0,3,3,3
LET,0,0,0,4,4,3
TEA,0,0,0,2,2,3
QRS,0,0,0,1,1,3
NIL,0,0,0,5,5,3
ILT,0,0,0,5,5,3
KKQ,0,0,0,2,2,3
QEL,0,0,0,11,11,3
TKH,0,0,0,1,1,3
HFQ,0,0,0,1,1,3
KTA,0,0,0,2,2,3
IVE,0,0,0,3,3,3
VEM,0,0,0,1,1,3
DRF,0,0,0,1,1,3
YKR,0,0,0,1,1,3
KLD,0,0,0,1,1,3
DSR,0,0,0,1,1,3
SRF,0,0,0,2,2,3
RFD,0,0,0,2,2,3
FDN,0,0,0,1,1,3
DNN,0,0,0,1,1,3
FRF,0,0,0,1,1,3
RFV,0,0,0,2,2,3
LFV,0,0,0,7,7,3
EEK,0,0,0,3,3,3
AAT,0,0,0,6,6,3
KEL,0,0,0,7,7,3
LIF,0,0,0,1,1,3
IFI,0,0,0,1,1,3
NLV,0,0,0,6,6,3
NIK,0,0,0,1,1,3
NVE,0,0,0,2,2,3
VEK,0,0,0,2,2,3
QWD,0,0,0,1,1,3
WDE,0,0,0,1,1,3
ERT,0,0,0,2,2,3
RTR,0,0,0,1,1,3
KPE,0,0,0,3,3,3
EVE,0,0,0,3,3,3
VEQ,0,0,0,1,1,3
EQI,0,0,0,2,2,3
QIK,0,0,0,2,2,3
IKL,0,0,0,2,2,3
KLY,0,0,0,4,4,3
LYV,0,0,0,2,2,3
YVM,0,0,0,1,1,3
VMS,0,0,0,1,1,3
REY,0,0,0,1,1,3
EYE,0,0,0,2,2,3
EDY,0,0,0,3,3,3
DYM,0,0,0,2,2,3
MAR,0,0,0,2,2,3
PEQ,0,0,0,2,2,3
QYN,0,0,0,1,1,3
YNI,0,0,0,1,1,3
GEH,0,0,0,1,1,3
MFS,0,0,0,2,2,3
KPQ,0,0,0,2,2,3
PQE,0,0,0,2,2,3
RFE,0,0,0,3,3,3
RAD,0,0,0,1,1,3
KPW,0,0,0,1,1,3
PWL,0,0,0,2,2,3
WLS,0,0,0,1,1,3
IRE,0,0,0,8,8,3
ERS,0,0,0,2,2,3
EEF,0,0,0,5,5,3
EFV,0,0,0,2,2,3
FVQ,0,0,0,2,2,3
VQT,0,0,0,3,3,3
GQS,0,0,0,1,1,3
QSL,0,0,0,5,5,3
KRE,0,0,0,2,2,3
IIH,0,0,0,1,1,3
REV,0,0,0,3,3,3
QNA,0,0,0,5,5,3
TGI,0,0,0,2,2,3
GIQ,0,0,0,3,3,3
QLD,0,0,0,3,3,3
KSE,0,0,0,3,3,3
SEA,0,0,0,3,3,3
AKM,0,0,0,1,1,3
KMW,0,0,0,1,1,3
MWG,0,0,0,1,1,3
WGQ,0,0,0,1,1,3
TAS,0,0,0,1,1,3
DRR,0,0,0,1,1,3
RRE,0,0,0,4,4,3
REQ,0,0,0,3,3,3
RTT,0,0,0,2,2,3
EFE,0,0,0,1,1,3
FER,0,0,0,2,2,3
FRQ,0,0,0,3,3,3
KVN,0,0,0,2,2,3
NRA,0,0,0,2,2,3
EIR,0,0,0,5,5,3
RNW,0,0,0,2,2,3
NWT,0,0,0,1,1,3
WTW,0,0,0,1,1,3
TWV,0,0,0,1,1,3
WVF,0,0,0,2,2,3
VFL,0,0,0,2,2,3
TVY,0,0,0,2,2,3
VYN,0,0,0,1,1,3
YNS,0,0,0,1,1,3
VRG,0,0,0,1,1,3
LTV,0,0,0,4,4,3
RFY,0,0,0,2,2,3
FYR,0,0,0,2,2,3
VDN,0,0,0,2,2,3
NFE,0,0,0,3,3,3
FEN,0,0,0,3,3,3
KVW,0,0,0,2,2,3
VWK,0,0,0,1,1,3
WKG,0,0,0,1,1,3
GVK,0,0,0,2,2,3
VKT,0,0,0,2,2,3
KTI,0,0,0,3,3,3
ADV,0,0,0,2,2,3
DVW,0,0,0,1,1,3
VWQ,0,0,0,1,1,3
WQV,0,0,0,1,1,3
WEA,0,0,0,1,1,3
KIH,0,0,0,1,1,3
IHI,0,0,0,1,1,3
HIG,0,0,0,1,1,3
IGF,0,0,0,1,1,3
QAY,0,0,0,1,1,3
KWV,0,0,0,1,1,3
WVR,0,0,0,1,1,3
FVW,0,0,0,1,1,3
VWV,0,0,0,3,3,3
WVW,0,0,0,1,1,3
VWF,0,0,0,1,1,3
WFF,0,0,0,2,2,3
YDH,0,0,0,1,1,3
DHF,0,0,0,2,2,3
HFA,0,0,0,1,1,3
FAG,0,0,0,1,1,3
AGR,0,0,0,2,2,3
YVR,0,0,0,2,2,3
LHQ,0,0,0,2,2,3
HQD,0,0,0,1,1,3
QLY,0,0,0,1,1,3
YNG,0,0,0,1,1,3
AYI,0,0,0,2,2,3
LGN,0,0,0,1,1,3
GNV,0,0,0,1,1,3
RSK,0,0,0,1,1,3
KAW,0,0,0,3,3,3
WMV,0,0,0,1,1,3
MVD,0,0,0,1,1,3
VDA,0,0,0,3,3,3
KQF,0,0,0,2,2,3
QFK,0,0,0,2,2,3
FKD,0,0,0,2,2,3
DML,0,0,0,3,3,3
EFD,0,0,0,1,1,3
NVD,0,0,0,1,1,3
LEP,0,0,0,1,1,3
EPI,0,0,0,2,2,3
PIK,0,0,0,2,2,3
QVE,0,0,0,2,2,3
VEF,0,0,0,2,2,3
LNQ,0,0,0,3,3,3
NQL,0,0,0,4,4,3
LHD,0,0,0,1,1,3
AIH,0,0,0,2,2,3
IHM,0,0,0,2,2,3
HMA,0,0,0,1,1,3
MAA,0,0,0,4,4,3
NAV,0,0,0,2,2,3
LKY,0,0,0,3,3,3
KYV,0,0,0,2,2,3
YVG,0,0,0,1,1,3
VLN,0,0,0,3,3,3
NEA,0,0,0,1,1,3
REF,0,0,0,1,1,3
FIE,0,0,0,3,3,3
LLP,0,0,0,2,2,3
QQI,0,0,0,1,1,3
IGR,0,0,0,2,2,3
GRE,0,0,0,1,1,3
TEV,0,0,0,4,4,3
VET,0,0,0,3,3,3
YVL,0,0,0,1,1,3
MEP,0,0,0,1,1,3
EPV,0,0,0,1,1,3
MGH,0,0,0,1,1,3
GHQ,0,0,0,1,1,3
HQK,0,0,0,1,1,3
QKK,0,0,0,4,4,3
ILG,0,0,0,3,3,3
SIQ,0,0,0,2,2,3
TMR,0,0,0,1,1,3
NFS,0,0,0,1,1,3
FSR,0,0,0,3,3,3
SRY,0,0,0,2,2,3
YFL,0,0,0,1,1,3
HQS,0,0,0,1,1,3
QSR,0,0,0,2,2,3
ETE,0,0,0,1,1,3
TEH,0,0,0,1,1,3
HAE,0,0,0,2,2,3
LQN,0,0,0,3,3,3
QNQ,0,0,0,2,2,3
QRG,0,0,0,1,1,3
EDQ,0,0,0,2,2,3
LFQ,0,0,0,1,1,3
SLE,0,0,0,6,6,3
AYR,0,0,0,1,1,3
LPH,0,0,0,1,1,3
HFY,0,0,0,1,1,3
YEL,0,0,0,2,2,3
SLW,0,0,0,1,1,3
LPI,0,0,0,2,2,3
PIH,0,0,0,1,1,3
IHY,0,0,0,1,1,3
HYK,0,0,0,1,1,3
SQE,0,0,0,2,2,3
QEF,0,0,0,3,3,3
FFL,0,0,0,2,2,3
QAP,0,0,0,1,1,3
PLQ,0,0,0,1,1,3
QME,0,0,0,4,4,3
MEF,0,0,0,1,1,3
FKY,0,0,0,2,2,3
YLA,0,0,0,4,4,3
AII,0,0,0,3,3,3
FYT,0,0,0,1,1,3
YTE,0,0,0,2,2,3
TEY,0,0,0,2,2,3
EYY,0,0,0,2,2,3
LQW,0,0,0,2,2,3
QWY,0,0,0,1,1,3
WYV,0,0,0,2,2,3
VSE,0,0,0,4,4,3
HEE,0,0,0,2,2,3
FRG,0,0,0,2,2,3
ENM,0,0,0,2,2,3
NMI,0,0,0,1,1,3
MIK,0,0,0,3,3,3
RSW,0,0,0,1,1,3
SWF,0,0,0,2,2,3
WFR,0,0,0,1,1,3
VNL,0,0,0,1,1,3
TYF,0,0,0,1,1,3
YFM,0,0,0,2,2,3
RHY,0,0,0,1,1,3
HYR,0,0,0,1,1,3
QLS,0,0,0,1,1,3
LST,0,0,0,2,2,3
STV,0,0,0,1,1,3
TVS,0,0,0,2,2,3
VSN,0,0,0,1,1,3
SNF,0,0,0,2,2,3
NFF,0,0,0,2,2,3
FFM,0,0,0,1,1,3
FMN,0,0,0,1,1,3
MNA,0,0,0,2,2,3
MHV,0,0,0,1,1,3
HVM,0,0,0,2,2,3
VMQ,0,0,0,2,2,3
VLP,0,0,0,1,1,3
PIA,0,0,0,2,2,3
MEA,0,0,0,3,3,3
KQI,0,0,0,6,6,3
QIL,0,0,0,2,2,3
ILQ,0,0,0,3,3,3
LQI,0,0,0,1,1,3
QLW,0,0,0,2,2,3
LWE,0,0,0,1,1,3
WEK,0,0,0,1,1,3
EEY,0,0,0,3,3,3
MPE,0,0,0,1,1,3
PEV,0,0,0,6,6,3
FNY,0,0,0,2,2,3
YLG,0,0,0,2,2,3
LGI,0,0,0,5,5,3
GIY,0,0,0,1,1,3
IYL,0,0,0,1,1,3
MPG,0,0,0,1,1,3
PGT,0,0,0,1,1,3
GTA,0,0,0,2,2,3
TAT,0,0,0,2,2,3
ATH,0,0,0,1,1,3
THT,0,0,0,1,1,3
HTV,0,0,0,2,2,3
VKM,0,0,0,1,1,3
MPY,0,0,0,1,1,3
PYT,0,0,0,1,1,3
TDA,0,0,0,4,4,3
HEV,0,0,0,3,3,3
QRY,0,0,0,2,2,3
RYI,0,0,0,1,1,3
YID,0,0,0,1,1,3
MTD,0,0,0,1,1,3
TDQ,0,0,0,2,2,3
RAF,0,0,0,2,2,3
MVF,0,0,0,2,2,3
FKQ,0,0,0,1,1,3
AQF,0,0,0,2,2,3
MYS,0,0,0,1,1,3
YSN,0,0,0,1,1,3
RSY,0,0,0,1,1,3
YKQ,0,0,0,1,1,3
QEM,0,0,0,1,1,3
MGK,0,0,0,1,1,3
ETD,0,0,0,1,1,3
TDF,0,0,0,1,1,3
DFK,0,0,0,2,2,3
SRI,0,0,0,4,4,3
AGW,0,0,0,1,1,3
GWD,0,0,0,2,2,3
WDL,0,0,0,1,1,3
EIP,0,0,0,1,1,3
IPR,0,0,0,2,2,3
PRF,0,0,0,1,1,3
SYA,0,0,0,3,3,3
NAG,0,0,0,2,2,3
FFN,0,0,0,1,1,3
FNE,0,0,0,1,1,3
EFW,0,0,0,1,1,3
FWS,0,0,0,2,2,3
TGN,0,0,0,2,2,3
FIT,0,0,0,2,2,3
ITV,0,0,0,1,1,3
TVM,0,0,0,1,1,3
VMD,0,0,0,1,1,3
NAS,0,0,0,1,1,3
SRT,0,0,0,2,2,3
TVG,0,0,0,1,1,3
VGV,0,0,0,2,2,3
GVV,0,0,0,1,1,3
NDA,0,0,0,2,2,3
QYG,0,0,0,1,1,3
NDE,0,0,0,2,2,3
ETV,0,0,0,2,2,3
TAG,0,0,0,1,1,3
GGH,0,0,0,1,1,3
GHT,0,0,0,1,1,3
GLS,0,0,0,1,1,3
LSY,0,0,0,1,1,3
NEQ,0,0,0,3,3,3
EQD,0,0,0,3,3,3
QDL,0,0,0,4,4,3
IQY,0,0,0,2,2,3
YKA,0,0,0,2,2,3
LKP,0,0,0,1,1,3
EVD,0,0,0,1,1,3
NIM,0,0,0,2,2,3
AKR,0,0,0,4,4,3
NEY,0,0,0,2,2,3
YIM,0,0,0,1,1,3
IMS,0,0,0,1,1,3
MSL,0,0,0,1,1,3
NFK,0,0,0,3,3,3
TAK,0,0,0,3,3,3
KVM,0,0,0,1,1,3
VMN,0,0,0,3,3,3
MNF,0,0,0,1,1,3
GET,0,0,0,1,1,3
NID,0,0,0,2,2,3
DSY,0,0,0,2,2,3
VNI,0,0,0,2,2,3
NII,0,0,0,4,4,3
NIF,0,0,0,2,2,3
LWR,0,0,0,1,1,3
WRD,0,0,0,2,2,3
DYN,0,0,0,1,1,3
YNK,0,0,0,1,1,3
NKY,0,0,0,1,1,3
KYE,0,0,0,3,3,3
GIN,0,0,0,1,1,3
QIF,0,0,0,1,1,3
LFI,0,0,0,2,2,3
ISR,0,0,0,5,5,3
NIP,0,0,0,1,1,3
PKH,0,0,0,1,1,3
KHT,0,0,0,2,2,3
HTH,0,0,0,2,2,3
THR,0,0,0,1,1,3
HRF,0,0,0,1,1,3
FFI,0,0,0,2,2,3
ILV,0,0,0,4,4,3
NKD,0,0,0,1,1,3
KDQ,0,0,0,2,2,3
DQW,0,0,0,1,1,3
QWE,0,0,0,1,1,3
WEE,0,0,0,1,1,3
RIQ,0,0,0,3,3,3
QVW,0,0,0,1,1,3
VWH,0,0,0,2,2,3
WHE,0,0,0,1,1,3
NKE,0,0,0,2,2,3
EMM,0,0,0,1,1,3
MDI,0,0,0,1,1,3
IYD,0,0,0,1,1,3
YDM,0,0,0,1,1,3
DMM,0,0,0,1,1,3
MMG,0,0,0,2,2,3
NKL,0,0,0,3,3,3
VDR,0,0,0,3,3,3
DRW,0,0,0,1,1,3
RWL,0,0,0,5,5,3
LHV,0,0,0,1,1,3
HVR,0,0,0,1,1,3
KHL,0,0,0,3,3,3
YYN,0,0,0,1,1,3
YNL,0,0,0,2,2,3
NKQ,0,0,0,2,2,3
SIK,0,0,0,3,3,3
ERN,0,0,0,1,1,3
NKK,0,0,0,1,1,3
KTG,0,0,0,3,3,3
VDW,0,0,0,1,1,3
DWA,0,0,0,1,1,3
WAM,0,0,0,1,1,3
AMR,0,0,0,2,2,3
NKS,0,0,0,1,1,3
YAI,0,0,0,1,1,3
QEE,0,0,0,2,2,3
AWT,0,0,0,2,2,3
WTV,0,0,0,1,1,3
VSI,0,0,0,2,2,3
IAN,0,0,0,1,1,3
ANL,0,0,0,3,3,3
LEG,0,0,0,2,2,3
EQT,0,0,0,1,1,3
TAR,0,0,0,2,2,3
RRW,0,0,0,1,1,3
ERG,0,0,0,2,2,3
ESE,0,0,0,3,3,3
EIH,0,0,0,1,1,3
IHT,0,0,0,1,1,3
LKH,0,0,0,2,2,3
HLV,0,0,0,3,3,3
ENN,0,0,0,2,2,3
NLF,0,0,0,3,3,3
FDH,0,0,0,1,1,3
HFS,0,0,0,1,1,3
LFP,0,0,0,1,1,3
FPI,0,0,0,1,1,3
PIV,0,0,0,2,2,3
YDI,0,0,0,1,1,3
ENG,0,0,0,2,2,3
NQS,0,0,0,1,1,3
QSI,0,0,0,2,2,3
SID,0,0,0,3,3,3
IDN,0,0,0,1,1,3
FVN,0,0,0,1,1,3
NMA,0,0,0,1,1,3
MAF,0,0,0,1,1,3
FFA,0,0,0,1,1,3
NLS,0,0,0,1,1,3
NLT,0,0,0,1,1,3
DMR,0,0,0,1,1,3
RFN,0,0,0,2,2,3
RES,0,0,0,2,2,3
QVS,0,0,0,1,1,3
AIT,0,0,0,6,6,3
ITK,0,0,0,2,2,3
GFT,0,0,0,1,1,3
NPA,0,0,0,3,3,3
KMQ,0,0,0,1,1,3
MQV,0,0,0,2,2,3
RGK,0,0,0,1,1,3
EKG,0,0,0,2,2,3
PAQ,0,0,0,2,2,3
AQH,0,0,0,2,2,3
QTV,0,0,0,1,1,3
TVR,0,0,0,2,2,3
ENS,0,0,0,1,1,3
NPE,0,0,0,2,2,3
PEI,0,0,0,2,2,3
KRF,0,0,0,2,2,3
PER,0,0,0,2,2,3
YRY,0,0,0,1,1,3
RYD,0,0,0,1,1,3
YDV,0,0,0,2,2,3
NPG,0,0,0,1,1,3
AIW,0,0,0,3,3,3
IWL,0,0,0,2,2,3
WLG,0,0,0,1,1,3
GEF,0,0,0,1,1,3
EFS,0,0,0,2,2,3
SKR,0,0,0,1,1,3
NPM,0,0,0,1,1,3
PMI,0,0,0,1,1,3
MII,0,0,0,1,1,3
IEG,0,0,0,3,3,3
GQI,0,0,0,1,1,3
HGG,0,0,0,1,1,3
TEG,0,0,0,3,3,3
YAV,0,0,0,2,2,3
VAM,0,0,0,2,2,3
AMG,0,0,0,3,3,3
NPQ,0,0,0,1,1,3
DIG,0,0,0,2,2,3
GAE,0,0,0,1,1,3
NPR,0,0,0,1,1,3
PRW,0,0,0,2,2,3
WIG,0,0,0,1,1,3
GRH,0,0,0,1,1,3
HKH,0,0,0,1,1,3
KHM,0,0,0,1,1,3
HMF,0,0,0,1,1,3
MFN,0,0,0,1,1,3
FNF,0,0,0,1,1,3
NPV,0,0,0,1,1,3
PVL,0,0,0,2,2,3
QHF,0,0,0,2,2,3
HFR,0,0,0,1,1,3
FRN,0,0,0,1,1,3
RNL,0,0,0,3,3,3
NQD,0,0,0,1,1,3
QDE,0,0,0,3,3,3
GYN,0,0,0,1,1,3
KGS,0,0,0,1,1,3
GSG,0,0,0,1,1,3
NQP,0,0,0,1,1,3
QPF,0,0,0,1,1,3
PFA,0,0,0,1,1,3
LEM,0,0,0,3,3,3
KSR,0,0,0,2,2,3
SRQ,0,0,0,3,3,3
LQD,0,0,0,3,3,3
QDY,0,0,0,1,1,3
DYR,0,0,0,2,2,3
RQH,0,0,0,1,1,3
NRE,0,0,0,1,1,3
EAN,0,0,0,1,1,3
NLQ,0,0,0,1,1,3
NRK,0,0,0,1,1,3
RKM,0,0,0,2,2,3
KMA,0,0,0,1,1,3
MAM,0,0,0,1,1,3
MGR,0,0,0,2,2,3
RKK,0,0,0,1,1,3
KFN,0,0,0,1,1,3
FNM,0,0,0,1,1,3
NMD,0,0,0,1,1,3
NSD,0,0,0,1,1,3
SDQ,0,0,0,2,2,3
QDA,0,0,0,2,2,3
GIA,0,0,0,2,2,3
IIR,0,0,0,2,2,3
NSN,0,0,0,2,2,3
SNH,0,0,0,1,1,3
NHQ,0,0,0,1,1,3
HQM,0,0,0,1,1,3
SNT,0,0,0,2,2,3
NTF,0,0,0,1,1,3
VHM,0,0,0,1,1,3
REM,0,0,0,3,3,3
MFV,0,0,0,1,1,3
VQE,0,0,0,3,3,3
RYY,0,0,0,3,3,3
NSS,0,0,0,1,1,3
SSD,0,0,0,1,1,3
SDS,0,0,0,2,2,3
IDW,0,0,0,1,1,3
WLT,0,0,0,2,2,3
NSV,0,0,0,1,1,3
NTD,0,0,0,1,1,3
TDT,0,0,0,1,1,3
RVT,0,0,0,1,1,3
NTE,0,0,0,2,2,3
TEK,0,0,0,3,3,3
TVP,0,0,0,1,1,3
VPI,0,0,0,2,2,3
PII,0,0,0,1,1,3
IQN,0,0,0,3,3,3
NQM,0,0,0,1,1,3
QMD,0,0,0,1,1,3
NTP,0,0,0,1,1,3
TPE,0,0,0,8,8,3
AYS,0,0,0,1,1,3
YSV,0,0,0,1,1,3
WAE,0,0,0,2,2,3
VKH,0,0,0,1,1,3
VKD,0,0,0,2,2,3
KRT,0,0,0,1,1,3
DVT,0,0,0,1,1,3
WDD,0,0,0,2,2,3
DDM,0,0,0,1,1,3
KIW,0,0,0,3,3,3
WHH,0,0,0,1,1,3
TFY,0,0,0,2,2,3
FYN,0,0,0,2,2,3
NYA,0,0,0,3,3,3
YAH,0,0,0,1,1,3
NRG,0,0,0,1,1,3
IAL,0,0,0,1,1,3
LYY,0,0,0,1,1,3
YYG,0,0,0,2,2,3
NYE,0,0,0,2,2,3
IYI,0,0,0,1,1,3
YIL,0,0,0,3,3,3
ILN,0,0,0,3,3,3
NHI,0,0,0,1,1,3
YEK,0,0,0,1,1,3
KFS,0,0,0,1,1,3
TKE,0,0,0,2,2,3
KER,0,0,0,4,4,3
PAE,0,0,0,2,2,3
YYR,0,0,0,1,1,3
YRD,0,0,0,1,1,3
RDA,0,0,0,3,3,3
RIT,0,0,0,1,1,3
YVE,0,0,0,1,1,3
KYI,0,0,0,2,2,3
PDE,0,0,0,1,1,3
EVS,0,0,0,1,1,3
RRT,0,0,0,3,3,3
TTE,0,0,0,1,1,3
NTT,0,0,0,1,1,3
TTL,0,0,0,1,1,3
PDF,0,0,0,1,1,3
DFR,0,0,0,1,1,3
PDI,0,0,0,1,1,3
QYQ,0,0,0,1,1,3
QRW,0,0,0,1,1,3
PDY,0,0,0,1,1,3
EVM,0,0,0,2,2,3
VME,0,0,0,4,4,3
MET,0,0,0,1,1,3
TFQ,0,0,0,1,1,3
FQE,0,0,0,1,1,3
RDR,0,0,0,2,2,3
IQS,0,0,0,3,3,3
QSD,0,0,0,2,2,3
DAQ,0,0,0,1,1,3
VAP,0,0,0,1,1,3
APM,0,0,0,1,1,3
PMT,0,0,0,1,1,3
MTT,0,0,0,1,1,3
EDF,0,0,0,1,1,3
FAN,0,0,0,2,2,3
ANH,0,0,0,1,1,3
NHL,0,0,0,2,2,3
LFT,0,0,0,2,2,3
FTV,0,0,0,1,1,3
AVT,0,0,0,2,2,3
GIK,0,0,0,2,2,3
VQI,0,0,0,1,1,3
QIA,0,0,0,1,1,3
TEQ,0,0,0,3,3,3
QIN,0,0,0,2,2,3
NEH,0,0,0,1,1,3
PEY,0,0,0,1,1,3
YEH,0,0,0,1,1,3
HLY,0,0,0,1,1,3
LYT,0,0,0,3,3,3
TGT,0,0,0,1,1,3
GTI,0,0,0,2,2,3
WKR,0,0,0,1,1,3
PGR,0,0,0,1,1,3
IQR,0,0,0,1,1,3
QRV,0,0,0,3,3,3
RGS,0,0,0,1,1,3
FIH,0,0,0,2,2,3
IHK,0,0,0,1,1,3
PID,0,0,0,1,1,3
IDI,0,0,0,1,1,3
DID,0,0,0,2,2,3
IDY,0,0,0,2,2,3
YMI,0,0,0,3,3,3
SDT,0,0,0,2,2,3
PIE,0,0,0,1,1,3
RLN,0,0,0,2,2,3
FIR,0,0,0,1,1,3
IRK,0,0,0,2,2,3
PKA,0,0,0,1,1,3
QHV,0,0,0,2,2,3
HVF,0,0,0,1,1,3
VFR,0,0,0,2,2,3
PKP,0,0,0,1,1,3
PLV,0,0,0,2,2,3
VSF,0,0,0,2,2,3
SFF,0,0,0,2,2,3
FFQ,0,0,0,1,1,3
VNH,0,0,0,2,2,3
NHD,0,0,0,1,1,3
EQQ,0,0,0,2,2,3
PLE,0,0,0,1,1,3
PLG,0,0,0,2,2,3
HMV,0,0,0,1,1,3
NQK,0,0,0,1,1,3
PLT,0,0,0,1,1,3
LGF,0,0,0,1,1,3
FVF,0,0,0,1,1,3
PND,0,0,0,1,1,3
RIF,0,0,0,4,4,3
FNI,0,0,0,1,1,3
KES,0,0,0,2,2,3
PNG,0,0,0,1,1,3
NGP,0,0,0,1,1,3
GPT,0,0,0,1,1,3
PTH,0,0,0,1,1,3
THA,0,0,0,2,2,3
HAP,0,0,0,1,1,3
APW,0,0,0,1,1,3
AHK,0,0,0,1,1,3
HKI,0,0,0,1,1,3
PQH,0,0,0,1,1,3
HER,0,0,0,1,1,3
ERD,0,0,0,2,2,3
RDV,0,0,0,1,1,3
PQS,0,0,0,1,1,3
QSY,0,0,0,1,1,3
QES,0,0,0,3,3,3
PQY,0,0,0,2,2,3
QYA,0,0,0,3,3,3
YAL,0,0,0,4,4,3
YAW,0,0,0,2,2,3
AWE,0,0,0,2,2,3
WEQ,0,0,0,1,1,3
QGS,0,0,0,2,2,3
QYS,0,0,0,2,2,3
YSQ,0,0,0,1,1,3
RVM,0,0,0,3,3,3
VML,0,0,0,2,2,3
TIS,0,0,0,2,2,3
ISM,0,0,0,1,1,3
SMI,0,0,0,1,1,3
VDD,0,0,0,2,2,3
DDT,0,0,0,1,1,3
DTF,0,0,0,1,1,3
TFD,0,0,0,1,1,3
PRE,0,0,0,1,1,3
PRR,0,0,0,1,1,3
RRQ,0,0,0,2,2,3
QQS,0,0,0,2,2,3
LRW,0,0,0,1,1,3
WLV,0,0,0,1,1,3
PSA,0,0,0,1,1,3
IDQ,0,0,0,2,2,3
EIN,0,0,0,2,2,3
QRF,0,0,0,5,5,3
PSD,0,0,0,2,2,3
NEM,0,0,0,2,2,3
PSF,0,0,0,1,1,3
HKY,0,0,0,1,1,3
KYM,0,0,0,1,1,3
YMD,0,0,0,1,1,3
MDN,0,0,0,1,1,3
DNI,0,0,0,2,2,3
HTD,0,0,0,1,1,3
PSS,0,0,0,1,1,3
SSQ,0,0,0,3,3,3
QIV,0,0,0,2,2,3
VGT,0,0,0,1,1,3
GTQ,0,0,0,1,1,3
NVM,0,0,0,1,1,3
PSV,0,0,0,1,1,3
SVV,0,0,0,1,1,3
NTV,0,0,0,2,2,3
KGG,0,0,0,1,1,3
QVI,0,0,0,4,4,3
PTL,0,0,0,2,2,3
IGH,0,0,0,1,1,3
EFQ,0,0,0,1,1,3
FQA,0,0,0,1,1,3
PVS,0,0,0,1,1,3
TMD,0,0,0,1,1,3
MDM,0,0,0,1,1,3
MLT,0,0,0,1,1,3
PWT,0,0,0,1,1,3
WTQ,0,0,0,2,2,3
TQR,0,0,0,2,2,3
FES,0,0,0,3,3,3
SFG,0,0,0,1,1,3
ASM,0,0,0,2,2,3
SMF,0,0,0,1,1,3
MFW,0,0,0,1,1,3
FWL,0,0,0,3,3,3
HFE,0,0,0,1,1,3
WVA,0,0,0,1,1,3
AVS,0,0,0,4,4,3
SEH,0,0,0,1,1,3
EHQ,0,0,0,2,2,3
HQR,0,0,0,1,1,3
RFT,0,0,0,1,1,3
TGS,0,0,0,1,1,3
QDD,0,0,0,1,1,3
DDV,0,0,0,2,2,3
LVW,0,0,0,1,1,3
VWG,0,0,0,1,1,3
WGA,0,0,0,3,3,3
AYW,0,0,0,2,2,3
YWL,0,0,0,1,1,3
WLY,0,0,0,1,1,3
LYK,0,0,0,1,1,3
AAH,0,0,0,3,3,3
HAY,0,0,0,1,1,3
WSQ,0,0,0,1,1,3
EWV,0,0,0,1,1,3
WVE,0,0,0,1,1,3
QFR,0,0,0,1,1,3
RGA,0,0,0,1,1,3
FKF,0,0,0,1,1,3
KFE,0,0,0,1,1,3
ELG,0,0,0,3,3,3
QFS,0,0,0,2,2,3
DRK,0,0,0,1,1,3
WSL,0,0,0,2,2,3
MKI,0,0,0,2,2,3
KQT,0,0,0,1,1,3
QTN,0,0,0,1,1,3
TNA,0,0,0,1,1,3
AGA,0,0,0,1,1,3
VYR,0,0,0,2,2,3
EMH,0,0,0,1,1,3
IQQ,0,0,0,3,3,3
QIP,0,0,0,1,1,3
PRI,0,0,0,2,2,3
MLY,0,0,0,1,1,3
GVG,0,0,0,1,1,3
VTQ,0,0,0,2,2,3
LQH,0,0,0,2,2,3
HVK,0,0,0,1,1,3
DQS,0,0,0,1,1,3
QSW,0,0,0,1,1,3
SWQ,0,0,0,2,2,3
YYQ,0,0,0,1,1,3
YQD,0,0,0,1,1,3
QDR,0,0,0,1,1,3
RVV,0,0,0,2,2,3
VVI,0,0,0,2,2,3
QMS,0,0,0,2,2,3
SFW,0,0,0,1,1,3
FWG,0,0,0,1,1,3
GAT,0,0,0,1,1,3
VIT,0,0,0,1,1,3
QPN,0,0,0,1,1,3
PNA,0,0,0,1,1,3
LYM,0,0,0,1,1,3
MIT,0,0,0,2,2,3
ITM,0,0,0,1,1,3
QTR,0,0,0,1,1,3
RQI,0,0,0,1,1,3
AWV,0,0,0,1,1,3
WVK,0,0,0,2,2,3
KRI,0,0,0,2,2,3
IEV,0,0,0,2,2,3
LNK,0,0,0,2,2,3
KQV,0,0,0,2,2,3
ADW,0,0,0,1,1,3
DWS,0,0,0,1,1,3
WSV,0,0,0,1,1,3
HNF,0,0,0,2,2,3
NFH,0,0,0,2,2,3
FHW,0,0,0,1,1,3
HWY,0,0,0,1,1,3
QVT,0,0,0,1,1,3
TQE,0,0,0,1,1,3
MKE,0,0,0,1,1,3
AYK,0,0,0,3,3,3
YKS,0,0,0,3,3,3
IWG,0,0,0,1,1,3
RVG,0,0,0,1,1,3
DIP,0,0,0,1,1,3
PEL,0,0,0,1,1,3
QSE,0,0,0,2,2,3
QAF,0,0,0,3,3,3
IYP,0,0,0,1,1,3
YPV,0,0,0,1,1,3
LSE,0,0,0,3,3,3
EGF,0,0,0,1,1,3
LSP,0,0,0,1,1,3
SPL,0,0,0,1,1,3
YLI,0,0,0,1,1,3
ESQ,0,0,0,2,2,3
RVY,0,0,0,1,1,3
VYH,0,0,0,1,1,3
YHP,0,0,0,1,1,3
VQP,0,0,0,1,1,3
QPL,0,0,0,1,1,3
NRW,0,0,0,1,1,3
DLT,0,0,0,2,2,3
IVW,0,0,0,2,2,3
FFW,0,0,0,2,2,3
VPR,0,0,0,1,1,3
RWR,0,0,0,1,1,3
WRT,0,0,0,2,2,3
VGQ,0,0,0,1,1,3
GQF,0,0,0,1,1,3
KRD,0,0,0,1,1,3
LVI,0,0,0,2,2,3
RGE,0,0,0,2,2,3
GEQ,0,0,0,2,2,3
MKG,0,0,0,2,2,3
KGH,0,0,0,1,1,3
TIE,0,0,0,3,3,3
DQV,0,0,0,1,1,3
RRM,0,0,0,1,1,3
RMI,0,0,0,1,1,3
RGF,0,0,0,1,1,3
RGW,0,0,0,1,1,3
GWW,0,0,0,1,1,3
STI,0,0,0,2,2,3
RGQ,0,0,0,1,1,3
LDF,0,0,0,3,3,3
DFI,0,0,0,1,1,3
HGI,0,0,0,1,1,3
LRK,0,0,0,3,3,3
YRH,0,0,0,1,1,3
NFD,0,0,0,1,1,3
FDS,0,0,0,1,1,3
DSW,0,0,0,1,1,3
SWW,0,0,0,1,1,3
WWG,0,0,0,1,1,3
WGK,0,0,0,1,1,3
VIV,0,0,0,2,2,3
IVI,0,0,0,2,2,3
QWI,0,0,0,2,2,3
WII,0,0,0,2,2,3
VWW,0,0,0,1,1,3
WAR,0,0,0,1,1,3
LQG,0,0,0,3,3,3
VFW,0,0,0,2,2,3
RKQ,0,0,0,2,2,3
QFY,0,0,0,1,1,3
FYY,0,0,0,1,1,3
EAS,0,0,0,1,1,3
SAR,0,0,0,3,3,3
ARS,0,0,0,2,2,3
RSG,0,0,0,2,2,3
SGI,0,0,0,1,1,3
EHY,0,0,0,1,1,3
SGW,0,0,0,1,1,3
WSA,0,0,0,1,1,3
NVR,0,0,0,2,2,3
VRF,0,0,0,1,1,3
LVV,0,0,0,2,2,3
LTN,0,0,0,4,4,3
TNF,0,0,0,2,2,3
FLN,0,0,0,1,1,3
LWT,0,0,0,1,1,3
TQW,0,0,0,1,1,3
IVQ,0,0,0,1,1,3
IRF,0,0,0,1,1,3
RMD,0,0,0,1,1,3
TLQ,0,0,0,1,1,3
QEN,0,0,0,1,1,3
NLR,0,0,0,2,2,3
EYD,0,0,0,1,1,3
YDQ,0,0,0,1,1,3
QQT,0,0,0,2,2,3
RNE,0,0,0,1,1,3
VVS,0,0,0,2,2,3
VSL,0,0,0,3,3,3
RPE,0,0,0,2,2,3
DKS,0,0,0,1,1,3
KSK,0,0,0,1,1,3
SKI,0,0,0,2,2,3
VQD,0,0,0,1,1,3
RPQ,0,0,0,1,1,3
HEK,0,0,0,1,1,3
RPR,0,0,0,1,1,3
WHY,0,0,0,2,2,3
HYV,0,0,0,1,1,3
YVK,0,0,0,1,1,3
NVI,0,0,0,2,2,3
VIP,0,0,0,1,1,3
LTW,0,0,0,1,1,3
TWW,0,0,0,1,1,3
AIP,0,0,0,1,1,3
IPN,0,0,0,2,2,3
PNI,0,0,0,1,1,3
IIV,0,0,0,1,1,3
VWR,0,0,0,3,3,3
WRW,0,0,0,2,2,3
WIV,0,0,0,1,1,3
VKW,0,0,0,1,1,3
KWW,0,0,0,1,1,3
RYG,0,0,0,1,1,3
YGW,0,0,0,1,1,3
VDY,0,0,0,1,1,3
DYS,0,0,0,2,2,3
WFG,0,0,0,1,1,3
AMT,0,0,0,1,1,3
WQK,0,0,0,1,1,3
MVQ,0,0,0,2,2,3
VND,0,0,0,1,1,3
EGM,0,0,0,1,1,3
GME,0,0,0,1,1,3
SAN,0,0,0,1,1,3
IQM,0,0,0,1,1,3
QMQ,0,0,0,2,2,3
SQN,0,0,0,2,2,3
NAW,0,0,0,1,1,3
ANR,0,0,0,1,1,3
ESK,0,0,0,3,3,3
SDE,0,0,0,2,2,3
FNT,0,0,0,1,1,3
VTF,0,0,0,1,1,3
TFG,0,0,0,1,1,3
FGD,0,0,0,1,1,3
GDS,0,0,0,1,1,3
FLQ,0,0,0,1,1,3
LDH,0,0,0,1,1,3
DHI,0,0,0,2,2,3
LSR,0,0,0,2,2,3
WEV,0,0,0,1,1,3
NKN,0,0,0,1,1,3
KNM,0,0,0,1,1,3
NMR,0,0,0,1,1,3
RAH,0,0,0,1,1,3
NWF,0,0,0,1,1,3
VVT,0,0,0,1,1,3
NER,0,0,0,1,1,3
WYL,0,0,0,1,1,3
KGR,0,0,0,1,1,3
SQF,0,0,0,1,1,3
QFI,0,0,0,1,1,3
AYM,0,0,0,2,2,3
YMK,0,0,0,1,1,3
EYQ,0,0,0,2,2,3
YQM,0,0,0,1,1,3
MSG,0,0,0,2,2,3
SGN,0,0,0,1,1,3
GNE,0,0,0,1,1,3
EQW,0,0,0,2,2,3
SKT,0,0,0,1,1,3
SEE,0,0,0,5,5,3
EEN,0,0,0,2,2,3
NNV,0,0,0,1,1,3
NSA,0,0,0,2,2,3
SAW,0,0,0,2,2,3
WTI,0,0,0,1,1,3
IAY,0,0,0,2,2,3
EMD,0,0,0,1,1,3
MDD,0,0,0,1,1,3
IRS,0,0,0,2,2,3
MVS,0,0,0,1,1,3
SES,0,0,0,3,3,3
VSH,0,0,0,1,1,3
SHQ,0,0,0,1,1,3
QFT,0,0,0,1,1,3
FTD,0,0,0,1,1,3
FDR,0,0,0,1,1,3
GTR,0,0,0,1,1,3
TRD,0,0,0,1,1,3
GAR,0,0,0,1,1,3
TEN,0,0,0,1,1,3
SGD,0,0,0,1,1,3
GDE,0,0,0,1,1,3
KQR,0,0,0,1,1,3
RDH,0,0,0,1,1,3
DHH,0,0,0,2,2,3
SGP,0,0,0,1,1,3
PAY,0,0,0,1,1,3
YVF,0,0,0,2,2,3
VFY,0,0,0,2,2,3
FYL,0,0,0,2,2,3
SGR,0,0,0,1,1,3
RFW,0,0,0,1,1,3
FWK,0,0,0,3,3,3
SGT,0,0,0,1,1,3
MEM,0,0,0,1,1,3
HAQ,0,0,0,1,1,3
AQD,0,0,0,1,1,3
QDI,0,0,0,4,4,3
IYK,0,0,0,1,1,3
YKE,0,0,0,2,2,3
AFN,0,0,0,1,1,3
FNS,0,0,0,1,1,3
AWD,0,0,0,1,1,3
WDQ,0,0,0,1,1,3
DQY,0,0,0,1,1,3
MES,0,0,0,2,2,3
SIP,0,0,0,1,1,3
IPH,0,0,0,1,1,3
PHL,0,0,0,1,1,3
RYK,0,0,0,1,1,3
IEW,0,0,0,1,1,3
EWL,0,0,0,1,1,3
YIA,0,0,0,2,2,3
LML,0,0,0,1,1,3
SYF,0,0,0,1,1,3
FMA,0,0,0,1,1,3
MAT,0,0,0,1,1,3
SLH,0,0,0,1,1,3
AMK,0,0,0,1,1,3
MKL,0,0,0,1,1,3
VER,0,0,0,2,2,3
ARN,0,0,0,1,1,3
NWV,0,0,0,1,1,3
EQR,0,0,0,3,3,3
DYV,0,0,0,3,3,3
NYR,0,0,0,1,1,3
AIM,0,0,0,1,1,3
SKP,0,0,0,1,1,3
KPI,0,0,0,1,1,3
PIQ,0,0,0,1,1,3
QNV,0,0,0,1,1,3
ESG,0,0,0,2,2,3
SGF,0,0,0,2,2,3
GFI,0,0,0,1,1,3
FIF,0,0,0,2,2,3
IFA,0,0,0,2,2,3
AQQ,0,0,0,1,1,3
FVS,0,0,0,1,1,3
SEG,0,0,0,1,1,3
EGS,0,0,0,1,1,3
RSF,0,0,0,1,1,3
FAT,0,0,0,1,1,3
TQV,0,0,0,1,1,3
IDM,0,0,0,1,1,3
TSI,0,0,0,1,1,3
MFD,0,0,0,1,1,3
DKM,0,0,0,1,1,3
MRP,0,0,0,1,1,3
RPY,0,0,0,1,1,3
PYY,0,0,0,1,1,3
YYE,0,0,0,1,1,3
SMD,0,0,0,1,1,3
MDH,0,0,0,1,1,3
DHR,0,0,0,1,1,3
YYI,0,0,0,3,3,3
SNE,0,0,0,3,3,3
RQD,0,0,0,1,1,3
FAY,0,0,0,1,1,3
AYQ,0,0,0,1,1,3
YQR,0,0,0,2,2,3
RTK,0,0,0,1,1,3
MRI,0,0,0,1,1,3
DGR,0,0,0,1,1,3
SME,0,0,0,1,1,3
TNN,0,0,0,1,1,3
SPA,0,0,0,4,4,3
DLD,0,0,0,1,1,3
DAS,0,0,0,1,1,3
SKV,0,0,0,1,1,3
RYR,0,0,0,1,1,3
RDN,0,0,0,1,1,3
VQM,0,0,0,1,1,3
YRR,0,0,0,1,1,3
SPE,0,0,0,6,6,3
EWM,0,0,0,1,1,3
WMK,0,0,0,1,1,3
MKS,0,0,0,3,3,3
PEH,0,0,0,1,1,3
EHR,0,0,0,1,1,3
HRQ,0,0,0,1,1,3
ASG,0,0,0,1,1,3
SPK,0,0,0,3,3,3
PKE,0,0,0,2,2,3
YAY,0,0,0,1,1,3
YLE,0,0,0,2,2,3
QYT,0,0,0,1,1,3
SEV,0,0,0,2,2,3
PKS,0,0,0,1,1,3
STY,0,0,0,1,1,3
YSY,0,0,0,1,1,3
SYW,0,0,0,1,1,3
WAS,0,0,0,2,2,3
SPS,0,0,0,1,1,3
PSK,0,0,0,1,1,3
QMI,0,0,0,1,1,3
MIL,0,0,0,1,1,3
GDF,0,0,0,1,1,3
PVV,0,0,0,1,1,3
INQ,0,0,0,1,1,3
LVY,0,0,0,1,1,3
VYM,0,0,0,1,1,3
YMG,0,0,0,1,1,3
RQR,0,0,0,1,1,3
RSN,0,0,0,1,1,3
ITQ,0,0,0,1,1,3
TQY,0,0,0,2,2,3
FDT,0,0,0,1,1,3
TRV,0,0,0,1,1,3
SRD,0,0,0,1,1,3
RHM,0,0,0,1,1,3
HME,0,0,0,1,1,3
IEL,0,0,0,2,2,3
GNI,0,0,0,2,2,3
MAV,0,0,0,1,1,3
SRP,0,0,0,1,1,3
RPL,0,0,0,1,1,3
PLH,0,0,0,2,2,3
LHI,0,0,0,1,1,3
HIS,0,0,0,1,1,3
STF,0,0,0,2,2,3
TFI,0,0,0,1,1,3
RWG,0,0,0,1,1,3
WGV,0,0,0,1,1,3
VLI,0,0,0,1,1,3
QNW,0,0,0,1,1,3
NWQ,0,0,0,2,2,3
WQR,0,0,0,1,1,3
YQL,0,0,0,1,1,3
SMH,0,0,0,1,1,3
MHE,0,0,0,1,1,3
SSR,0,0,0,1,1,3
REW,0,0,0,2,2,3
EWF,0,0,0,1,1,3
WFS,0,0,0,1,1,3
FIG,0,0,0,1,1,3
STA,0,0,0,1,1,3
FYD,0,0,0,1,1,3
STE,0,0,0,1,1,3
QDM,0,0,0,1,1,3
MLW,0,0,0,1,1,3
LWQ,0,0,0,1,1,3
WQL,0,0,0,1,1,3
QTP,0,0,0,1,1,3
TPA,0,0,0,2,2,3
VSV,0,0,0,1,1,3
ADH,0,0,0,1,1,3
DHS,0,0,0,1,1,3
YRV,0,0,0,1,1,3
SVE,0,0,0,4,4,3
VGY,0,0,0,3,3,3
GYY,0,0,0,1,1,3
KVP,0,0,0,2,2,3
VPL,0,0,0,1,1,3
HSF,0,0,0,1,1,3
ELW,0,0,0,2,2,3
LWS,0,0,0,2,2,3
WST,0,0,0,1,1,3
TFM,0,0,0,1,1,3
QKW,0,0,0,1,1,3
AYT,0,0,0,2,2,3
YTA,0,0,0,1,1,3
IDA,0,0,0,1,1,3
NHH,0,0,0,1,1,3
HHL,0,0,0,1,1,3
VGF,0,0,0,1,1,3
NSE,0,0,0,1,1,3
SFK,0,0,0,2,2,3
SVP,0,0,0,1,1,3
VPY,0,0,0,1,1,3
PYF,0,0,0,1,1,3
YFI,0,0,0,1,1,3
NLK,0,0,0,1,1,3
SVR,0,0,0,1,1,3
RIK,0,0,0,1,1,3
SVS,0,0,0,2,2,3
SVW,0,0,0,1,1,3
VWA,0,0,0,1,1,3
WQS,0,0,0,1,1,3
DRY,0,0,0,1,1,3
YKD,0,0,0,1,1,3
IKD,0,0,0,1,1,3
AQE,0,0,0,3,3,3
LMI,0,0,0,1,1,3
MIQ,0,0,0,1,1,3
QII,0,0,0,1,1,3
INF,0,0,0,1,1,3
SRN,0,0,0,1,1,3
YNQ,0,0,0,1,1,3
NQG,0,0,0,1,1,3
QGI,0,0,0,1,1,3
GIR,0,0,0,1,1,3
HEA,0,0,0,1,1,3
TGR,0,0,0,1,1,3
QIQ,0,0,0,2,2,3
ENE,0,0,0,1,1,3
TAP,0,0,0,1,1,3
EMT,0,0,0,1,1,3
GGM,0,0,0,1,1,3
GMR,0,0,0,1,1,3
MRV,0,0,0,1,1,3
TDK,0,0,0,1,1,3
DKQ,0,0,0,1,1,3
QFE,0,0,0,2,2,3
NDN,0,0,0,1,1,3
TDL,0,0,0,1,1,3
QQK,0,0,0,2,2,3
QGD,0,0,0,1,1,3
GDA,0,0,0,3,3,3
DAF,0,0,0,2,2,3
TEE,0,0,0,1,1,3
AHI,0,0,0,1,1,3
HIT,0,0,0,2,2,3
IFG,0,0,0,1,1,3
IDL,0,0,0,1,1,3
LKF,0,0,0,1,1,3
FAI,0,0,0,1,1,3
EQN,0,0,0,1,1,3
QNF,0,0,0,1,1,3
NFQ,0,0,0,1,1,3
FQL,0,0,0,1,1,3
QSQ,0,0,0,1,1,3
SQW,0,0,0,1,1,3
QWK,0,0,0,1,1,3
WKE,0,0,0,1,1,3
EFG,0,0,0,1,1,3
TES,0,0,0,1,1,3
SMK,0,0,0,1,1,3
TET,0,0,0,2,2,3
ETQ,0,0,0,2,2,3
TQI,0,0,0,1,1,3
FDL,0,0,0,2,2,3
FYA,0,0,0,1,1,3
YQI,0,0,0,1,1,3
NRV,0,0,0,1,1,3
TFP,0,0,0,3,3,3
FPD,0,0,0,1,1,3
PDK,0,0,0,1,1,3
DKA,0,0,0,3,3,3
PEW,0,0,0,1,1,3
EWH,0,0,0,1,1,3
WHR,0,0,0,2,2,3
TVQ,0,0,0,1,1,3
VQF,0,0,0,1,1,3
RRH,0,0,0,1,1,3
PNW,0,0,0,1,1,3
NWH,0,0,0,1,1,3
MED,0,0,0,1,1,3
TFS,0,0,0,1,1,3
FSQ,0,0,0,1,1,3
SQV,0,0,0,1,1,3
RTQ,0,0,0,2,2,3
QYD,0,0,0,1,1,3
DVS,0,0,0,2,2,3
MTV,0,0,0,1,1,3
MLH,0,0,0,1,1,3
THN,0,0,0,1,1,3
HNK,0,0,0,1,1,3
AFM,0,0,0,1,1,3
FMK,0,0,0,1,1,3
KEH,0,0,0,1,1,3
HQE,0,0,0,1,1,3
EFH,0,0,0,1,1,3
HSK,0,0,0,1,1,3
QEA,0,0,0,1,1,3
TIQ,0,0,0,1,1,3
AWG,0,0,0,1,1,3
WGL,0,0,0,1,1,3
AHV,0,0,0,1,1,3
TEM,0,0,0,1,1,3
VYK,0,0,0,1,1,3
SGG,0,0,0,1,1,3
RWF,0,0,0,1,1,3
FLV,0,0,0,2,2,3
VIW,0,0,0,1,1,3
IWV,0,0,0,1,1,3
WVL,0,0,0,1,1,3
VLW,0,0,0,1,1,3
TKD,0,0,0,2,2,3
KDE,0,0,0,2,2,3
EFM,0,0,0,1,1,3
FMS,0,0,0,1,1,3
SGE,0,0,0,1,1,3
GEP,0,0,0,1,1,3
PIF,0,0,0,1,1,3
IFT,0,0,0,1,1,3
TKY,0,0,0,1,1,3
KYF,0,0,0,1,1,3
FQN,0,0,0,1,1,3
QNL,0,0,0,2,2,3
KGE,0,0,0,1,1,3
MIV,0,0,0,1,1,3
RTG,0,0,0,1,1,3
TGK,0,0,0,1,1,3
VPA,0,0,0,1,1,3
DQM,0,0,0,1,1,3
YDG,0,0,0,1,1,3
VRY,0,0,0,1,1,3
YVT,0,0,0,1,1,3
LDM,0,0,0,1,1,3
WGD,0,0,0,1,1,3
RYM,0,0,0,1,1,3
YMT,0,0,0,1,1,3
ITD,0,0,0,2,2,3
KND,0,0,0,1,1,3
PAK,0,0,0,1,1,3
TPD,0,0,0,1,1,3
PDQ,0,0,0,1,1,3
LHF,0,0,0,1,1,3
IMD,0,0,0,1,1,3
SYN,0,0,0,1,1,3
KHY,0,0,0,1,1,3
HYE,0,0,0,1,1,3
VED,0,0,0,1,1,3
QTY,0,0,0,1,1,3
QVD,0,0,0,1,1,3
KMG,0,0,0,2,2,3
RVD,0,0,0,1,1,3
DRI,0,0,0,1,1,3
THY,0,0,0,1,1,3
HYL,0,0,0,1,1,3
TVN,0,0,0,1,1,3
HAM,0,0,0,1,1,3
TPL,0,0,0,1,1,3
GIT,0,0,0,1,1,3
TDY,0,0,0,1,1,3
DYY,0,0,0,1,1,3
TPQ,0,0,0,1,1,3
PQD,0,0,0,1,1,3
TPS,0,0,0,1,1,3
PVY,0,0,0,1,1,3
IRY,0,0,0,1,1,3
YYL,0,0,0,1,1,3
MLF,0,0,0,1,1,3
TPW,0,0,0,1,1,3
PWS,0,0,0,1,1,3
TPY,0,0,0,1,1,3
PYD,0,0,0,1,1,3
QET,0,0,0,1,1,3
TQG,0,0,0,3,3,3
TQD,0,0,0,1,1,3
RSH,0,0,0,1,1,3
AIF,0,0,0,1,1,3
QGM,0,0,0,1,1,3
MQN,0,0,0,1,1,3
SSE,0,0,0,1,1,3
SEK,0,0,0,1,1,3
TQS,0,0,0,1,1,3
DVY,0,0,0,1,1,3
GYI,0,0,0,1,1,3
YIH,0,0,0,1,1,3
TRT,0,0,0,1,1,3
SAQ,0,0,0,2,2,3
QTK,0,0,0,1,1,3
EYV,0,0,0,1,1,3
TSH,0,0,0,1,1,3
MGM,0,0,0,1,1,3
GMF,0,0,0,1,1,3
MFY,0,0,0,1,1,3
IRM,0,0,0,1,1,3
RMM,0,0,0,1,1,3
MME,0,0,0,1,1,3
MEN,0,0,0,1,1,3
TTD,0,0,0,1,1,3
TDE,0,0,0,1,1,3
AMD,0,0,0,1,1,3
MDK,0,0,0,1,1,3
YMR,0,0,0,1,1,3
TVE,0,0,0,1,1,3
NEI,0,0,0,1,1,3
KAH,0,0,0,1,1,3
FGT,0,0,0,1,1,3
NYV,0,0,0,1,1,3
TYY,0,0,0,1,1,3
YAK,0,0,0,2,2,3
KDI,0,0,0,1,1,3
FQF,0,0,0,1,1,3
QFW,0,0,0,1,1,3
WKM,0,0,0,1,1,3
KWR,0,0,0,1,1,3
WRA,0,0,0,1,1,3
DDN,0,0,0,1,1,3
LYP,0,0,0,1,1,3
YPQ,0,0,0,1,1,3
FEF,0,0,0,1,1,3
EFL,0,0,0,3,3,3
KGN,0,0,0,1,1,3
WPT,0,0,0,1,1,3
PTM,0,0,0,1,1,3
TML,0,0,0,1,1,3
KRY,0,0,0,1,1,3
IDP,0,0,0,1,1,3
VKY,0,0,0,1,1,3
VSQ,0,0,0,1,1,3
GII,0,0,0,1,1,3
TKT,0,0,0,1,1,3
WDI,0,0,0,1,1,3
DIQ,0,0,0,1,1,3
VMG,0,0,0,1,1,3
MGQ,0,0,0,1,1,3
GQN,0,0,0,1,1,3
LNM,0,0,0,1,1,3
VMP,0,0,0,1,1,3
MPS,0,0,0,1,1,3
MQW,0,0,0,1,1,3
QWV,0,0,0,1,1,3
QHR,0,0,0,1,1,3
HRH,0,0,0,1,1,3
RHR,0,0,0,1,1,3
HRR,0,0,0,1,1,3
RRD,0,0,0,1,1,3
RDD,0,0,0,1,1,3
NQF,0,0,0,1,1,3
LDY,0,0,0,1,1,3
GVM,0,0,0,1,1,3
VPM,0,0,0,1,1,3
PMQ,0,0,0,1,1,3
KYH,0,0,0,1,1,3
NRF,0,0,0,2,2,3
FIK,0,0,0,1,1,3
MKA,0,0,0,1,1,3
HYA,0,0,0,1,1,3
VYG,0,0,0,1,1,3
YGP,0,0,0,1,1,3
GPF,0,0,0,1,1,3
PFW,0,0,0,1,1,3
WKN,0,0,0,1,1,3
KNW,0,0,0,1,1,3
QWA,0,0,0,1,1,3
WAD,0,0,0,1,1,3
RND,0,0,0,1,1,3
QND,0,0,0,1,1,3
VST,0,0,0,1,1,3
KGA,0,0,0,1,1,3
TQT,0,0,0,1,1,3
YDD,0,0,0,1,1,3
YDL,0,0,0,1,1,3
YSR,0,0,0,1,1,3
LEF,0,0,0,1,1,3
FIV,0,0,0,1,1,3
VDL,0,0,0,1,1,3
GIP,0,0,0,1,1,3
PNV,0,0,0,1,1,3
YGS,0,0,0,1,1,3
FGY,0,0,0,1,1,3
KEP,0,0,0,1,1,3
QVN,0,0,0,1,1,3
LAP,0,0,0,1,1,3
APQ,0,0,0,1,1,3
PQI,0,0,0,1,1,3
HGA,0,0,0,1,1,3
RFQ,0,0,0,1,1,3
MGN,0,0,0,1,1,3
GNH,0,0,0,1,1,3
TNL,0,0,0,1,1,3
ESV,0,0,0,1,1,3
GDH,0,0,0,1,1,3
YPI,0,0,0,1,1,3
MRQ,0,0,0,1,1,3
ETG,0,0,0,1,1,3
YQN,0,0,0,1,1,3
QNI,0,0,0,1,1,3
YAA,0,0,0,1,1,3
ARK,0,0,0,1,1,3
RMT,0,0,0,1,1,3
AIGK,0,1,0,1,2,4
IGKF,5,6,1,0,12,4
GKFL,4,6,1,0,11,4
KFLH,3,7,1,0,11,4
FLHS,0,7,1,0,8,4
LHSA,0,7,1,0,8,4
HSAK,0,6,1,0,7,4
SAKK,2,9,1,0,12,4
AKKF,6,10,4,1,21,4
KKFG,0,2,1,0,3,4
KFGK,0,2,1,0,3,4
FGKA,0,2,1,0,3,4
GKAF,0,2,1,0,3,4
KAFV,1,4,1,0,6,4
AFVG,0,2,0,0,2,4
FVGE,0,2,0,0,2,4
VGEI,0,2,0,0,2,4
GEIM,0,2,0,0,2,4
EIMN,0,4,0,0,4,4
IMNS,0,4,0,0,4,4
FAKA,1,4,0,0,5,4
AKAL,1,8,5,1,15,4
KALA,0,2,3,1,6,4
ALAK,0,2,2,2,6,4
LAKL,3,14,21,1,39,4
AKLA,3,14,21,3,41,4
KLAK,5,34,43,0,82,4
LAKK,7,23,29,1,60,4
AKKL,3,26,30,2,61,4
KKLL,2,5,3,2,12,4
KALK,1,18,15,4,38,4
ALKA,2,13,6,0,21,4
LKAL,0,12,7,1,20,4
KALL,0,1,1,0,2,4
ALLK,0,1,3,2,6,4
LLKA,2,1,2,0,5,4
FAKF,0,2,0,0,2,4
AKFL,1,3,0,1,5,4
KFLA,0,1,0,0,1,4
FLAK,0,1,0,0,1,4
LAKF,0,2,0,0,2,4
KFLK,2,2,1,1,6,4
FLKK,1,2,1,1,5,4
LKKA,1,12,11,1,25,4
KKAL,0,16,16,0,32,4
FAKI,1,0,1,0,2,4
AKII,0,0,1,0,1,4
KIIA,0,0,1,1,2,4
IIAK,0,0,1,0,1,4
IAKI,0,0,2,0,2,4
AKIA,0,0,2,1,3,4
KIAK,0,0,2,1,3,4
IAKK,0,1,1,0,2,4
AKKI,0,0,2,0,2,4
KKIL,0,0,2,3,5,4
FAKK,0,12,13,1,26,4
KKFA,1,8,2,0,11,4
KFAK,1,7,0,1,9,4
KKFK,0,1,0,0,1,4
KFKK,0,1,0,1,2,4
FKKF,0,3,0,0,3,4
AKFA,0,1,0,0,1,4
KFAF,0,1,0,0,1,4
FAFA,0,1,0,0,1,4
AFAF,0,1,0,0,1,4
KKLA,3,24,23,0,50,4
LAKA,1,4,6,1,12,4
AKAA,0,0,1,0,1,4
KAAL,0,0,1,0,1,4
KLAL,1,4,5,0,10,4
AKLL,2,6,17,1,26,4
KKLK,0,10,7,1,18,4
KLKK,0,11,7,1,19,4
LKKL,2,16,10,4,32,4
AKKW,0,1,0,0,1,4
KKWK,0,1,0,0,1,4
KWKL,5,9,2,0,16,4
LALA,0,2,2,4,8,4
ALAL,0,8,9,4,21,4
LALK,0,8,7,0,15,4
KKLI,1,1,0,2,4,4
KLIG,0,1,0,1,2,4
LIGA,0,1,0,0,1,4
IGAV,1,4,0,0,5,4
GAVL,1,4,0,0,5,4
AVLK,1,4,0,0,5,4
VLKV,1,4,0,0,5,4
AKKA,0,4,7,0,11,4
KLLA,2,8,13,0,23,4
LLAL,0,1,0,1,2,4
ALKL,0,1,4,1,6,4
LKLA,0,1,3,1,5,4
LLAK,2,6,13,0,21,4
FAKL,2,6,18,0,26,4
AKLF,0,1,2,0,3,4
KLFA,1,0,1,0,2,4
LFAK,1,0,1,0,2,4
KFAL,0,1,2,0,3,4
ALKK,1,15,13,2,31,4
LKKF,0,2,0,0,2,4
KKFL,1,1,0,2,4,4
LKLK,0,0,1,0,1,4
KLKL,0,0,2,1,3,4
AKAK,0,1,1,1,3,4
KAKL,0,1,1,0,2,4
KKAA,0,0,1,0,1,4
AKKG,0,0,1,0,1,4
KKGL,0,0,1,0,1,4
AKKS,0,0,1,0,1,4
KKSL,0,0,1,2,3,4
AKKV,0,2,1,1,4,4
KKVL,0,1,1,1,3,4
AKLK,0,1,1,1,3,4
KLLF,0,0,1,0,1,4
LLFK,0,0,1,0,1,4
LFKA,0,2,1,0,3,4
FKAL,0,2,1,1,4,4
KLLK,1,2,1,4,8,4
LLKL,1,0,1,0,2,4
KLAA,1,1,1,0,3,4
LAAK,1,2,1,1,5,4
AAKK,0,1,1,0,2,4
AKLW,0,1,1,0,2,4
KLWA,0,1,1,0,2,4
LWAK,0,1,1,0,2,4
WAKL,0,1,1,0,2,4
KLAF,0,1,1,0,2,4
LAFG,0,1,0,0,1,4
AFGK,0,1,0,0,1,4
FGKG,0,1,0,0,1,4
GKGI,0,1,0,0,1,4
KGIG,0,1,0,0,1,4
GIGK,5,6,1,0,12,4
IGKV,0,1,0,1,2,4
GKVG,0,1,0,0,1,4
KVGK,0,1,0,0,1,4
VGKK,0,1,0,0,1,4
GKKL,0,1,0,0,1,4
FALA,0,7,4,0,11,4
ALAA,0,1,0,2,3,4
AAKA,0,2,0,2,4,4
KKAK,1,1,1,0,3,4
KAKA,0,1,0,1,2,4
LLKK,1,2,1,3,7,4
FALK,0,1,0,0,1,4
FALL,0,0,2,0,2,4
FAVG,0,0,1,0,1,4
AVGL,0,0,1,0,1,4
VGLR,0,0,1,0,1,4
GLRA,0,0,1,0,1,4
LRAI,0,0,1,0,1,4
RAIK,0,0,1,0,1,4
AIKR,0,0,1,0,1,4
IKRA,0,0,1,0,1,4
KRAL,0,0,1,1,2,4
RALK,0,0,1,0,1,4
KKLR,0,0,1,0,1,4
KLRR,0,0,1,0,1,4
LRRG,0,0,1,0,1,4
RRGV,0,0,1,0,1,4
RGVR,0,0,1,0,1,4
GVRK,0,0,1,0,1,4
VRKV,0,0,1,1,2,4
RKVA,0,0,1,0,1,4
KVAK,1,1,1,0,3,4
VAKD,0,0,1,0,1,4
AKDL,0,0,1,0,1,4
FKLA,1,0,2,0,3,4
LAFK,0,0,1,0,1,4
AFKL,0,0,1,0,1,4
KKAF,0,0,1,0,1,4
KAFL,0,0,1,1,2,4
FKRL,0,1,0,1,2,4
KRLA,0,1,0,0,1,4
RLAK,0,2,0,2,4,4
LAKI,0,2,0,0,2,4
AKIK,0,2,0,0,2,4
KIKV,0,1,0,0,1,4
IKVL,0,1,0,1,2,4
KVLR,0,1,0,1,2,4
VLRL,0,1,0,4,5,4
LRLA,0,1,0,1,2,4
KIKR,0,1,0,0,1,4
FKVK,0,0,3,0,3,4
KVKF,0,0,2,0,2,4
VKFK,0,0,2,0,2,4
KFKV,0,0,1,0,1,4
KVKV,0,0,1,0,1,4
VKVK,0,0,1,0,1,4
FLGA,0,3,0,0,3,4
LGAL,0,3,0,0,3,4
GALF,0,3,0,0,3,4
ALFH,0,1,0,0,1,4
LFHA,0,1,0,0,1,4
FHAL,0,1,0,0,1,4
HALS,0,1,0,0,1,4
ALSK,0,2,0,0,2,4
LSKL,0,2,0,1,3,4
SKLL,0,2,0,0,2,4
ALFK,0,2,0,1,3,4
KALS,0,2,0,0,2,4
ALSH,0,1,0,1,2,4
LSHL,0,1,0,0,1,4
SHLL,0,1,0,0,1,4
FLGM,2,0,0,0,2,4
LGMI,2,0,0,0,2,4
GMIP,2,0,0,0,2,4
MIPG,1,0,0,0,1,4
IPGL,1,0,0,0,1,4
PGLI,1,0,0,0,1,4
GLIG,1,0,0,0,1,4
LIGG,1,0,0,0,1,4
IGGL,2,4,0,0,6,4
GGLI,1,0,0,0,1,4
GLIS,1,0,0,0,1,4
LISA,1,0,0,1,2,4
ISAF,1,0,1,0,2,4
SAFK,1,0,1,0,2,4
MIPK,1,0,0,0,1,4
IPKL,2,0,0,1,3,4
PKLI,1,0,0,0,1,4
KLIK,2,0,0,2,4,4
LIKK,1,0,0,1,2,4
IKKL,2,5,0,2,9,4
LIKA,1,0,0,0,1,4
IKAF,2,0,0,1,3,4
KAFK,2,0,0,2,4,4
FLGW,0,2,0,0,2,4
LGWL,0,2,0,1,3,4
GWLF,0,2,0,1,3,4
WLFK,0,4,0,0,4,4
LFKW,0,4,0,0,4,4
FKWA,0,4,0,0,4,4
KWAK,0,2,0,2,4,4
WAKK,0,2,0,0,2,4
KWAW,0,2,0,0,2,4
WAWK,0,2,0,0,2,4
FLKL,1,2,0,2,5,4
LKLL,1,2,0,0,3,4
LLAG,0,1,0,0,1,4
LAGL,0,1,0,0,1,4
AGLL,0,1,0,1,2,4
GLLK,0,1,0,2,3,4
LLKN,0,1,0,1,2,4
LKNF,0,1,0,1,2,4
KNFA,0,1,0,0,1,4
AAKF,1,0,0,0,1,4
KFLP,1,0,0,0,1,4
FLPT,1,0,0,0,1,4
LPTI,1,0,0,0,1,4
PTII,1,0,0,0,1,4
TIIC,1,0,0,0,1,4
IICK,1,0,0,0,1,4
ICKI,1,0,0,0,1,4
CKIS,1,0,0,0,1,4
KISY,1,0,0,0,1,4
ISYK,1,0,0,0,1,4
SYKC,1,0,0,0,1,4
AAKL,0,1,1,1,3,4
FLKW,0,1,0,0,1,4
LKWL,0,1,0,0,1,4
KWLF,0,1,0,0,1,4
FLSL,1,0,1,0,2,4
LSLI,1,0,1,1,3,4
SLIP,1,0,1,0,2,4
LIPK,1,0,0,0,1,4
PKLV,1,0,0,0,1,4
KLVK,1,0,0,2,3,4
LVKK,1,0,0,1,2,4
VKKI,1,4,0,1,6,4
KKII,1,0,0,0,1,4
KIIK,1,0,0,2,3,4
IIKA,1,0,0,1,2,4
LIPS,0,0,1,0,1,4
IPSL,0,0,1,0,1,4
PSLV,0,0,1,1,2,4
SLVG,0,0,1,0,1,4
LVGG,0,0,1,1,2,4
VGGS,0,0,1,0,1,4
GGSI,0,0,1,0,1,4
GSIS,0,0,1,0,1,4
SISA,0,0,1,0,1,4
FLWW,0,1,0,0,1,4
LWWL,0,1,0,0,1,4
WWLF,0,1,0,1,2,4
GIGA,2,3,0,0,5,4
LKVL,1,3,0,3,7,4
KVLT,0,2,0,0,2,4
VLTT,0,2,0,0,2,4
LTTG,0,2,0,0,2,4
TTGL,0,1,0,0,1,4
TGLP,0,1,0,0,1,4
GLPA,0,1,0,0,1,4
LPAL,0,1,0,1,2,4
PALI,0,1,0,1,2,4
ALIS,0,1,0,0,1,4
LISW,0,1,0,0,1,4
ISWI,0,1,0,0,1,4
SWIK,0,1,0,0,1,4
WIKR,0,1,0,1,2,4
IKRK,0,1,0,0,1,4
KRKR,0,1,0,1,2,4
RKRQ,0,1,0,0,1,4
KRQQ,0,1,0,1,2,4
FLHA,0,1,0,0,1,4
LHAA,0,1,0,0,1,4
HAAK,0,1,0,0,1,4
AKAF,1,2,0,1,4,4
AFVA,0,2,0,0,2,4
FVAE,0,2,0,0,2,4
VAEI,0,2,0,1,3,4
AEIM,0,2,0,0,2,4
KAKK,1,0,1,0,2,4
AFVK,1,0,1,0,2,4
FVKI,1,0,1,0,2,4
VKII,1,0,0,0,1,4
KIIN,1,0,0,0,1,4
IINN,1,0,0,0,1,4
VKIL,0,0,1,0,1,4
KILK,0,0,1,1,2,4
ILKK,0,0,1,2,3,4
GLFA,2,4,0,0,6,4
LFAV,2,4,0,0,6,4
FAVI,2,4,0,0,6,4
AVIK,2,5,0,0,7,4
VIKK,3,15,0,3,21,4
IKKV,2,10,0,1,13,4
KKVA,2,10,0,2,14,4
KVAA,0,3,0,0,3,4
VAAV,0,3,0,2,5,4
AAVI,0,3,0,1,4,4
AVIR,0,1,0,0,1,4
VIRR,0,1,0,0,1,4
IRRL,0,1,0,0,1,4
VAKV,1,1,0,0,2,4
AKVI,1,1,0,0,2,4
KVIK,1,3,0,1,5,4
KVAS,1,7,0,0,8,4
VASV,1,8,0,0,9,4
ASVI,1,8,0,0,9,4
SVIG,1,3,0,0,4,4
VIGG,1,4,0,0,5,4
SVIK,0,5,0,0,5,4
VIKG,0,2,0,0,2,4
IKGL,0,2,0,0,2,4
GLFD,0,12,0,2,14,4
LFDI,0,6,0,0,6,4
FDIA,0,1,0,0,1,4
DIAK,0,1,0,1,2,4
KKVI,0,1,0,1,2,4
KVIG,0,1,0,0,1,4
VIGV,0,1,0,0,1,4
IGVI,0,1,0,0,1,4
GVIG,0,1,0,0,1,4
VIGS,0,1,0,1,2,4
IGSL,0,1,0,0,1,4
FDII,0,1,0,0,1,4
DIIK,0,1,0,0,1,4
IIKK,0,1,0,2,3,4
IKKI,0,1,0,1,2,4
KKIA,0,4,0,1,5,4
KIAE,0,1,0,0,1,4
IAES,0,1,0,1,2,4
AESF,0,1,0,1,2,4
FDIV,0,4,0,0,4,4
DIVK,0,4,0,2,6,4
IVKK,0,4,0,0,4,4
KIAG,0,3,0,0,3,4
IAGH,0,3,0,0,3,4
AGHI,0,3,0,0,3,4
GHIA,0,2,0,0,2,4
HIAG,0,1,0,0,1,4
IAGS,0,1,0,0,1,4
AGSI,0,1,0,0,1,4
HIAS,0,1,0,0,1,4
IASS,0,1,0,0,1,4
ASSI,0,1,0,0,1,4
GHIV,0,1,0,0,1,4
HIVS,0,1,0,0,1,4
IVSS,0,1,0,0,1,4
VSSI,0,1,0,1,2,4
VKKV,0,1,0,1,2,4
KKVV,0,1,1,1,3,4
KVVG,0,1,0,0,1,4
VVGA,0,1,0,0,1,4
VGAF,0,1,0,0,1,4
GAFG,0,1,0,0,1,4
AFGS,0,1,0,0,1,4
FGSL,0,1,0,1,2,4
LFDV,0,6,0,1,7,4
FDVI,0,6,0,1,7,4
DVIA,0,1,0,1,2,4
VIAK,0,1,0,1,2,4
IAKV,0,1,0,0,1,4
AKVA,0,1,0,0,1,4
DVIK,0,5,0,0,5,4
VIKA,0,1,0,0,1,4
IKAV,0,1,0,0,1,4
KAVA,0,1,0,1,2,4
AVAS,0,1,0,2,3,4
AVIG,0,1,0,0,1,4
GLFK,0,2,0,1,3,4
LFKV,0,2,0,0,2,4
FKVI,0,2,0,1,3,4
ILPW,0,0,1,0,1,4
LPWK,0,0,1,0,1,4
PWKW,0,0,1,0,1,4
WKWP,0,0,1,0,1,4
KWPW,0,0,1,0,1,4
WPWW,0,0,1,0,1,4
PWWP,0,0,1,0,1,4
WWPW,0,0,1,0,1,4
WPWR,0,0,1,0,1,4
PWRR,0,0,1,0,1,4
KKKF,4,1,0,0,5,4
KKFP,4,1,0,0,5,4
KFPW,4,1,0,0,5,4
FPWW,4,1,0,0,5,4
PWWW,4,1,0,0,5,4
WWWP,4,1,0,0,5,4
WWPF,4,1,0,0,5,4
WPFK,4,1,0,0,5,4
PFKK,4,1,0,0,5,4
FKKK,4,2,0,0,6,4
KKKC,2,0,0,0,2,4
KKCK,1,0,0,0,1,4
KCKK,1,0,0,0,1,4
CKKK,1,0,0,0,1,4
KKKK,4,0,0,0,4,4
KVVF,0,0,1,0,1,4
VVFK,0,0,1,0,1,4
VFKV,0,0,1,0,1,4
LKAA,0,0,1,2,3,4
KAAK,0,0,1,0,1,4
KTKL,0,2,0,0,2,4
TKLF,0,2,0,0,2,4
KLFK,4,10,1,0,15,4
LFKK,4,10,1,0,15,4
KWKK,1,0,0,0,1,4
WKKF,1,0,0,0,1,4
FLKI,1,0,0,1,2,4
LKIG,1,0,0,0,1,4
KIGI,6,4,0,0,10,4
IGIG,6,4,0,0,10,4
FLHL,4,0,0,0,4,4
LHLA,4,0,0,0,4,4
HLAK,4,0,0,2,6,4
WKLA,0,0,1,0,1,4
LALL,0,0,1,2,3,4
WKLF,5,8,1,0,14,4
AKIG,1,0,0,0,1,4
FKKA,0,1,0,0,1,4
FKKI,4,7,2,0,13,4
KKIG,4,5,0,0,9,4
KIGA,0,1,0,0,1,4
IGAF,1,1,0,0,2,4
GAFL,1,1,0,0,2,4
AFLH,1,1,0,0,2,4
KVLK,1,0,0,0,1,4
VLKK,1,0,0,0,1,4
LKKG,1,0,0,0,1,4
GKFK,1,0,0,1,2,4
KFKL,1,0,0,0,1,4
HSAT,0,1,0,1,2,4
SATT,0,1,0,0,1,4
ATTF,0,1,0,0,1,4
KKIK,0,0,1,0,1,4
KIKF,0,0,1,0,1,4
IKFL,0,0,1,0,1,4
KKIP,0,1,0,0,1,4
KIPK,0,1,0,0,1,4
IPKF,0,1,0,0,1,4
PKFL,0,1,0,0,1,4
KKKT,0,1,0,0,1,4
KKTK,0,1,0,0,1,4
KWKS,5,3,0,0,8,4
WKSF,5,3,0,0,8,4
KSFA,0,1,0,0,1,4
SFAK,0,1,0,0,1,4
FAKT,0,1,0,0,1,4
AKTF,0,1,0,0,1,4
KTFK,5,3,0,0,8,4
TFKS,5,3,0,0,8,4
FKSA,2,3,0,0,5,4
KSAK,2,3,0,0,5,4
AKKT,2,3,0,0,5,4
KKTV,5,3,0,0,8,4
KTVL,5,1,0,0,6,4
TVLH,5,1,0,0,6,4
VLHT,5,1,0,0,6,4
LHTA,2,1,0,0,3,4
HTAL,2,2,0,0,4,4
TALK,2,2,0,0,4,4
LKAI,4,2,0,0,6,4
KAIS,4,3,0,0,7,4
AISS,4,3,0,1,8,4
KSFL,5,2,0,1,8,4
SFLK,5,2,0,0,7,4
FLKT,5,2,0,1,8,4
LKTF,5,2,0,0,7,4
KTVA,0,2,0,1,3,4
TVAH,0,2,0,0,2,4
VAHT,0,2,0,0,2,4
AHTA,0,2,0,0,2,4
HTAA,0,1,0,0,1,4
TAAK,0,1,0,1,2,4
AKAI,0,1,0,0,1,4
LHTL,3,0,0,0,3,4
HTLL,3,0,0,0,3,4
TLLK,3,0,0,0,3,4
FKSL,3,0,0,0,3,4
KSLK,3,0,0,0,3,4
SLKK,3,0,0,1,4,4
LKKT,3,0,0,0,3,4
LKLI,1,0,0,1,2,4
KLIS,1,0,0,0,1,4
LISS,1,0,0,0,1,4
KYKK,0,0,1,0,1,4
YKKA,0,0,1,0,1,4
LGGI,0,1,0,0,1,4
GGIV,0,1,0,0,1,4
GIVS,0,1,0,0,1,4
IVSA,0,1,0,0,1,4
VSAV,0,1,0,0,1,4
SAVK,0,1,0,1,2,4
AVKK,0,1,0,0,1,4
KKIV,0,1,0,0,1,4
KIVD,0,1,0,0,1,4
IVDF,0,1,0,0,1,4
VDFL,0,1,0,2,3,4
DFLG,0,1,0,0,1,4
LPKW,0,1,0,1,2,4
PKWK,0,1,1,0,2,4
KWKV,0,1,1,0,2,4
WKVF,0,1,1,0,2,4
KVFK,0,1,1,0,2,4
VFKK,0,1,1,0,2,4
KKIE,0,1,1,0,2,4
KIEK,0,1,1,0,2,4
IEKV,0,1,1,0,2,4
EKVG,0,1,1,0,2,4
KVGR,0,1,1,0,2,4
VGRN,0,1,1,0,2,4
GRNI,0,1,1,0,2,4
RNIR,0,1,1,0,2,4
NIRN,0,1,1,0,2,4
IRNG,0,1,1,0,2,4
RNGI,0,1,1,0,2,4
NGIV,0,1,1,0,2,4
GIVK,0,1,1,0,2,4
IVKA,0,1,1,2,4,4
VKAG,0,1,1,2,4,4
KAGP,0,1,1,0,2,4
AGPA,0,1,1,0,2,4
GPAI,0,1,1,0,2,4
PAIA,0,1,1,0,2,4
AIAV,0,1,1,1,3,4
IAVL,0,1,1,0,2,4
AVLG,0,1,1,0,2,4
VLGE,0,1,1,1,3,4
LGEA,0,1,1,2,4,4
GEAK,0,1,1,0,2,4
EAKA,0,1,1,0,2,4
KALG,0,1,1,1,3,4
MPKW,0,0,1,0,1,4
RAGL,1,0,0,0,1,4
AGLQ,1,0,0,0,1,4
GLQF,1,0,0,0,1,4
LQFP,1,0,0,0,1,4
QFPV,1,0,0,0,1,4
FPVG,1,0,0,0,1,4
PVGR,1,0,0,0,1,4
VGRL,1,0,0,0,1,4
GRLL,1,0,0,0,1,4
RLLR,3,0,0,0,3,4
LLRR,2,0,0,0,2,4
LRRL,2,0,0,0,2,4
RRLL,2,0,0,1,3,4
VAKK,1,0,0,0,1,4
VAKL,0,1,1,2,4,4
VALA,0,0,1,2,3,4
WALA,0,0,1,1,2,4
AADI,0,0,0,1,1,4
ADIF,0,0,0,1,1,4
DIFS,0,0,0,1,1,4
IFSK,0,0,0,1,1,4
FSKF,0,0,0,1,1,4
SKFK,0,0,0,1,1,4
FKKD,0,0,0,1,1,4
KKDM,0,0,0,1,1,4
KDME,0,0,0,1,1,4
DMEV,0,0,0,1,1,4
MEVK,0,0,0,1,1,4
EVKF,0,0,0,1,1,4
VKFA,0,0,0,1,1,4
AAQK,0,0,0,1,1,4
AQKD,0,0,0,1,1,4
QKDN,0,0,0,1,1,4
KDNV,0,0,0,1,1,4
DNVK,0,0,0,1,1,4
NVKS,0,0,0,1,1,4
VKSS,0,0,0,1,1,4
KSSW,0,0,0,1,1,4
SSWA,0,0,0,1,1,4
SWAK,0,0,0,1,1,4
WAKA,0,0,0,1,1,4
AKAS,0,0,0,3,3,4
KASA,0,0,0,1,1,4
AASQ,0,0,0,1,1,4
ASQR,0,0,0,1,1,4
SQRK,0,0,0,1,1,4
QRKL,0,0,0,1,1,4
RKLI,0,0,0,1,1,4
KLIA,0,0,0,1,1,4
LIAE,0,0,0,1,1,4
IAEK,0,0,0,2,2,4
AEKF,0,0,0,1,1,4
EKFA,0,0,0,1,1,4
KFAQ,0,0,0,1,1,4
FAQA,0,0,0,1,1,4
AQAL,0,0,0,2,2,4
QALM,0,0,0,1,1,4
ALMS,0,0,0,1,1,4
LMSS,0,0,0,1,1,4
MSSL,0,0,0,1,1,4
AAYA,0,0,0,2,2,4
AYAT,0,0,0,1,1,4
YATL,0,0,0,1,1,4
ATLY,0,0,0,1,1,4
TLYE,0,0,0,1,1,4
LYEA,0,0,0,1,1,4
YEAL,0,0,0,1,1,4
EALV,0,0,0,2,2,4
ALVL,0,0,0,1,1,4
LVLV,0,0,0,1,1,4
VLVA,0,0,0,1,1,4
LVAT,0,0,0,1,1,4
VATL,0,0,0,2,2,4
ATLA,0,0,0,2,2,4
TLAA,0,0,0,2,2,4
LAAP,0,0,0,1,1,4
AEAH,0,0,0,1,1,4
EAHE,0,0,0,1,1,4
AHES,0,0,0,1,1,4
HESI,0,0,0,1,1,4
ESIR,0,0,0,2,2,4
SIRL,0,0,0,1,1,4
IRLV,0,0,0,1,1,4
RLVF,0,0,0,1,1,4
LVFH,0,0,0,1,1,4
VFHD,0,0,0,2,2,4
FHDS,0,0,0,1,1,4
AEGE,0,0,0,1,1,4
EGER,0,0,0,2,2,4
GERE,0,0,0,2,2,4
EREA,0,0,0,2,2,4
REAR,0,0,0,2,2,4
EARV,0,0,0,1,1,4
ARVF,0,0,0,2,2,4
RVFT,0,0,0,1,1,4
VFTL,0,0,0,2,2,4
FTLW,0,0,0,1,1,4
TLWL,0,0,0,1,1,4
LWLN,0,0,0,1,1,4
WLNS,0,0,0,1,1,4
LNSL,0,0,0,2,2,4
AEGV,0,0,0,1,1,4
EGVA,0,0,0,2,2,4
GVAT,0,0,0,1,1,4
VATA,0,0,0,1,1,4
ATAD,0,0,0,2,2,4
TADP,0,0,0,1,1,4
ADPL,0,0,0,1,1,4
DPLM,0,0,0,1,1,4
PLMR,0,0,0,1,1,4
LMRL,0,0,0,2,2,4
MRLA,0,0,0,1,1,4
LAKQ,0,0,0,3,3,4
AKQL,0,0,0,2,2,4
KQLK,0,0,0,1,1,4
AEHA,0,0,0,1,1,4
EHAK,0,0,0,1,1,4
HAKV,0,0,0,1,1,4
AKVL,0,0,0,1,1,4
KVLM,0,0,0,1,1,4
VLMD,0,0,0,1,1,4
LMDS,0,0,0,1,1,4
MDSL,0,0,0,1,1,4
DSLT,0,0,0,1,1,4
SLTG,0,0,0,1,1,4
LTGV,0,0,0,1,1,4
TGVW,0,0,0,1,1,4
GVWD,0,0,0,1,1,4
VWDN,0,0,0,1,1,4
WDNF,0,0,0,1,1,4
DNFL,0,0,0,1,1,4
NFLT,0,0,0,1,1,4
AEHL,0,0,0,1,1,4
EHLA,0,0,0,1,1,4
AKAE,0,0,0,1,1,4
KAEL,0,0,0,1,1,4
AELT,0,0,0,2,2,4
ELTT,0,0,0,1,1,4
LTTV,0,0,0,1,1,4
TTVF,0,0,0,1,1,4
TVFS,0,0,0,1,1,4
VFST,0,0,0,1,1,4
FSTL,0,0,0,2,2,4
STLY,0,0,0,2,2,4
TLYQ,0,0,0,1,1,4
LYQK,0,0,0,1,1,4
YQKF,0,0,0,1,1,4
AEKA,0,0,0,1,1,4
EKAK,0,0,0,1,1,4
KAKY,0,0,0,1,1,4
AKYD,0,0,0,1,1,4
KYDE,0,0,0,1,1,4
YDEI,0,0,0,1,1,4
DEIF,0,0,0,2,2,4
EIFL,0,0,0,1,1,4
IFLK,0,0,0,1,1,4
AFFT,0,0,0,1,1,4
FFTI,0,0,0,1,1,4
FTIA,0,0,0,1,1,4
TIAA,0,0,0,1,1,4
IAAV,0,0,0,1,1,4
AAVA,0,0,0,1,1,4
AVAR,0,0,0,1,1,4
VARV,0,0,0,1,1,4
ARVL,0,0,0,1,1,4
RVLD,0,0,0,1,1,4
AFRH,0,0,0,1,1,4
FRHS,0,0,0,1,1,4
RHSV,0,0,0,1,1,4
HSVK,0,0,0,1,1,4
SVKE,0,0,0,1,1,4
VKEE,0,0,0,1,1,4
KEEL,0,0,0,3,3,4
EELN,0,0,0,3,3,4
ELNY,0,0,0,1,1,4
LNYI,0,0,0,2,2,4
NYIR,0,0,0,1,1,4
YIRR,0,0,0,1,1,4
IRRR,0,0,0,2,2,4
RRRL,0,0,0,2,2,4
RRLE,0,0,0,1,1,4
RLER,0,0,0,2,2,4
LERF,0,0,0,1,1,4
ERFP,0,0,0,1,1,4
RFPN,0,0,0,1,1,4
FPNR,0,0,0,1,1,4
PNRL,0,0,0,1,1,4
AGDV,0,0,0,1,1,4
GDVL,0,0,0,1,1,4
DVLH,0,0,0,1,1,4
VLHN,0,0,0,1,1,4
LHNV,0,0,0,1,1,4
HNVL,0,0,0,1,1,4
NVLQ,0,0,0,1,1,4
VLQM,0,0,0,1,1,4
LQML,0,0,0,2,2,4
QMLI,0,0,0,1,1,4
MLII,0,0,0,1,1,4
LIIE,0,0,0,2,2,4
IIES,0,0,0,1,1,4
IESH,0,0,0,1,1,4
ESHS,0,0,0,1,1,4
AGEM,0,0,0,1,1,4
GEMV,0,0,0,1,1,4
EMVR,0,0,0,3,3,4
MVRQ,0,0,0,1,1,4
VRQA,0,0,0,1,1,4
RQAR,0,0,0,1,1,4
QARI,0,0,0,1,1,4
ARIL,0,0,0,1,1,4
RILA,0,0,0,1,1,4
ILAQ,0,0,0,1,1,4
LAQA,0,0,0,2,2,4
AQAT,0,0,0,1,1,4
QATS,0,0,0,1,1,4
ATSD,0,0,0,1,1,4
TSDL,0,0,0,1,1,4
SDLV,0,0,0,1,1,4
DLVN,0,0,0,1,1,4
LVNA,0,0,0,1,1,4
VNAI,0,0,0,1,1,4
NAIK,0,0,0,1,1,4
AIKA,0,0,0,1,1,4
IKAD,0,0,0,1,1,4
KADA,0,0,0,2,2,4
AGNL,0,0,0,2,2,4
GNLD,0,0,0,1,1,4
NLDI,0,0,0,1,1,4
LDIM,0,0,0,1,1,4
DIMT,0,0,0,1,1,4
IMTS,0,0,0,1,1,4
MTSA,0,0,0,1,1,4
TSAA,0,0,0,2,2,4
SAAL,0,0,0,2,2,4
AALA,0,0,0,6,6,4
ALAT,0,0,0,1,1,4
LATA,0,0,0,1,1,4
ATAE,0,0,0,1,1,4
TAER,0,0,0,2,2,4
AERM,0,0,0,1,1,4
ERMA,0,0,0,1,1,4
RMAQ,0,0,0,1,1,4
MAQS,0,0,0,1,1,4
AQSM,0,0,0,1,1,4
QSML,0,0,0,1,1,4
SMLN,0,0,0,1,1,4
AHAI,0,0,0,1,1,4
HAIG,0,0,0,1,1,4
AIGV,0,0,0,1,1,4
IGVL,0,0,0,1,1,4
GVLL,0,0,0,2,2,4
VLLD,0,0,0,2,2,4
LLDN,0,0,0,1,1,4
LDNL,0,0,0,1,1,4
AIEK,0,0,0,2,2,4
IEKE,0,0,0,2,2,4
EKEI,0,0,0,1,1,4
KEIL,0,0,0,1,1,4
EILI,0,0,0,1,1,4
ILIE,0,0,0,1,1,4
LIEA,0,0,0,1,1,4
IEAI,0,0,0,3,3,4
EAIS,0,0,0,1,1,4
AKQE,0,0,0,1,1,4
KQEK,0,0,0,1,1,4
QEKI,0,0,0,1,1,4
EKII,0,0,0,2,2,4
KIII,0,0,0,1,1,4
IIIQ,0,0,0,1,1,4
IIQV,0,0,0,1,1,4
IQVA,0,0,0,1,1,4
QVAL,0,0,0,1,1,4
VALN,0,0,0,1,1,4
ALND,0,0,0,1,1,4
LNDI,0,0,0,1,1,4
NDIT,0,0,0,1,1,4
DITH,0,0,0,1,1,4
ITHV,0,0,0,1,1,4
THVV,0,0,0,1,1,4
HVVE,0,0,0,1,1,4
VVEL,0,0,0,1,1,4
VELL,0,0,0,1,1,4
AKVV,0,0,0,2,2,4
KVVR,0,0,0,1,1,4
VVRT,0,0,0,1,1,4
VRTA,0,0,0,1,1,4
RTAL,0,0,0,2,2,4
TALE,0,0,0,2,2,4
ALED,0,0,0,1,1,4
LEDA,0,0,0,2,2,4
EDAA,0,0,0,1,1,4
DAAS,0,0,0,1,1,4
AASV,0,0,0,1,1,4
ASVA,0,0,0,1,1,4
SVAG,0,0,0,1,1,4
VAGL,0,0,0,2,2,4
GLLI,0,0,0,2,2,4
LLIT,0,0,0,1,1,4
ALAV,0,0,0,1,1,4
LAVA,0,0,0,1,1,4
AVAA,0,0,0,2,2,4
VAAK,0,0,0,1,1,4
AAKP,0,0,0,1,1,4
AKPF,0,0,0,1,1,4
KPFL,0,0,0,1,1,4
ALGK,0,0,0,1,1,4
LGKV,0,0,0,1,1,4
GKVI,0,0,0,3,3,4
IKKW,0,0,0,1,1,4
KKWG,0,0,0,1,1,4
KWGT,0,0,0,1,1,4
WGTT,0,0,0,1,1,4
GTTV,0,0,0,2,2,4
TTVA,0,0,0,1,1,4
TVAK,0,0,0,1,1,4
ALYG,0,0,0,1,1,4
LYGL,0,0,0,1,1,4
YGLL,0,0,0,1,1,4
LLKE,0,0,0,1,1,4
LKEE,0,0,0,1,1,4
KEEM,0,0,0,2,2,4
EEMG,0,0,0,1,1,4
EMGE,0,0,0,1,1,4
MGEI,0,0,0,1,1,4
GEIL,0,0,0,3,3,4
EILA,0,0,0,2,2,4
ILAK,0,0,0,1,1,4
AMFE,0,0,0,1,1,4
MFEQ,0,0,0,1,1,4
FEQM,0,0,0,1,1,4
EQMR,0,0,0,1,1,4
QMRA,0,0,0,1,1,4
MRAN,0,0,0,1,1,4
RANV,0,0,0,1,1,4
ANVG,0,0,0,1,1,4
NVGK,0,0,0,2,2,4
VGKL,0,0,0,2,2,4
GKLL,0,0,0,1,1,4
LLKG,0,0,0,2,2,4
APDA,0,0,0,1,1,4
PDAE,0,0,0,1,1,4
DAEG,0,0,0,1,1,4
AEGR,0,0,0,1,1,4
EGRA,0,0,0,1,1,4
GRAI,0,0,0,2,2,4
RAIQ,0,0,0,2,2,4
AIQA,0,0,0,1,1,4
IQAV,0,0,0,2,2,4
QAVY,0,0,0,1,1,4
AVYW,0,0,0,1,1,4
VYWA,0,0,0,1,1,4
YWAN,0,0,0,1,1,4
WANK,0,0,0,1,1,4
ANKW,0,0,0,1,1,4
NKWA,0,0,0,1,1,4
WAKE,0,0,0,1,1,4
AKEQ,0,0,0,1,1,4
KEQG,0,0,0,1,1,4
APDL,0,0,0,1,1,4
PDLL,0,0,0,1,1,4
DLLI,0,0,0,1,1,4
LLIS,0,0,0,2,2,4
LISL,0,0,0,2,2,4
ISLA,0,0,0,1,1,4
SLAT,0,0,0,1,1,4
LATV,0,0,0,1,1,4
ATVL,0,0,0,1,1,4
TVLY,0,0,0,1,1,4
VLYH,0,0,0,1,1,4
LYHL,0,0,0,1,1,4
YHLQ,0,0,0,1,1,4
HLQQ,0,0,0,1,1,4
APED,0,0,0,1,1,4
PEDV,0,0,0,1,1,4
EDVR,0,0,0,1,1,4
DVRK,0,0,0,1,1,4
VRKS,0,0,0,1,1,4
RKSS,0,0,0,1,1,4
KSSK,0,0,0,1,1,4
SSKE,0,0,0,2,2,4
SKEV,0,0,0,1,1,4
KEVL,0,0,0,3,3,4
APLL,0,0,0,1,1,4
PLLN,0,0,0,1,1,4
LLNF,0,0,0,1,1,4
LNFV,0,0,0,1,1,4
NFVR,0,0,0,1,1,4
FVRD,0,0,0,1,1,4
VRDF,0,0,0,1,1,4
RDFV,0,0,0,1,1,4
DFVR,0,0,0,1,1,4
FVRE,0,0,0,1,1,4
VRED,0,0,0,2,2,4
REDA,0,0,0,1,1,4
EDAK,0,0,0,1,1,4
DAKY,0,0,0,1,1,4
AKYL,0,0,0,1,1,4
KYLY,0,0,0,1,1,4
YLYS,0,0,0,1,1,4
LYSS,0,0,0,1,1,4
YSSL,0,0,0,1,1,4
SSLV,0,0,0,1,1,4
AQTS,0,0,0,2,2,4
QTSR,0,0,0,1,1,4
TSRW,0,0,0,1,1,4
SRWA,0,0,0,1,1,4
RWAA,0,0,0,1,1,4
WAAM,0,0,0,1,1,4
AAMQ,0,0,0,2,2,4
AMQI,0,0,0,1,1,4
MQIG,0,0,0,1,1,4
QIGM,0,0,0,1,1,4
IGMS,0,0,0,1,1,4
GMSF,0,0,0,1,1,4
MSFI,0,0,0,1,1,4
SFIS,0,0,0,1,1,4
FISA,0,0,0,1,1,4
ISAY,0,0,0,1,1,4
ARDE,0,0,0,1,1,4
RDEA,0,0,0,1,1,4
DEAE,0,0,0,2,2,4
EAEM,0,0,0,1,1,4
AEME,0,0,0,1,1,4
EMEY,0,0,0,1,1,4
MEYL,0,0,0,1,1,4
EYLK,0,0,0,1,1,4
YLKI,0,0,0,1,1,4
LKIA,0,0,0,2,2,4
KIAQ,0,0,0,1,1,4
ASLP,0,0,0,1,1,4
SLPE,0,0,0,2,2,4
LPEA,0,0,0,1,1,4
PEAI,0,0,0,1,1,4
EAIE,0,0,0,4,4,4
AIEA,0,0,0,3,3,4
IEAL,0,0,0,2,2,4
EALT,0,0,0,4,4,4
ALTK,0,0,0,3,3,4
LTKG,0,0,0,2,2,4
ATLK,0,0,0,1,1,4
TLKN,0,0,0,1,1,4
LKNL,0,0,0,1,1,4
KNLG,0,0,0,1,1,4
NLGS,0,0,0,1,1,4
LGSV,0,0,0,1,1,4
GSVH,0,0,0,1,1,4
SVHV,0,0,0,1,1,4
VHVS,0,0,0,1,1,4
HVSK,0,0,0,1,1,4
VSKG,0,0,0,1,1,4
AVDT,0,0,0,1,1,4
VDTL,0,0,0,2,2,4
DTLV,0,0,0,1,1,4
TLVL,0,0,0,1,1,4
LVLA,0,0,0,1,1,4
VLAL,0,0,0,2,2,4
ALAE,0,0,0,4,4,4
LAEA,0,0,0,3,3,4
AEAT,0,0,0,3,3,4
DAAA,0,0,0,2,2,4
AAAL,0,0,0,2,2,4
AALF,0,0,0,2,2,4
ALFR,0,0,0,2,2,4
LFRL,0,0,0,1,1,4
FRLH,0,0,0,2,2,4
RLHK,0,0,0,2,2,4
LHKF,0,0,0,1,1,4
HKFL,0,0,0,1,1,4
KFLT,0,0,0,2,2,4
FLTK,0,0,0,2,2,4
LTKW,0,0,0,1,1,4
DAAG,0,0,0,1,1,4
AAGL,0,0,0,1,1,4
AGLA,0,0,0,1,1,4
GLAS,0,0,0,1,1,4
LASR,0,0,0,2,2,4
ASRH,0,0,0,1,1,4
SRHK,0,0,0,1,1,4
RHKG,0,0,0,1,1,4
DAEN,0,0,0,2,2,4
AENR,0,0,0,1,1,4
ENRD,0,0,0,1,1,4
NRDL,0,0,0,1,1,4
RDLF,0,0,0,1,1,4
DLFL,0,0,0,3,3,4
LFLA,0,0,0,4,4,4
FLAL,0,0,0,1,1,4
ALLS,0,0,0,1,1,4
LLSV,0,0,0,1,1,4
DAHA,0,0,0,1,1,4
AHAW,0,0,0,1,1,4
HAWM,0,0,0,1,1,4
AWMI,0,0,0,1,1,4
WMIG,0,0,0,1,1,4
MIGQ,0,0,0,1,1,4
IGQL,0,0,0,1,1,4
GQLK,0,0,0,1,1,4
QLKG,0,0,0,1,1,4
LKGL,0,0,0,1,1,4
DALE,0,0,0,1,1,4
ALEI,0,0,0,1,1,4
LEIF,0,0,0,1,1,4
EIFK,0,0,0,3,3,4
IFKT,0,0,0,1,1,4
FKTL,0,0,0,2,2,4
KTLF,0,0,0,1,1,4
TLFS,0,0,0,1,1,4
LFSL,0,0,0,2,2,4
FSLV,0,0,0,1,1,4
SLVM,0,0,0,1,1,4
LVMR,0,0,0,1,1,4
VMRF,0,0,0,1,1,4
MRFS,0,0,0,1,1,4
RFSS,0,0,0,1,1,4
FSSY,0,0,0,1,1,4
SSYL,0,0,0,2,2,4
DAML,0,0,0,1,1,4
AMLR,0,0,0,1,1,4
MLRT,0,0,0,1,1,4
LRTS,0,0,0,1,1,4
RTSM,0,0,0,1,1,4
TSMV,0,0,0,1,1,4
SMVA,0,0,0,1,1,4
MVAT,0,0,0,1,1,4
VATQ,0,0,0,1,1,4
ATQL,0,0,0,1,1,4
TQLV,0,0,0,1,1,4
QLVG,0,0,0,1,1,4
LVGL,0,0,0,1,1,4
VGLA,0,0,0,1,1,4
GLAM,0,0,0,1,1,4
LAMM,0,0,0,1,1,4
AMMR,0,0,0,1,1,4
MMRY,0,0,0,1,1,4
MRYV,0,0,0,1,1,4
DARA,0,0,0,1,1,4
ARAK,0,0,0,1,1,4
RAKK,0,0,0,1,1,4
KLLD,0,0,0,2,2,4
LLDK,0,0,0,1,1,4
LDKW,0,0,0,1,1,4
DKWA,0,0,0,1,1,4
WAKW,0,0,0,1,1,4
AKWI,0,0,0,1,1,4
KWIN,0,0,0,1,1,4
WING,0,0,0,1,1,4
DATA,0,0,0,1,1,4
ATAA,0,0,0,1,1,4
TAAL,0,0,0,2,2,4
LALT,0,0,0,1,1,4
ALTM,0,0,0,1,1,4
LTMA,0,0,0,1,1,4
DATL,0,0,0,1,1,4
ATLI,0,0,0,1,1,4
TLIS,0,0,0,2,2,4
LISE,0,0,0,1,1,4
ISEL,0,0,0,2,2,4
SELQ,0,0,0,1,1,4
ELQQ,0,0,0,1,1,4
LQQM,0,0,0,1,1,4
DDAD,0,0,0,1,1,4
DADL,0,0,0,1,1,4
ADLE,0,0,0,1,1,4
DLEK,0,0,0,1,1,4
LEKF,0,0,0,2,2,4
EKFV,0,0,0,1,1,4
KFVI,0,0,0,1,1,4
FVIE,0,0,0,1,1,4
VIEY,0,0,0,1,1,4
DDET,0,0,0,2,2,4
DETL,0,0,0,1,1,4
ETLG,0,0,0,1,1,4
TLGV,0,0,0,1,1,4
LGVL,0,0,0,2,2,4
GVLM,0,0,0,2,2,4
VLMW,0,0,0,1,1,4
LMWI,0,0,0,1,1,4
MWIL,0,0,0,1,1,4
WILD,0,0,0,1,1,4
ILDR,0,0,0,1,1,4
LDRS,0,0,0,1,1,4
DRSI,0,0,0,1,1,4
RSIH,0,0,0,1,1,4
DETR,0,0,0,1,1,4
ETRE,0,0,0,2,2,4
TREE,0,0,0,1,1,4
REEL,0,0,0,3,3,4
EELE,0,0,0,2,2,4
ELEE,0,0,0,4,4,4
LEEL,0,0,0,3,3,4
EELL,0,0,0,2,2,4
ELLI,0,0,0,1,1,4
LLIQ,0,0,0,2,2,4
LIQA,0,0,0,1,1,4
DDRV,0,0,0,1,1,4
DRVQ,0,0,0,1,1,4
RVQS,0,0,0,1,1,4
VQSH,0,0,0,1,1,4
QSHI,0,0,0,1,1,4
SHIL,0,0,0,1,1,4
HILH,0,0,0,2,2,4
ILHL,0,0,0,1,1,4
LHLE,0,0,0,1,1,4
HLEH,0,0,0,1,1,4
LEHD,0,0,0,1,1,4
EHDL,0,0,0,1,1,4
HDLV,0,0,0,2,2,4
DLVH,0,0,0,1,1,4
LVHV,0,0,0,1,1,4
VHVT,0,0,0,1,1,4
HVTR,0,0,0,1,1,4
VTRK,0,0,0,1,1,4
TRKN,0,0,0,1,1,4
DDYL,0,0,0,1,1,4
DYLK,0,0,0,1,1,4
YLKE,0,0,0,2,2,4
LKEQ,0,0,0,1,1,4
KEQV,0,0,0,1,1,4
EQVL,0,0,0,2,2,4
QVLH,0,0,0,1,1,4
VLHM,0,0,0,1,1,4
LHMK,0,0,0,1,1,4
HMKQ,0,0,0,1,1,4
MKQY,0,0,0,1,1,4
KQYV,0,0,0,1,1,4
QYVS,0,0,0,1,1,4
YVSD,0,0,0,1,1,4
VSDN,0,0,0,1,1,4
DEAA,0,0,0,2,2,4
EAAF,0,0,0,1,1,4
AAFQ,0,0,0,1,1,4
AFQK,0,0,0,1,1,4
FQKL,0,0,0,1,1,4
QKLM,0,0,0,1,1,4
KLMS,0,0,0,1,1,4
LMSN,0,0,0,1,1,4
MSNL,0,0,0,1,1,4
SNLD,0,0,0,1,1,4
DEAG,0,0,0,1,1,4
EAGL,0,0,0,1,1,4
AGLM,0,0,0,1,1,4
GLMR,0,0,0,1,1,4
LMRE,0,0,0,1,1,4
MREL,0,0,0,2,2,4
RELR,0,0,0,1,1,4
ELRL,0,0,0,1,1,4
LRLF,0,0,0,2,2,4
RLFR,0,0,0,2,2,4
LFRR,0,0,0,1,1,4
FRRR,0,0,0,1,1,4
RRRI,0,0,0,1,1,4
RRIM,0,0,0,1,1,4
RIMV,0,0,0,1,1,4
IMVR,0,0,0,1,1,4
MVRI,0,0,0,1,1,4
VRIA,0,0,0,2,2,4
RIAW,0,0,0,1,1,4
IAWA,0,0,0,1,1,4
AWAQ,0,0,0,1,1,4
WAQT,0,0,0,1,1,4
AQTL,0,0,0,2,2,4
DEET,0,0,0,2,2,4
EETM,0,0,0,1,1,4
ETME,0,0,0,1,1,4
TMER,0,0,0,1,1,4
MERI,0,0,0,1,1,4
ERIM,0,0,0,1,1,4
RIMR,0,0,0,1,1,4
IMRE,0,0,0,1,1,4
RELK,0,0,0,1,1,4
ELKK,0,0,0,2,2,4
LKKK,0,0,0,2,2,4
DEFT,0,0,0,1,1,4
EFTK,0,0,0,1,1,4
FTKQ,0,0,0,1,1,4
TKQH,0,0,0,1,1,4
KQHI,0,0,0,2,2,4
QHIV,0,0,0,1,1,4
HIVG,0,0,0,1,1,4
IVGK,0,0,0,1,1,4
DEKA,0,0,0,2,2,4
EKAF,0,0,0,1,1,4
AFKN,0,0,0,1,1,4
FKNT,0,0,0,1,1,4
KNTY,0,0,0,1,1,4
NTYR,0,0,0,1,1,4
TYRQ,0,0,0,1,1,4
YRQA,0,0,0,1,1,4
RQAM,0,0,0,1,1,4
QAMN,0,0,0,1,1,4
AMND,0,0,0,1,1,4
DEKK,0,0,0,1,1,4
EKKI,0,0,0,1,1,4
ILKD,0,0,0,2,2,4
LKDF,0,0,0,1,1,4
KDFL,0,0,0,1,1,4
DFLI,0,0,0,2,2,4
FLIQ,0,0,0,2,2,4
DEKS,0,0,0,1,1,4
EKSI,0,0,0,1,1,4
KSII,0,0,0,1,1,4
SIIT,0,0,0,1,1,4
IITY,0,0,0,1,1,4
ITYV,0,0,0,1,1,4
TYVS,0,0,0,1,1,4
YVSS,0,0,0,1,1,4
VSSL,0,0,0,1,1,4
SSLY,0,0,0,1,1,4
SLYD,0,0,0,2,2,4
LYDA,0,0,0,1,1,4
YDAM,0,0,0,1,1,4
DELL,0,0,0,2,2,4
ELLS,0,0,0,2,2,4
LLSK,0,0,0,2,2,4
LSKM,0,0,0,1,1,4
SKMR,0,0,0,1,1,4
KMRF,0,0,0,1,1,4
MRFA,0,0,0,1,1,4
RFAL,0,0,0,1,1,4
DEPQ,0,0,0,1,1,4
EPQV,0,0,0,1,1,4
PQVQ,0,0,0,1,1,4
QVQA,0,0,0,1,1,4
VQAK,0,0,0,1,1,4
QAKI,0,0,0,1,1,4
AKIM,0,0,0,1,1,4
KIMA,0,0,0,1,1,4
IMAY,0,0,0,1,1,4
MAYL,0,0,0,1,1,4
AYLQ,0,0,0,1,1,4
YLQQ,0,0,0,1,1,4
LQQE,0,0,0,1,1,4
QQEQ,0,0,0,1,1,4
QEQS,0,0,0,1,1,4
EQSN,0,0,0,1,1,4
QSNR,0,0,0,1,1,4
DEQY,0,0,0,1,1,4
EQYR,0,0,0,1,1,4
QYRE,0,0,0,1,1,4
YREG,0,0,0,1,1,4
REGA,0,0,0,1,1,4
EGAV,0,0,0,2,2,4
GAVR,0,0,0,2,2,4
AVRT,0,0,0,1,1,4
VRTV,0,0,0,1,1,4
RTVA,0,0,0,1,1,4
TVAS,0,0,0,1,1,4
VASF,0,0,0,1,1,4
ASFR,0,0,0,1,1,4
SFRE,0,0,0,1,1,4
FRER,0,0,0,2,2,4
RERL,0,0,0,2,2,4
ERLD,0,0,0,1,1,4
RLDR,0,0,0,1,1,4
DERL,0,0,0,1,1,4
ERLL,0,0,0,5,5,4
RLLQ,0,0,0,1,1,4
LLQK,0,0,0,1,1,4
LQKY,0,0,0,1,1,4
QKYR,0,0,0,1,1,4
KYRA,0,0,0,1,1,4
YRAQ,0,0,0,1,1,4
RAQV,0,0,0,1,1,4
AQVF,0,0,0,1,1,4
QVFE,0,0,0,1,1,4
VFEW,0,0,0,1,1,4
FEWG,0,0,0,1,1,4
DEVL,0,0,0,1,1,4
EVLL,0,0,0,1,1,4
VLLA,0,0,0,1,1,4
LAEQ,0,0,0,2,2,4
AEQL,0,0,0,1,1,4
EQLG,0,0,0,1,1,4
QLGT,0,0,0,1,1,4
DFAA,0,0,0,1,1,4
FAAL,0,0,0,1,1,4
ALAQ,0,0,0,2,2,4
LAQT,0,0,0,2,2,4
AQTA,0,0,0,1,1,4
QTAH,0,0,0,1,1,4
TAHR,0,0,0,1,1,4
AHRL,0,0,0,2,2,4
HRLK,0,0,0,1,1,4
RLKG,0,0,0,1,1,4
LKGV,0,0,0,1,1,4
KGVF,0,0,0,1,1,4
GVFA,0,0,0,1,1,4
VFAM,0,0,0,1,1,4
FAML,0,0,0,1,1,4
AMLN,0,0,0,1,1,4
DFLE,0,0,0,1,1,4
FLEE,0,0,0,1,1,4
LEEQ,0,0,0,1,1,4
EEQY,0,0,0,1,1,4
EQYK,0,0,0,1,1,4
QYKG,0,0,0,1,1,4
YKGQ,0,0,0,1,1,4
KGQR,0,0,0,1,1,4
GQRD,0,0,0,1,1,4
QRDL,0,0,0,1,1,4
RDLA,0,0,0,1,1,4
DLAG,0,0,0,1,1,4
LAGK,0,0,0,1,1,4
AGKA,0,0,0,1,1,4
GKAS,0,0,0,2,2,4
KAST,0,0,0,1,1,4
ASTL,0,0,0,1,1,4
STLK,0,0,0,1,1,4
TLKK,0,0,0,2,2,4
DFPA,0,0,0,1,1,4
FPAL,0,0,0,1,1,4
ALIK,0,0,0,1,1,4
LIKQ,0,0,0,1,1,4
IKQA,0,0,0,2,2,4
KQAS,0,0,0,1,1,4
QASL,0,0,0,2,2,4
ASLD,0,0,0,1,1,4
SLDA,0,0,0,2,2,4
LDAL,0,0,0,4,4,4
DALF,0,0,0,1,1,4
DFSE,0,0,0,1,1,4
FSET,0,0,0,2,2,4
SETI,0,0,0,1,1,4
ETIN,0,0,0,2,2,4
TINA,0,0,0,1,1,4
INAY,0,0,0,1,1,4
NAYF,0,0,0,1,1,4
AYFV,0,0,0,1,1,4
YFVA,0,0,0,1,1,4
FVAK,0,0,0,1,1,4
DGAL,0,0,0,1,1,4
GALK,0,0,0,1,1,4
ALKR,0,0,0,1,1,4
LKRA,0,0,0,4,4,4
KRAE,0,0,0,4,4,4
RAEE,0,0,0,2,2,4
AEEL,0,0,0,2,2,4
EELK,0,0,0,2,2,4
ELKT,0,0,0,1,1,4
LKTQ,0,0,0,1,1,4
KTQA,0,0,0,1,1,4
TQAN,0,0,0,1,1,4
QAND,0,0,0,1,1,4
ANDY,0,0,0,1,1,4
NDYF,0,0,0,1,1,4
DYFK,0,0,0,1,1,4
DGFS,0,0,0,1,1,4
GFSV,0,0,0,2,2,4
FSVL,0,0,0,1,1,4
SVLM,0,0,0,1,1,4
VLMR,0,0,0,1,1,4
LMRA,0,0,0,1,1,4
MRAM,0,0,0,1,1,4
RAMQ,0,0,0,1,1,4
AMQQ,0,0,0,1,1,4
DGGG,0,0,0,1,1,4
GGGF,0,0,0,1,1,4
GGFV,0,0,0,1,1,4
GFVI,0,0,0,1,1,4
FVIS,0,0,0,1,1,4
VISK,0,0,0,1,1,4
ISKH,0,0,0,1,1,4
SKHP,0,0,0,1,1,4
KHPV,0,0,0,1,1,4
HPVR,0,0,0,1,1,4
PVRL,0,0,0,1,1,4
VRLA,0,0,0,1,1,4
KKLN,0,0,0,1,1,4
KLNR,0,0,0,1,1,4
DHAV,0,0,0,1,1,4
HAVL,0,0,0,2,2,4
AVLE,0,0,0,1,1,4
VLEV,0,0,0,1,1,4
LEVL,0,0,0,2,2,4
EVLA,0,0,0,3,3,4
VLAT,0,0,0,1,1,4
LATP,0,0,0,1,1,4
ATPV,0,0,0,1,1,4
TPVR,0,0,0,1,1,4
PVRE,0,0,0,2,2,4
VREA,0,0,0,2,2,4
REAL,0,0,0,1,1,4
EALL,0,0,0,2,2,4
ALLA,0,0,0,1,1,4
LLAR,0,0,0,4,4,4
LARF,0,0,0,1,1,4
ARFG,0,0,0,1,1,4
DIFD,0,0,0,1,1,4
IFDF,0,0,0,1,1,4
FDFM,0,0,0,1,1,4
DFME,0,0,0,1,1,4
FMER,0,0,0,2,2,4
MERW,0,0,0,1,1,4
ERWI,0,0,0,1,1,4
RWIE,0,0,0,1,1,4
WIEK,0,0,0,2,2,4
IEKK,0,0,0,1,1,4
EKKL,0,0,0,1,1,4
KKLE,0,0,0,1,1,4
KLEY,0,0,0,1,1,4
LEYS,0,0,0,1,1,4
EYSA,0,0,0,1,1,4
YSAS,0,0,0,1,1,4
SASH,0,0,0,1,1,4
DIHA,0,0,0,1,1,4
IHAA,0,0,0,1,1,4
HAAI,0,0,0,1,1,4
AAIE,0,0,0,2,2,4
AIEM,0,0,0,1,1,4
IEML,0,0,0,1,1,4
EMLL,0,0,0,1,1,4
MLLG,0,0,0,1,1,4
DIIG,0,0,0,1,1,4
IIGT,0,0,0,1,1,4
IGTE,0,0,0,1,1,4
GTEI,0,0,0,1,1,4
TEIT,0,0,0,1,1,4
EITS,0,0,0,1,1,4
ITSA,0,0,0,3,3,4
TSAL,0,0,0,2,2,4
SALK,0,0,0,2,2,4
ALKN,0,0,0,2,2,4
LKNV,0,0,0,3,3,4
KNVY,0,0,0,1,1,4
NVYS,0,0,0,1,1,4
VYSI,0,0,0,1,1,4
YSIA,0,0,0,1,1,4
SIAI,0,0,0,1,1,4
IAIA,0,0,0,1,1,4
AIAW,0,0,0,1,1,4
IAWI,0,0,0,1,1,4
AWIR,0,0,0,1,1,4
WIRG,0,0,0,1,1,4
IRGY,0,0,0,1,1,4
RGYE,0,0,0,1,1,4
GYES,0,0,0,1,1,4
YESR,0,0,0,1,1,4
ESRK,0,0,0,1,1,4
SRKN,0,0,0,1,1,4
DILR,0,0,0,1,1,4
ILRE,0,0,0,1,1,4
LREI,0,0,0,2,2,4
REIG,0,0,0,1,1,4
EIGM,0,0,0,1,1,4
IGMI,0,0,0,1,1,4
GMIA,0,0,0,1,1,4
MIAR,0,0,0,1,1,4
IARA,0,0,0,1,1,4
ARAL,0,0,0,4,4,4
RALD,0,0,0,2,2,4
ALDS,0,0,0,1,1,4
LDSI,0,0,0,3,3,4
DSIS,0,0,0,1,1,4
SISN,0,0,0,1,1,4
ISNI,0,0,0,1,1,4
SNIE,0,0,0,1,1,4
NIEF,0,0,0,1,1,4
DIRA,0,0,0,1,1,4
IRAV,0,0,0,1,1,4
RAVL,0,0,0,1,1,4
AVLR,0,0,0,2,2,4
VLRD,0,0,0,1,1,4
LRDL,0,0,0,1,1,4
RDLS,0,0,0,1,1,4
DLSF,0,0,0,1,1,4
LSFH,0,0,0,1,1,4
SFHL,0,0,0,1,1,4
FHLN,0,0,0,1,1,4
HLNG,0,0,0,1,1,4
LNGH,0,0,0,1,1,4
NGHI,0,0,0,1,1,4
GHIL,0,0,0,1,1,4
ILHS,0,0,0,1,1,4
LHSI,0,0,0,1,1,4
HSIF,0,0,0,1,1,4
SIFW,0,0,0,1,1,4
IFWP,0,0,0,1,1,4
FWPN,0,0,0,1,1,4
WPNM,0,0,0,1,1,4
DIRT,0,0,0,1,1,4
IRTS,0,0,0,1,1,4
RTSL,0,0,0,1,1,4
TSLA,0,0,0,1,1,4
SLAN,0,0,0,1,1,4
LAND,0,0,0,1,1,4
ANDM,0,0,0,1,1,4
NDMA,0,0,0,1,1,4
DMAI,0,0,0,1,1,4
MAIY,0,0,0,1,1,4
AIYG,0,0,0,1,1,4
IYGD,0,0,0,1,1,4
YGDI,0,0,0,1,1,4
GDII,0,0,0,1,1,4
DIIE,0,0,0,2,2,4
IIEA,0,0,0,2,2,4
IEAT,0,0,0,1,1,4
EATR,0,0,0,1,1,4
ATRE,0,0,0,1,1,4
TREH,0,0,0,2,2,4
REHT,0,0,0,1,1,4
EHTE,0,0,0,1,1,4
HTEL,0,0,0,1,1,4
TELA,0,0,0,1,1,4
ELAE,0,0,0,2,2,4
LAEN,0,0,0,2,2,4
AENL,0,0,0,1,1,4
DIYQ,0,0,0,1,1,4
IYQQ,0,0,0,1,1,4
YQQV,0,0,0,1,1,4
QQVR,0,0,0,1,1,4
QVRD,0,0,0,1,1,4
VRDE,0,0,0,1,1,4
RDEL,0,0,0,2,2,4
DELK,0,0,0,1,1,4
ELKR,0,0,0,1,1,4
KRAS,0,0,0,1,1,4
DKET,0,0,0,1,1,4
KETM,0,0,0,1,1,4
ETMN,0,0,0,1,1,4
TMNI,0,0,0,1,1,4
MNIH,0,0,0,1,1,4
NIHH,0,0,0,1,1,4
IHHT,0,0,0,1,1,4
HHTK,0,0,0,1,1,4
DLAA,0,0,0,2,2,4
LAAN,0,0,0,3,3,4
AANN,0,0,0,1,1,4
ANNG,0,0,0,1,1,4
NNGG,0,0,0,1,1,4
NGGW,0,0,0,1,1,4
GGWQ,0,0,0,1,1,4
GWQW,0,0,0,1,1,4
WQWS,0,0,0,1,1,4
DLAR,0,0,0,1,1,4
LARI,0,0,0,1,1,4
ARIE,0,0,0,1,1,4
RIEQ,0,0,0,1,1,4
IEQF,0,0,0,1,1,4
EQFL,0,0,0,1,1,4
QFLD,0,0,0,2,2,4
FLDA,0,0,0,1,1,4
DALW,0,0,0,1,1,4
ALWL,0,0,0,1,1,4
LWLE,0,0,0,1,1,4
DLEA,0,0,0,2,2,4
LEAK,0,0,0,2,2,4
EAKK,0,0,0,2,2,4
AKKM,0,0,0,1,1,4
KKMY,0,0,0,1,1,4
KMYF,0,0,0,1,1,4
MYFD,0,0,0,1,1,4
YFDA,0,0,0,2,2,4
FDAV,0,0,0,1,1,4
DAVQ,0,0,0,1,1,4
AVQA,0,0,0,2,2,4
VQAI,0,0,0,3,3,4
QAIE,0,0,0,1,1,4
AIET,0,0,0,1,1,4
IETH,0,0,0,1,1,4
ETHL,0,0,0,1,1,4
DLES,0,0,0,1,1,4
LESD,0,0,0,1,1,4
ESDA,0,0,0,1,1,4
SDAL,0,0,0,1,1,4
DALG,0,0,0,1,1,4
ALGW,0,0,0,2,2,4
LGWQ,0,0,0,1,1,4
GWQY,0,0,0,1,1,4
WQYI,0,0,0,1,1,4
QYIT,0,0,0,1,1,4
YITG,0,0,0,1,1,4
DLGR,0,0,0,1,1,4
LGRK,0,0,0,1,1,4
GRKI,0,0,0,1,1,4
RKIT,0,0,0,1,1,4
KITS,0,0,0,1,1,4
SALR,0,0,0,2,2,4
ALRS,0,0,0,1,1,4
LRSL,0,0,0,2,2,4
RSLS,0,0,0,1,1,4
SLSN,0,0,0,1,1,4
DLKQ,0,0,0,1,1,4
LKQA,0,0,0,1,1,4
KQAE,0,0,0,2,2,4
QAES,0,0,0,1,1,4
AESW,0,0,0,1,1,4
ESWL,0,0,0,1,1,4
SWLH,0,0,0,1,1,4
WLHK,0,0,0,1,1,4
LHKQ,0,0,0,1,1,4
HKQA,0,0,0,1,1,4
KQAQ,0,0,0,1,1,4
QAQK,0,0,0,1,1,4
AQKE,0,0,0,1,1,4
QKEG,0,0,0,1,1,4
KEGW,0,0,0,1,1,4
EGWS,0,0,0,1,1,4
GWSK,0,0,0,1,1,4
WSKA,0,0,0,1,1,4
SKAA,0,0,0,1,1,4
KAAR,0,0,0,1,1,4
AARL,0,0,0,2,2,4
ARLH,0,0,0,1,1,4
DLKR,0,0,0,1,1,4
RAES,0,0,0,1,1,4
AESM,0,0,0,1,1,4
ESML,0,0,0,2,2,4
SMLQ,0,0,0,1,1,4
MLQQ,0,0,0,1,1,4
LQQA,0,0,0,2,2,4
DLKT,0,0,0,1,1,4
LKTM,0,0,0,1,1,4
KTMT,0,0,0,1,1,4
TMTE,0,0,0,2,2,4
MTER,0,0,0,1,1,4
TERL,0,0,0,1,1,4
ERLR,0,0,0,2,2,4
RLRS,0,0,0,1,1,4
DLQL,0,0,0,1,1,4
LQLN,0,0,0,1,1,4
QLNA,0,0,0,1,1,4
LNAN,0,0,0,1,1,4
NANA,0,0,0,1,1,4
ANAE,0,0,0,1,1,4
NAER,0,0,0,1,1,4
AERI,0,0,0,1,1,4
ERIN,0,0,0,2,2,4
RINV,0,0,0,1,1,4
INVY,0,0,0,1,1,4
NVYY,0,0,0,1,1,4
DLRE,0,0,0,1,1,4
LREL,0,0,0,1,1,4
RELI,0,0,0,3,3,4
ELIA,0,0,0,1,1,4
LIAR,0,0,0,2,2,4
IARV,0,0,0,2,2,4
ARVR,0,0,0,2,2,4
RVRA,0,0,0,2,2,4
VRAL,0,0,0,1,1,4
RALI,0,0,0,1,1,4
ALIR,0,0,0,1,1,4
LIRR,0,0,0,1,1,4
IRRK,0,0,0,1,1,4
RRKS,0,0,0,1,1,4
DLSA,0,0,0,2,2,4
LSAS,0,0,0,2,2,4
SASR,0,0,0,1,1,4
ASRS,0,0,0,1,1,4
SRSA,0,0,0,1,1,4
RSAI,0,0,0,3,3,4
SAID,0,0,0,1,1,4
AIDS,0,0,0,1,1,4
IDSL,0,0,0,1,1,4
DSLN,0,0,0,1,1,4
SLNN,0,0,0,1,1,4
LNNR,0,0,0,1,1,4
NNRM,0,0,0,1,1,4
NRML,0,0,0,1,1,4
RMLS,0,0,0,1,1,4
MLSQ,0,0,0,1,1,4
LSQI,0,0,0,1,1,4
SQIW,0,0,0,1,1,4
QIWS,0,0,0,1,1,4
IWSH,0,0,0,1,1,4
DLVD,0,0,0,1,1,4
LVDF,0,0,0,1,1,4
VDFA,0,0,0,1,1,4
DFAV,0,0,0,1,1,4
FAVE,0,0,0,1,1,4
AVEY,0,0,0,1,1,4
VEYF,0,0,0,1,1,4
EYFT,0,0,0,1,1,4
YFTR,0,0,0,1,1,4
FTRL,0,0,0,1,1,4
TRLR,0,0,0,1,1,4
RLRE,0,0,0,1,1,4
LREA,0,0,0,1,1,4
EARR,0,0,0,1,1,4
ARRG,0,0,0,1,1,4
RRGL,0,0,0,2,2,4
RGLE,0,0,0,1,1,4
GLEH,0,0,0,1,1,4
LEHH,0,0,0,1,1,4
EHHH,0,0,0,1,1,4
DMAS,0,0,0,1,1,4
MASL,0,0,0,1,1,4
ASLQ,0,0,0,2,2,4
SLQQ,0,0,0,1,1,4
LQQQ,0,0,0,1,1,4
QQQR,0,0,0,1,1,4
QQRQ,0,0,0,1,1,4
QRQE,0,0,0,1,1,4
DMNQ,0,0,0,1,1,4
MNQV,0,0,0,1,1,4
NQVL,0,0,0,1,1,4
QVLD,0,0,0,3,3,4
VLDA,0,0,0,1,1,4
LDAY,0,0,0,2,2,4
DAYE,0,0,0,1,1,4
AYEN,0,0,0,2,2,4
DNAM,0,0,0,1,1,4
NAMA,0,0,0,1,1,4
AMAN,0,0,0,1,1,4
MANQ,0,0,0,1,1,4
ANQY,0,0,0,1,1,4
NQYE,0,0,0,1,1,4
QYET,0,0,0,1,1,4
YETL,0,0,0,2,2,4
ETLA,0,0,0,2,2,4
TLAN,0,0,0,1,1,4
LANA,0,0,0,2,2,4
ANAR,0,0,0,1,1,4
NARQ,0,0,0,1,1,4
ARQK,0,0,0,1,1,4
RQKG,0,0,0,1,1,4
QKGI,0,0,0,1,1,4
KGIE,0,0,0,1,1,4
GIEK,0,0,0,1,1,4
IEKY,0,0,0,2,2,4
EKYL,0,0,0,2,2,4
DNKT,0,0,0,1,1,4
NKTR,0,0,0,1,1,4
KTRF,0,0,0,1,1,4
TRFK,0,0,0,1,1,4
RFKI,0,0,0,1,1,4
FKII,0,0,0,2,2,4
IIKE,0,0,0,1,1,4
IKEK,0,0,0,1,1,4
KEKL,0,0,0,2,2,4
EKLK,0,0,0,1,1,4
KLKE,0,0,0,2,2,4
LKEF,0,0,0,1,1,4
DNTY,0,0,0,1,1,4
NTYL,0,0,0,1,1,4
TYLN,0,0,0,1,1,4
YLNT,0,0,0,1,1,4
LNTA,0,0,0,1,1,4
NTAE,0,0,0,1,1,4
TAES,0,0,0,2,2,4
AESL,0,0,0,1,1,4
ESLY,0,0,0,2,2,4
LYDE,0,0,0,1,1,4
YDEF,0,0,0,1,1,4
DNVV,0,0,0,1,1,4
NVVL,0,0,0,1,1,4
VVLQ,0,0,0,2,2,4
VLQL,0,0,0,1,1,4
LQLQ,0,0,0,1,1,4
QLQV,0,0,0,1,1,4
LQVA,0,0,0,2,2,4
QVAR,0,0,0,2,2,4
VARF,0,0,0,1,1,4
ARFL,0,0,0,1,1,4
RFLM,0,0,0,1,1,4
FLMK,0,0,0,1,1,4
LMKT,0,0,0,1,1,4
MKTV,0,0,0,2,2,4
TVAQ,0,0,0,1,1,4
DPAR,0,0,0,1,1,4
PARA,0,0,0,2,2,4
RALF,0,0,0,1,1,4
ALFA,0,0,0,1,1,4
LFAA,0,0,0,1,1,4
FAAM,0,0,0,1,1,4
AAMS,0,0,0,1,1,4
AMSQ,0,0,0,1,1,4
DPAT,0,0,0,1,1,4
PATV,0,0,0,1,1,4
ATVK,0,0,0,1,1,4
TVKK,0,0,0,1,1,4
KVVN,0,0,0,1,1,4
VVNF,0,0,0,1,1,4
VNFL,0,0,0,2,2,4
DPAW,0,0,0,1,1,4
PAWQ,0,0,0,1,1,4
AWQG,0,0,0,1,1,4
WQGF,0,0,0,1,1,4
QGFR,0,0,0,1,1,4
GFRE,0,0,0,1,1,4
FREL,0,0,0,1,1,4
ELIE,0,0,0,3,3,4
LIEK,0,0,0,1,1,4
IEKA,0,0,0,1,1,4
EKAL,0,0,0,1,1,4
DPEK,0,0,0,1,1,4
PEKV,0,0,0,2,2,4
EKVL,0,0,0,1,1,4
KVLF,0,0,0,1,1,4
VLFL,0,0,0,1,1,4
FLAG,0,0,0,2,2,4
LAGN,0,0,0,1,1,4
GNLL,0,0,0,1,1,4
NLLA,0,0,0,1,1,4
LARL,0,0,0,2,2,4
ARLT,0,0,0,2,2,4
RLTE,0,0,0,1,1,4
DPET,0,0,0,2,2,4
PETL,0,0,0,1,1,4
ETLE,0,0,0,2,2,4
TLEA,0,0,0,1,1,4
LEAI,0,0,0,1,1,4
EAIA,0,0,0,2,2,4
AIAE,0,0,0,3,3,4
IAEN,0,0,0,1,1,4
PETN,0,0,0,1,1,4
ETNI,0,0,0,2,2,4
TNIN,0,0,0,1,1,4
NINI,0,0,0,1,1,4
INIG,0,0,0,1,1,4
NIGT,0,0,0,1,1,4
IGTS,0,0,0,1,1,4
GTSY,0,0,0,1,1,4
TSYL,0,0,0,1,1,4
SYLQ,0,0,0,1,1,4
YLQY,0,0,0,1,1,4
LQYV,0,0,0,1,1,4
QYVY,0,0,0,1,1,4
YVYQ,0,0,0,1,1,4
VYQQ,0,0,0,1,1,4
YQQF,0,0,0,1,1,4
DPKR,0,0,0,1,1,4
PKRL,0,0,0,1,1,4
KRLQ,0,0,0,4,4,4
RLQA,0,0,0,1,1,4
LQAS,0,0,0,1,1,4
SLQT,0,0,0,1,1,4
LQTI,0,0,0,1,1,4
QTIV,0,0,0,1,1,4
TIVG,0,0,0,1,1,4
IVGM,0,0,0,1,1,4
VGMV,0,0,0,2,2,4
GMVV,0,0,0,1,1,4
MVVY,0,0,0,1,1,4
VVYS,0,0,0,1,1,4
VYSW,0,0,0,1,1,4
DPLR,0,0,0,1,1,4
PLRE,0,0,0,1,1,4
LRER,0,0,0,1,1,4
RERQ,0,0,0,1,1,4
ERQV,0,0,0,1,1,4
RQVA,0,0,0,2,2,4
QVAE,0,0,0,2,2,4
VAEK,0,0,0,2,2,4
AEKQ,0,0,0,1,1,4
EKQL,0,0,0,1,1,4
KQLA,0,0,0,2,2,4
QLAA,0,0,0,1,1,4
LAAL,0,0,0,3,3,4
AALG,0,0,0,1,1,4
ALGD,0,0,0,2,2,4
LGDI,0,0,0,1,1,4
GDIL,0,0,0,1,1,4
DILS,0,0,0,1,1,4
ILSA,0,0,0,1,1,4
DPLW,0,0,0,1,1,4
PLWK,0,0,0,1,1,4
LWKK,0,0,0,1,1,4
WKKE,0,0,0,1,1,4
KKEM,0,0,0,2,2,4
KEMF,0,0,0,1,1,4
EMFE,0,0,0,1,1,4
MFEK,0,0,0,3,3,4
FEKY,0,0,0,1,1,4
KYLS,0,0,0,1,1,4
YLSN,0,0,0,1,1,4
DPQK,0,0,0,2,2,4
PQKA,0,0,0,1,1,4
QKAD,0,0,0,1,1,4
ADAV,0,0,0,1,1,4
DAVA,0,0,0,1,1,4
AVAV,0,0,0,1,1,4
VAVN,0,0,0,1,1,4
PQKR,0,0,0,1,1,4
QKRA,0,0,0,1,1,4
KRAV,0,0,0,3,3,4
RAVV,0,0,0,1,1,4
AVVN,0,0,0,1,1,4
VVNQ,0,0,0,1,1,4
VNQR,0,0,0,1,1,4
NQRL,0,0,0,1,1,4
QRLY,0,0,0,1,1,4
RLYF,0,0,0,1,1,4
LYFD,0,0,0,1,1,4
YFDM,0,0,0,1,1,4
FDMG,0,0,0,1,1,4
DMGT,0,0,0,1,1,4
DPTK,0,0,0,1,1,4
PTKL,0,0,0,2,2,4
TKLN,0,0,0,1,1,4
KLNH,0,0,0,1,1,4
LNHA,0,0,0,1,1,4
NHAV,0,0,0,1,1,4
HAVA,0,0,0,1,1,4
AVAG,0,0,0,1,1,4
DPYV,0,0,0,1,1,4
PYVI,0,0,0,1,1,4
YVIL,0,0,0,1,1,4
VILI,0,0,0,1,1,4
ILIT,0,0,0,1,1,4
LITE,0,0,0,1,1,4
ITEI,0,0,0,1,1,4
TEIL,0,0,0,1,1,4
EILL,0,0,0,2,2,4
DQDK,0,0,0,1,1,4
QDKI,0,0,0,1,1,4
DKIQ,0,0,0,1,1,4
KIQK,0,0,0,2,2,4
IQKA,0,0,0,1,1,4
QKAI,0,0,0,1,1,4
KAIA,0,0,0,1,1,4
AIAA,0,0,0,4,4,4
IAAG,0,0,0,1,1,4
DQED,0,0,0,1,1,4
QEDV,0,0,0,1,1,4
EDVA,0,0,0,2,2,4
DVAQ,0,0,0,2,2,4
VAQT,0,0,0,1,1,4
AQTI,0,0,0,1,1,4
QTIR,0,0,0,1,1,4
TIRD,0,0,0,1,1,4
IRDY,0,0,0,1,1,4
RDYD,0,0,0,1,1,4
DQGT,0,0,0,1,1,4
QGTL,0,0,0,1,1,4
GTLF,0,0,0,1,1,4
TLFE,0,0,0,1,1,4
LFEL,0,0,0,1,1,4
FELI,0,0,0,1,1,4
ELIL,0,0,0,1,1,4
LILA,0,0,0,1,1,4
ILAA,0,0,0,1,1,4
AANY,0,0,0,1,1,4
ANYL,0,0,0,1,1,4
NYLD,0,0,0,1,1,4
DQHL,0,0,0,1,1,4
QHLM,0,0,0,1,1,4
HLMA,0,0,0,1,1,4
LMAE,0,0,0,1,1,4
MAEY,0,0,0,1,1,4
AEYR,0,0,0,1,1,4
EYRE,0,0,0,1,1,4
YREL,0,0,0,2,2,4
RELP,0,0,0,1,1,4
ELPR,0,0,0,1,1,4
LPRV,0,0,0,1,1,4
PRVF,0,0,0,1,1,4
RVFG,0,0,0,1,1,4
VFGA,0,0,0,1,1,4
FGAV,0,0,0,1,1,4
AVRK,0,0,0,1,1,4
VRKH,0,0,0,2,2,4
RKHV,0,0,0,2,2,4
KHVA,0,0,0,2,2,4
HVAN,0,0,0,1,1,4
VANG,0,0,0,1,1,4
DQNG,0,0,0,1,1,4
QNGE,0,0,0,1,1,4
NGEI,0,0,0,1,1,4
GEIY,0,0,0,1,1,4
EIYM,0,0,0,1,1,4
IYMW,0,0,0,1,1,4
YMWP,0,0,0,1,1,4
MWPV,0,0,0,1,1,4
WPVA,0,0,0,1,1,4
PVAQ,0,0,0,1,1,4
VAQA,0,0,0,1,1,4
DQQG,0,0,0,1,1,4
QQGV,0,0,0,1,1,4
QGVF,0,0,0,2,2,4
GVFV,0,0,0,1,1,4
VFVK,0,0,0,1,1,4
FVKG,0,0,0,1,1,4
VKGY,0,0,0,2,2,4
KGYA,0,0,0,1,1,4
GYAM,0,0,0,1,1,4
DRAS,0,0,0,1,1,4
RASY,0,0,0,1,1,4
ASYE,0,0,0,1,1,4
SYEA,0,0,0,1,1,4
YEAR,0,0,0,1,1,4
EARE,0,0,0,1,1,4
ARER,0,0,0,1,1,4
RERH,0,0,0,1,1,4
ERHV,0,0,0,1,1,4
RHVA,0,0,0,1,1,4
HVAE,0,0,0,2,2,4
VAER,0,0,0,2,2,4
AERL,0,0,0,2,2,4
RLLM,0,0,0,1,1,4
LLMH,0,0,0,1,1,4
LMHL,0,0,0,1,1,4
MHLE,0,0,0,1,1,4
HLEE,0,0,0,2,2,4
LEEM,0,0,0,1,1,4
DRAV,0,0,0,1,1,4
RAVI,0,0,0,1,1,4
AVIE,0,0,0,1,1,4
VIEH,0,0,0,1,1,4
IEHN,0,0,0,1,1,4
EHNL,0,0,0,1,1,4
HNLL,0,0,0,1,1,4
NLLS,0,0,0,1,1,4
LLSA,0,0,0,1,1,4
SASK,0,0,0,1,1,4
ASKL,0,0,0,1,1,4
DRQL,0,0,0,1,1,4
RQLR,0,0,0,1,1,4
QLRS,0,0,0,2,2,4
LRSS,0,0,0,1,1,4
RSSI,0,0,0,1,1,4
SSIE,0,0,0,1,1,4
SIER,0,0,0,2,2,4
IERV,0,0,0,1,1,4
ERVI,0,0,0,1,1,4
RVIS,0,0,0,1,1,4
VISI,0,0,0,1,1,4
ISIF,0,0,0,1,1,4
SIFQ,0,0,0,1,1,4
IFQS,0,0,0,2,2,4
DRTS,0,0,0,1,1,4
RTSF,0,0,0,1,1,4
TSFD,0,0,0,2,2,4
SFDK,0,0,0,1,1,4
FDKL,0,0,0,1,1,4
DKLA,0,0,0,4,4,4
KLAN,0,0,0,1,1,4
LANS,0,0,0,1,1,4
DSEQ,0,0,0,1,1,4
SEQV,0,0,0,1,1,4
EQVV,0,0,0,1,1,4
QVVH,0,0,0,1,1,4
VVHQ,0,0,0,1,1,4
VHQL,0,0,0,1,1,4
HQLE,0,0,0,1,1,4
QLER,0,0,0,2,2,4
LERL,0,0,0,2,2,4
ERLI,0,0,0,4,4,4
RLIA,0,0,0,2,2,4
DSGY,0,0,0,1,1,4
SGYR,0,0,0,1,1,4
GYRS,0,0,0,1,1,4
YRSA,0,0,0,2,2,4
RSAM,0,0,0,1,1,4
SAMS,0,0,0,1,1,4
AMSV,0,0,0,1,1,4
MSVQ,0,0,0,1,1,4
SVQS,0,0,0,1,1,4
VQSS,0,0,0,1,1,4
QSSL,0,0,0,1,1,4
DSMV,0,0,0,1,1,4
SMVV,0,0,0,1,1,4
MVVL,0,0,0,1,1,4
VLQQ,0,0,0,2,2,4
LQQR,0,0,0,1,1,4
QQRA,0,0,0,1,1,4
QRAY,0,0,0,1,1,4
RAYE,0,0,0,1,1,4
AYEI,0,0,0,1,1,4
YEIL,0,0,0,2,2,4
EILM,0,0,0,1,1,4
ILMT,0,0,0,2,2,4
LMTI,0,0,0,1,1,4
MTIM,0,0,0,1,1,4
TIME,0,0,0,1,1,4
DSSV,0,0,0,1,1,4
SSVI,0,0,0,1,1,4
SVII,0,0,0,1,1,4
VIIS,0,0,0,1,1,4
IISA,0,0,0,1,1,4
ISAL,0,0,0,1,1,4
ALKT,0,0,0,1,1,4
LKTY,0,0,0,1,1,4
KTYL,0,0,0,1,1,4
TYLV,0,0,0,1,1,4
YLVS,0,0,0,1,1,4
LVSG,0,0,0,1,1,4
DSVA,0,0,0,1,1,4
SVAS,0,0,0,1,1,4
VASL,0,0,0,2,2,4
ASLL,0,0,0,1,1,4
SLLD,0,0,0,1,1,4
LLDV,0,0,0,1,1,4
LDVV,0,0,0,1,1,4
DVVK,0,0,0,1,1,4
VVKS,0,0,0,1,1,4
VKST,0,0,0,1,1,4
KSTG,0,0,0,1,1,4
DSVT,0,0,0,1,1,4
SVTN,0,0,0,1,1,4
VTND,0,0,0,1,1,4
TNDI,0,0,0,1,1,4
NDIF,0,0,0,1,1,4
DIFN,0,0,0,2,2,4
IFNV,0,0,0,1,1,4
FNVA,0,0,0,1,1,4
NVAK,0,0,0,1,1,4
VAKA,0,0,0,1,1,4
KASI,0,0,0,2,2,4
ASIE,0,0,0,1,1,4
SIEK,0,0,0,1,1,4
IEKH,0,0,0,1,1,4
EKHI,0,0,0,1,1,4
KHIW,0,0,0,1,1,4
HIWM,0,0,0,1,1,4
IWML,0,0,0,1,1,4
WMLQ,0,0,0,1,1,4
MLQA,0,0,0,2,2,4
LQAE,0,0,0,1,1,4
QAEL,0,0,0,1,1,4
DTAF,0,0,0,1,1,4
TAFL,0,0,0,1,1,4
AFLM,0,0,0,1,1,4
FLME,0,0,0,1,1,4
LMEQ,0,0,0,1,1,4
MEQL,0,0,0,1,1,4
EQLE,0,0,0,2,2,4
QLEL,0,0,0,1,1,4
LELR,0,0,0,1,1,4
ELRE,0,0,0,2,2,4
LREE,0,0,0,1,1,4
EELD,0,0,0,1,1,4
ELDE,0,0,0,2,2,4
LDEI,0,0,0,1,1,4
DEIE,0,0,0,2,2,4
EIEQ,0,0,0,1,1,4
IEQA,0,0,0,3,3,4
EQAK,0,0,0,2,2,4
DTMK,0,0,0,1,1,4
TMKD,0,0,0,1,1,4
MKDA,0,0,0,1,1,4
KDAG,0,0,0,1,1,4
DAGM,0,0,0,1,1,4
AGMQ,0,0,0,1,1,4
GMQM,0,0,0,1,1,4
MQMK,0,0,0,1,1,4
QMKK,0,0,0,1,1,4
MKKV,0,0,0,1,1,4
KVLD,0,0,0,1,1,4
VLDS,0,0,0,1,1,4
DTRA,0,0,0,1,1,4
TRAW,0,0,0,1,1,4
RAWA,0,0,0,1,1,4
AWAL,0,0,0,2,2,4
LAEK,0,0,0,2,2,4
AEKL,0,0,0,3,3,4
EKLF,0,0,0,2,2,4
KLFG,0,0,0,1,1,4
DVAL,0,0,0,1,1,4
ALAD,0,0,0,1,1,4
LADS,0,0,0,1,1,4
ADSF,0,0,0,1,1,4
DSFD,0,0,0,1,1,4
SFDA,0,0,0,1,1,4
FDAL,0,0,0,1,1,4
DVEA,0,0,0,1,1,4
VEAV,0,0,0,1,1,4
EAVE,0,0,0,3,3,4
AVEI,0,0,0,3,3,4
VEIM,0,0,0,1,1,4
EIMQ,0,0,0,1,1,4
IMQR,0,0,0,1,1,4
MQRI,0,0,0,1,1,4
QRIH,0,0,0,1,1,4
RIHV,0,0,0,1,1,4
IHVL,0,0,0,1,1,4
HVLR,0,0,0,1,1,4
VLRS,0,0,0,1,1,4
LRSQ,0,0,0,1,1,4
RSQG,0,0,0,1,1,4
SQGG,0,0,0,1,1,4
QGGF,0,0,0,1,1,4
GGFN,0,0,0,1,1,4
DVLA,0,0,0,2,2,4
VLAE,0,0,0,2,2,4
LAED,0,0,0,2,2,4
AEDT,0,0,0,1,1,4
EDTI,0,0,0,1,1,4
DTIT,0,0,0,1,1,4
TITA,0,0,0,1,1,4
ITAL,0,0,0,1,1,4
TALL,0,0,0,1,1,4
ALLH,0,0,0,1,1,4
DVRV,0,0,0,1,1,4
VRVK,0,0,0,1,1,4
RVKE,0,0,0,2,2,4
VKEY,0,0,0,1,1,4
KEYF,0,0,0,1,1,4
EYFD,0,0,0,1,1,4
YFDD,0,0,0,1,1,4
FDDI,0,0,0,1,1,4
DDIA,0,0,0,1,1,4
DIAR,0,0,0,1,1,4
IARY,0,0,0,1,1,4
ARYF,0,0,0,1,1,4
RYFS,0,0,0,1,1,4
YFSI,0,0,0,1,1,4
FSIG,0,0,0,1,1,4
SIGL,0,0,0,2,2,4
IGLL,0,0,0,1,1,4
GLLN,0,0,0,1,1,4
LLNL,0,0,0,1,1,4
LNLI,0,0,0,1,1,4
NLIH,0,0,0,1,1,4
LIHL,0,0,0,2,2,4
IHLF,0,0,0,1,1,4
HLFG,0,0,0,1,1,4
DWGE,0,0,0,1,1,4
WGEA,0,0,0,1,1,4
GEAF,0,0,0,1,1,4
EAFT,0,0,0,1,1,4
AFTA,0,0,0,1,1,4
FTAI,0,0,0,1,1,4
TAIN,0,0,0,1,1,4
AINL,0,0,0,1,1,4
DWLK,0,0,0,1,1,4
WLKR,0,0,0,1,1,4
LKRL,0,0,0,1,1,4
RLQK,0,0,0,1,1,4
LQKI,0,0,0,1,1,4
QKIF,0,0,0,1,1,4
KIFP,0,0,0,1,1,4
IFPP,0,0,0,1,1,4
FPPI,0,0,0,1,1,4
PPIL,0,0,0,1,1,4
PILS,0,0,0,1,1,4
ILSI,0,0,0,1,1,4
DWYR,0,0,0,1,1,4
WYRT,0,0,0,1,1,4
YRTY,0,0,0,1,1,4
RTYA,0,0,0,1,1,4
TYAE,0,0,0,1,1,4
YAEL,0,0,0,1,1,4
AELR,0,0,0,1,1,4
LRET,0,0,0,1,1,4
RETA,0,0,0,1,1,4
DYER,0,0,0,1,1,4
YERF,0,0,0,1,1,4
ERFK,0,0,0,1,1,4
RFKS,0,0,0,1,1,4
FKSY,0,0,0,1,1,4
KSYI,0,0,0,2,2,4
SYIQ,0,0,0,1,1,4
YIQT,0,0,0,1,1,4
IQTL,0,0,0,2,2,4
ALVH,0,0,0,1,1,4
LVHK,0,0,0,2,2,4
VHKL,0,0,0,2,2,4
HKLT,0,0,0,1,1,4
KLTE,0,0,0,1,1,4
LTER,0,0,0,1,1,4
TERM,0,0,0,1,1,4
EAQK,0,0,0,1,1,4
AQKI,0,0,0,1,1,4
QKID,0,0,0,1,1,4
KIDR,0,0,0,1,1,4
IDRL,0,0,0,1,1,4
DRLV,0,0,0,1,1,4
RLVQ,0,0,0,1,1,4
LVQS,0,0,0,1,1,4
VQSF,0,0,0,1,1,4
QSFS,0,0,0,1,1,4
SFSG,0,0,0,1,1,4
FSGA,0,0,0,1,1,4
SGAY,0,0,0,1,1,4
GAYF,0,0,0,1,1,4
AYFQ,0,0,0,1,1,4
YFQQ,0,0,0,1,1,4
FQQN,0,0,0,1,1,4
EDDI,0,0,0,1,1,4
DDIM,0,0,0,1,1,4
DIMY,0,0,0,1,1,4
IMYL,0,0,0,1,1,4
MYLM,0,0,0,1,1,4
EDDS,0,0,0,1,1,4
DDSK,0,0,0,1,1,4
DSKL,0,0,0,1,1,4
SKLA,0,0,0,1,1,4
KLAS,0,0,0,1,1,4
ASRK,0,0,0,2,2,4
SRKY,0,0,0,1,1,4
RKYA,0,0,0,1,1,4
KYAR,0,0,0,1,1,4
YARI,0,0,0,1,1,4
ARII,0,0,0,1,1,4
RIIQ,0,0,0,1,1,4
IIQK,0,0,0,1,1,4
IQKI,0,0,0,1,1,4
EDKE,0,0,0,1,1,4
DKEA,0,0,0,1,1,4
KEAV,0,0,0,2,2,4
EAVF,0,0,0,1,1,4
AVFD,0,0,0,2,2,4
VFDV,0,0,0,1,1,4
FDVV,0,0,0,1,1,4
DVVD,0,0,0,1,1,4
VVDT,0,0,0,1,1,4
DTLT,0,0,0,1,1,4
TLTA,0,0,0,1,1,4
LTAV,0,0,0,1,1,4
TAVL,0,0,0,1,1,4
AVLQ,0,0,0,1,1,4
VLQV,0,0,0,2,2,4
QVAT,0,0,0,1,1,4
VATG,0,0,0,2,2,4
ATGV,0,0,0,1,1,4
TGVI,0,0,0,1,1,4
GVIS,0,0,0,1,1,4
VIST,0,0,0,2,2,4
ISTL,0,0,0,1,1,4
EDLP,0,0,0,1,1,4
DLPK,0,0,0,1,1,4
PKWS,0,0,0,1,1,4
KWSG,0,0,0,1,1,4
WSGY,0,0,0,1,1,4
SGYF,0,0,0,1,1,4
GYFE,0,0,0,1,1,4
YFEK,0,0,0,1,1,4
FEKL,0,0,0,2,2,4
EKLL,0,0,0,3,3,4
LKKN,0,0,0,1,1,4
EDMI,0,0,0,1,1,4
DMIF,0,0,0,1,1,4
MIFE,0,0,0,1,1,4
IFEI,0,0,0,1,1,4
FEIF,0,0,0,1,1,4
IFKN,0,0,0,1,1,4
FKNY,0,0,0,1,1,4
KNYL,0,0,0,1,1,4
NYLT,0,0,0,1,1,4
YLTK,0,0,0,1,1,4
LTKV,0,0,0,1,1,4
TKVA,0,0,0,1,1,4
KVAY,0,0,0,1,1,4
VAYY,0,0,0,2,2,4
AYYA,0,0,0,1,1,4
YYAR,0,0,0,1,1,4
YARQ,0,0,0,1,1,4
ARQV,0,0,0,1,1,4
VAEM,0,0,0,1,1,4
AEMN,0,0,0,1,1,4
EDNL,0,0,0,1,1,4
DNLL,0,0,0,1,1,4
NLLR,0,0,0,1,1,4
LLRQ,0,0,0,1,1,4
LRQL,0,0,0,2,2,4
RQLA,0,0,0,1,1,4
QLAQ,0,0,0,2,2,4
LAQK,0,0,0,1,1,4
AQKV,0,0,0,1,1,4
EELH,0,0,0,1,1,4
ELHT,0,0,0,1,1,4
LHTS,0,0,0,1,1,4
HTSL,0,0,0,1,1,4
TSLV,0,0,0,1,1,4
SLVE,0,0,0,2,2,4
LVEE,0,0,0,2,2,4
VEEL,0,0,0,2,2,4
EEMI,0,0,0,1,1,4
EMIA,0,0,0,1,1,4
MIAE,0,0,0,1,1,4
IAEF,0,0,0,1,1,4
AEFK,0,0,0,1,1,4
EFKA,0,0,0,1,1,4
FKAA,0,0,0,1,1,4
KAAF,0,0,0,1,1,4
AAFD,0,0,0,1,1,4
AFDM,0,0,0,1,1,4
FDMF,0,0,0,1,1,4
EERV,0,0,0,1,1,4
ERVK,0,0,0,2,2,4
RVKN,0,0,0,1,1,4
VKNG,0,0,0,1,1,4
KNGL,0,0,0,1,1,4
NGLE,0,0,0,2,2,4
GLER,0,0,0,1,1,4
ERLK,0,0,0,1,1,4
RLKK,0,0,0,1,1,4
KKAI,0,0,0,1,1,4
KAIK,0,0,0,1,1,4
AIKS,0,0,0,1,1,4
IKSG,0,0,0,1,1,4
KSGK,0,0,0,1,1,4
SGKQ,0,0,0,1,1,4
GKQS,0,0,0,1,1,4
KQST,0,0,0,1,1,4
EESD,0,0,0,1,1,4
ESDI,0,0,0,1,1,4
SDIK,0,0,0,3,3,4
DIKY,0,0,0,2,2,4
IKYK,0,0,0,1,1,4
KYKT,0,0,0,1,1,4
YKTS,0,0,0,1,1,4
KTSK,0,0,0,1,1,4
TSKN,0,0,0,1,1,4
SKNF,0,0,0,1,1,4
KNFI,0,0,0,1,1,4
NFIN,0,0,0,1,1,4
FINK,0,0,0,1,1,4
INKV,0,0,0,1,1,4
NKVY,0,0,0,1,1,4
EEVK,0,0,0,2,2,4
EVKK,0,0,0,4,4,4
VKKH,0,0,0,2,2,4
KKHG,0,0,0,1,1,4
KHGT,0,0,0,1,1,4
HGTT,0,0,0,1,1,4
TTVL,0,0,0,1,1,4
TVLT,0,0,0,1,1,4
VLTA,0,0,0,1,1,4
LTAL,0,0,0,1,1,4
TALG,0,0,0,1,1,4
ALGR,0,0,0,1,1,4
LGRI,0,0,0,1,1,4
GRIL,0,0,0,1,1,4
RILK,0,0,0,2,2,4
ILKQ,0,0,0,3,3,4
EFPE,0,0,0,1,1,4
FPEM,0,0,0,1,1,4
PEML,0,0,0,2,2,4
EMLA,0,0,0,1,1,4
MLAE,0,0,0,1,1,4
LAEI,0,0,0,1,1,4
AEII,0,0,0,1,1,4
EIIT,0,0,0,1,1,4
EFRD,0,0,0,1,1,4
FRDL,0,0,0,1,1,4
RDLH,0,0,0,1,1,4
DLHL,0,0,0,1,1,4
LHLF,0,0,0,1,1,4
HLFL,0,0,0,1,1,4
LFLG,0,0,0,1,1,4
FLGE,0,0,0,2,2,4
GEAA,0,0,0,1,1,4
EAAE,0,0,0,4,4,4
AAET,0,0,0,3,3,4
AETA,0,0,0,1,1,4
ETAE,0,0,0,1,1,4
TAEE,0,0,0,1,1,4
AEEV,0,0,0,1,1,4
EEVA,0,0,0,1,1,4
EVAD,0,0,0,1,1,4
VADE,0,0,0,1,1,4
ADEL,0,0,0,2,2,4
DELA,0,0,0,3,3,4
LAER,0,0,0,1,1,4
AERV,0,0,0,1,1,4
ERVQ,0,0,0,1,1,4
RVQA,0,0,0,1,1,4
VQAL,0,0,0,1,1,4
EGDQ,0,0,0,1,1,4
GDQQ,0,0,0,1,1,4
DQQL,0,0,0,1,1,4
QQLL,0,0,0,2,2,4
QLLK,0,0,0,2,2,4
LLKR,0,0,0,1,1,4
LKRV,0,0,0,2,2,4
KRVL,0,0,0,1,1,4
RVLV,0,0,0,1,1,4
VLVR,0,0,0,1,1,4
LVRK,0,0,0,1,1,4
VRKL,0,0,0,1,1,4
EGHV,0,0,0,1,1,4
GHVA,0,0,0,1,1,4
HVAA,0,0,0,1,1,4
AAVE,0,0,0,2,2,4
AVEV,0,0,0,1,1,4
VEVL,0,0,0,1,1,4
EVLR,0,0,0,2,2,4
VLRG,0,0,0,2,2,4
LRGI,0,0,0,1,1,4
RGIH,0,0,0,1,1,4
GIHR,0,0,0,1,1,4
IHRI,0,0,0,1,1,4
HRIA,0,0,0,1,1,4
RIAD,0,0,0,1,1,4
IADM,0,0,0,1,1,4
ADMS,0,0,0,1,1,4
EGKD,0,0,0,1,1,4
GKDR,0,0,0,1,1,4
KDRE,0,0,0,1,1,4
DREL,0,0,0,1,1,4
RELY,0,0,0,1,1,4
ELYG,0,0,0,2,2,4
LYGK,0,0,0,2,2,4
YGKL,0,0,0,1,1,4
GKLH,0,0,0,1,1,4
KLHE,0,0,0,1,1,4
LHET,0,0,0,1,1,4
HETL,0,0,0,1,1,4
ETLK,0,0,0,2,2,4
LKKV,0,0,0,3,3,4
KKVT,0,0,0,1,1,4
KVTE,0,0,0,1,1,4
VTED,0,0,0,1,1,4
TEDL,0,0,0,1,1,4
EDLE,0,0,0,1,1,4
EGNK,0,0,0,1,1,4
GNKR,0,0,0,1,1,4
NKRL,0,0,0,1,1,4
KRLD,0,0,0,1,1,4
RLDS,0,0,0,1,1,4
LDSV,0,0,0,1,1,4
DSVN,0,0,0,2,2,4
SVNS,0,0,0,2,2,4
VNSI,0,0,0,1,1,4
NSIV,0,0,0,1,1,4
SIVS,0,0,0,1,1,4
EGQQ,0,0,0,1,1,4
GQQR,0,0,0,1,1,4
QQRR,0,0,0,1,1,4
QRRI,0,0,0,4,4,4
RRIR,0,0,0,2,2,4
RIRQ,0,0,0,1,1,4
IRQQ,0,0,0,1,1,4
RQQR,0,0,0,1,1,4
QQRL,0,0,0,1,1,4
QRLI,0,0,0,1,1,4
RLIS,0,0,0,1,1,4
LISI,0,0,0,1,1,4
ISIG,0,0,0,1,1,4
SIGK,0,0,0,1,1,4
IGKW,0,0,0,1,1,4
GKWI,0,0,0,1,1,4
KWIA,0,0,0,2,2,4
WIAD,0,0,0,1,1,4
IADN,0,0,0,1,1,4
ADNQ,0,0,0,1,1,4
GVAW,0,0,0,1,1,4
VAWL,0,0,0,1,1,4
AWLE,0,0,0,1,1,4
WLEA,0,0,0,1,1,4
LEAV,0,0,0,1,1,4
EAVL,0,0,0,2,2,4
LRLL,0,0,0,1,1,4
RLLA,0,0,0,2,2,4
LLAQ,0,0,0,2,2,4
EHEI,0,0,0,1,1,4
HEIQ,0,0,0,1,1,4
EIQE,0,0,0,1,1,4
IQEW,0,0,0,1,1,4
QEWY,0,0,0,1,1,4
EWYK,0,0,0,1,1,4
WYKG,0,0,0,1,1,4
YKGF,0,0,0,1,1,4
KGFL,0,0,0,2,2,4
GFLR,0,0,0,1,1,4
FLRD,0,0,0,1,1,4
EIEK,0,0,0,1,1,4
IEKF,0,0,0,1,1,4
EKFR,0,0,0,1,1,4
KFRV,0,0,0,1,1,4
FRVW,0,0,0,1,1,4
RVWI,0,0,0,1,1,4
VWIS,0,0,0,1,1,4
WISI,0,0,0,1,1,4
ISIL,0,0,0,1,1,4
EISE,0,0,0,1,1,4
ISEM,0,0,0,1,1,4
SEMV,0,0,0,1,1,4
MVRM,0,0,0,1,1,4
VRMR,0,0,0,1,1,4
RMRE,0,0,0,1,1,4
MRER,0,0,0,1,1,4
RERI,0,0,0,2,2,4
ERIL,0,0,0,1,1,4
RILD,0,0,0,1,1,4
ILDS,0,0,0,1,1,4
DSIH,0,0,0,1,1,4
SIHL,0,0,0,1,1,4
IHLG,0,0,0,1,1,4
EISK,0,0,0,1,1,4
ISKL,0,0,0,2,2,4
SKLV,0,0,0,1,1,4
VKKM,0,0,0,1,1,4
KKMI,0,0,0,1,1,4
KMIS,0,0,0,1,1,4
MISS,0,0,0,1,1,4
ISSW,0,0,0,1,1,4
SSWK,0,0,0,1,1,4
SWKD,0,0,0,1,1,4
WKDA,0,0,0,1,1,4
KDAI,0,0,0,1,1,4
DAIN,0,0,0,1,1,4
EKET,0,0,0,1,1,4
KETF,0,0,0,1,1,4
ETFR,0,0,0,1,1,4
TFRE,0,0,0,1,1,4
FREK,0,0,0,1,1,4
REKF,0,0,0,1,1,4
EKFM,0,0,0,1,1,4
KFMQ,0,0,0,1,1,4
FMQH,0,0,0,1,1,4
EKNS,0,0,0,1,1,4
KNSY,0,0,0,1,1,4
NSYR,0,0,0,1,1,4
SYRK,0,0,0,1,1,4
YRKL,0,0,0,1,1,4
RKLV,0,0,0,1,1,4
KLVG,0,0,0,1,1,4
LVGN,0,0,0,1,1,4
VGNL,0,0,0,1,1,4
GNLY,0,0,0,1,1,4
NLYF,0,0,0,1,1,4
LYFV,0,0,0,1,1,4
YFVY,0,0,0,1,1,4
FVYS,0,0,0,1,1,4
VYSA,0,0,0,1,1,4
YSAM,0,0,0,1,1,4
SAME,0,0,0,1,1,4
AMEE,0,0,0,1,1,4
MEEE,0,0,0,1,1,4
EEEM,0,0,0,2,2,4
EEMA,0,0,0,1,1,4
EMAK,0,0,0,2,2,4
MAKF,0,0,0,1,1,4
EKVQ,0,0,0,1,1,4
KVQY,0,0,0,1,1,4
VQYL,0,0,0,1,1,4
QYLT,0,0,0,1,1,4
YLTR,0,0,0,1,1,4
LTRS,0,0,0,1,1,4
TRSA,0,0,0,1,1,4
SAIR,0,0,0,2,2,4
AIRR,0,0,0,1,1,4
EMNY,0,0,0,1,1,4
MNYY,0,0,0,1,1,4
NYYT,0,0,0,1,1,4
YYTV,0,0,0,1,1,4
YTVL,0,0,0,1,1,4
TVLF,0,0,0,1,1,4
VLFG,0,0,0,1,1,4
LFGV,0,0,0,1,1,4
FGVS,0,0,0,1,1,4
GVSR,0,0,0,1,1,4
VSRA,0,0,0,2,2,4
SRAL,0,0,0,2,2,4
RALG,0,0,0,3,3,4
ALGV,0,0,0,2,2,4
GVLA,0,0,0,1,1,4
VLAQ,0,0,0,1,1,4
LAQL,0,0,0,2,2,4
AQLI,0,0,0,2,2,4
QLIW,0,0,0,1,1,4
LIWS,0,0,0,1,1,4
IWSR,0,0,0,1,1,4
WSRA,0,0,0,1,1,4
EPEE,0,0,0,1,1,4
PEEV,0,0,0,3,3,4
EEVF,0,0,0,1,1,4
EVFK,0,0,0,1,1,4
VFKS,0,0,0,1,1,4
FKSV,0,0,0,2,2,4
KSVL,0,0,0,2,2,4
SVLK,0,0,0,1,1,4
VLKE,0,0,0,2,2,4
LKEM,0,0,0,1,1,4
KEME,0,0,0,1,1,4
EMEG,0,0,0,1,1,4
EPEK,0,0,0,1,1,4
EKVD,0,0,0,1,1,4
KVDK,0,0,0,1,1,4
VDKL,0,0,0,2,2,4
DKLQ,0,0,0,1,1,4
KLQE,0,0,0,3,3,4
LQEP,0,0,0,1,1,4
QEPL,0,0,0,1,1,4
EPLL,0,0,0,1,1,4
PLLE,0,0,0,1,1,4
LLEA,0,0,0,2,2,4
LEAL,0,0,0,5,5,4
EALR,0,0,0,3,3,4
ALRL,0,0,0,3,3,4
LRLY,0,0,0,1,1,4
RLYA,0,0,0,1,1,4
LYAR,0,0,0,1,1,4
YARR,0,0,0,1,1,4
ARRR,0,0,0,1,1,4
RRRR,0,0,0,1,1,4
EPGQ,0,0,0,1,1,4
PGQR,0,0,0,1,1,4
GQRK,0,0,0,2,2,4
QRKI,0,0,0,1,1,4
RKIV,0,0,0,1,1,4
KIVM,0,0,0,1,1,4
IVMH,0,0,0,1,1,4
VMHK,0,0,0,1,1,4
EQEI,0,0,0,1,1,4
QEIL,0,0,0,1,1,4
EILR,0,0,0,2,2,4
ILRQ,0,0,0,1,1,4
LRQV,0,0,0,1,1,4
RQVK,0,0,0,1,1,4
QVKK,0,0,0,1,1,4
VKKA,0,0,0,1,1,4
KKAY,0,0,0,1,1,4
KAYD,0,0,0,1,1,4
AYDR,0,0,0,1,1,4
YDRA,0,0,0,1,1,4
DRAA,0,0,0,1,1,4
RAAR,0,0,0,1,1,4
ARLG,0,0,0,1,1,4
EQEV,0,0,0,1,1,4
QEVY,0,0,0,1,1,4
EVYA,0,0,0,2,2,4
VYAQ,0,0,0,1,1,4
YAQV,0,0,0,1,1,4
AQVA,0,0,0,2,2,4
VARL,0,0,0,1,1,4
EQPS,0,0,0,1,1,4
QPSL,0,0,0,1,1,4
SLVR,0,0,0,1,1,4
LVRT,0,0,0,1,1,4
VRTL,0,0,0,2,2,4
RTLD,0,0,0,1,1,4
TLDQ,0,0,0,2,2,4
LDQL,0,0,0,3,3,4
DQLE,0,0,0,1,1,4
QLED,0,0,0,2,2,4
LEDK,0,0,0,1,1,4
ERQE,0,0,0,1,1,4
RQEV,0,0,0,1,1,4
QEVK,0,0,0,1,1,4
EVKQ,0,0,0,1,1,4
VKQM,0,0,0,1,1,4
KQMV,0,0,0,1,1,4
QMVV,0,0,0,1,1,4
MVVA,0,0,0,1,1,4
VVAT,0,0,0,2,2,4
TLAE,0,0,0,1,1,4
LAES,0,0,0,1,1,4
ERVR,0,0,0,1,1,4
VRAA,0,0,0,1,1,4
RAAM,0,0,0,3,3,4
AAME,0,0,0,1,1,4
AMEK,0,0,0,1,1,4
MEKL,0,0,0,3,3,4
EKLA,0,0,0,1,1,4
SLYE,0,0,0,1,1,4
LYES,0,0,0,1,1,4
YESI,0,0,0,1,1,4
SIRR,0,0,0,1,1,4
RRRY,0,0,0,1,1,4
RRYE,0,0,0,1,1,4
RYEE,0,0,0,1,1,4
YEEL,0,0,0,1,1,4
ESPV,0,0,0,1,1,4
SPVR,0,0,0,1,1,4
PVRK,0,0,0,1,1,4
VRKI,0,0,0,1,1,4
RKIL,0,0,0,1,1,4
KILR,0,0,0,1,1,4
ILRI,0,0,0,1,1,4
LRIV,0,0,0,1,1,4
RIVF,0,0,0,2,2,4
IVFH,0,0,0,1,1,4
FHDA,0,0,0,1,1,4
HDAI,0,0,0,2,2,4
TNIR,0,0,0,1,1,4
NIRV,0,0,0,1,1,4
IRVA,0,0,0,1,1,4
RVAL,0,0,0,1,1,4
VALE,0,0,0,1,1,4
ALEK,0,0,0,3,3,4
LEKS,0,0,0,1,1,4
EKSF,0,0,0,1,1,4
EVKR,0,0,0,2,2,4
VKRR,0,0,0,1,1,4
KRRF,0,0,0,1,1,4
RRFP,0,0,0,1,1,4
RFPT,0,0,0,1,1,4
FPTK,0,0,0,1,1,4
TKLG,0,0,0,1,1,4
KLGA,0,0,0,2,2,4
LGAW,0,0,0,1,1,4
GAWA,0,0,0,1,1,4
WALI,0,0,0,1,1,4
ALIW,0,0,0,1,1,4
LIWW,0,0,0,1,1,4
IWWL,0,0,0,1,1,4
WWLL,0,0,0,1,1,4
VKRS,0,0,0,1,1,4
KRSV,0,0,0,1,1,4
RSVN,0,0,0,1,1,4
SVNR,0,0,0,1,1,4
VNRD,0,0,0,1,1,4
NRDF,0,0,0,1,1,4
RDFA,0,0,0,1,1,4
DFAK,0,0,0,1,1,4
FAKW,0,0,0,1,1,4
AKWF,0,0,0,1,1,4
KWFL,0,0,0,1,1,4
WFLI,0,0,0,1,1,4
FLIV,0,0,0,1,1,4
LIVF,0,0,0,2,2,4
IVFI,0,0,0,2,2,4
EVNR,0,0,0,3,3,4
VNRN,0,0,0,1,1,4
NRNF,0,0,0,1,1,4
RNFG,0,0,0,1,1,4
NFGE,0,0,0,1,1,4
FGER,0,0,0,1,1,4
GERI,0,0,0,1,1,4
RIND,0,0,0,1,1,4
INDL,0,0,0,1,1,4
NDLR,0,0,0,1,1,4
DLRI,0,0,0,1,1,4
LRIL,0,0,0,2,2,4
RILI,0,0,0,2,2,4
ILIL,0,0,0,1,1,4
LILL,0,0,0,1,1,4
ILLL,0,0,0,2,2,4
EVVG,0,0,0,1,1,4
VVGR,0,0,0,1,1,4
VGRV,0,0,0,1,1,4
GRVS,0,0,0,1,1,4
RVSK,0,0,0,1,1,4
VSKL,0,0,0,1,1,4
SKLW,0,0,0,1,1,4
KLWN,0,0,0,1,1,4
LWNE,0,0,0,1,1,4
WNEW,0,0,0,1,1,4
NEWW,0,0,0,1,1,4
EWWL,0,0,0,1,1,4
WWLI,0,0,0,1,1,4
WLIV,0,0,0,1,1,4
EWQT,0,0,0,1,1,4
WQTM,0,0,0,1,1,4
QTMV,0,0,0,1,1,4
TMVA,0,0,0,1,1,4
MVAA,0,0,0,2,2,4
VAAL,0,0,0,2,2,4
AALQ,0,0,0,1,1,4
ALQA,0,0,0,1,1,4
EYKY,0,0,0,1,1,4
YKYY,0,0,0,1,1,4
KYYK,0,0,0,1,1,4
YYKL,0,0,0,1,1,4
YKLK,0,0,0,1,1,4
KLAE,0,0,0,3,3,4
LAEM,0,0,0,1,1,4
AEMQ,0,0,0,1,1,4
EMQR,0,0,0,1,1,4
FADL,0,0,0,2,2,4
ADLF,0,0,0,2,2,4
DLFD,0,0,0,1,1,4
LFDP,0,0,0,1,1,4
FDPV,0,0,0,1,1,4
DPVI,0,0,0,1,1,4
PVIQ,0,0,0,1,1,4
VIQE,0,0,0,1,1,4
IQER,0,0,0,1,1,4
QERH,0,0,0,1,1,4
FALR,0,0,0,1,1,4
LRLR,0,0,0,1,1,4
RLRR,0,0,0,1,1,4
LRRV,0,0,0,2,2,4
RRVI,0,0,0,1,1,4
RVIN,0,0,0,1,1,4
VINR,0,0,0,1,1,4
INRI,0,0,0,1,1,4
NRIG,0,0,0,1,1,4
RIGQ,0,0,0,1,1,4
IGQA,0,0,0,1,1,4
GQAW,0,0,0,1,1,4
QAWR,0,0,0,1,1,4
FEVI,0,0,0,1,1,4
EVID,0,0,0,1,1,4
VIDT,0,0,0,1,1,4
IDTI,0,0,0,1,1,4
DTIK,0,0,0,1,1,4
TIKA,0,0,0,2,2,4
IKAA,0,0,0,3,3,4
KAAV,0,0,0,1,1,4
AVEN,0,0,0,1,1,4
VENA,0,0,0,1,1,4
FFSF,0,0,0,1,1,4
FSFE,0,0,0,1,1,4
SFEL,0,0,0,1,1,4
FELV,0,0,0,1,1,4
ELVE,0,0,0,1,1,4
LVES,0,0,0,1,1,4
VESI,0,0,0,1,1,4
ESIN,0,0,0,2,2,4
SIND,0,0,0,1,1,4
INDV,0,0,0,1,1,4
NDVK,0,0,0,1,1,4
DVKK,0,0,0,1,1,4
VKKS,0,0,0,3,3,4
KSLR,0,0,0,1,1,4
FGLK,0,0,0,1,1,4
GLKV,0,0,0,1,1,4
KVLG,0,0,0,3,3,4
VLGW,0,0,0,1,1,4
LGWY,0,0,0,1,1,4
GWYS,0,0,0,1,1,4
WYSE,0,0,0,1,1,4
YSEM,0,0,0,1,1,4
SEMK,0,0,0,1,1,4
EMKR,0,0,0,1,1,4
MKRN,0,0,0,1,1,4
KRNV,0,0,0,2,2,4
RNVQ,0,0,0,1,1,4
NVQR,0,0,0,1,1,4
VQRL,0,0,0,1,1,4
QRLE,0,0,0,1,1,4
LERA,0,0,0,3,3,4
ERAI,0,0,0,2,2,4
RAIE,0,0,0,1,1,4
AIEE,0,0,0,2,2,4
IEEV,0,0,0,1,1,4
FHSV,0,0,0,1,1,4
HSVA,0,0,0,1,1,4
SVAE,0,0,0,1,1,4
VAEQ,0,0,0,1,1,4
AEQF,0,0,0,1,1,4
FIAV,0,0,0,1,1,4
IAVH,0,0,0,2,2,4
AVHE,0,0,0,2,2,4
VHEM,0,0,0,1,1,4
HEML,0,0,0,1,1,4
EMLD,0,0,0,1,1,4
MLDG,0,0,0,1,1,4
LDGF,0,0,0,1,1,4
DGFR,0,0,0,1,1,4
GFRT,0,0,0,1,1,4
FRTA,0,0,0,1,1,4
TALI,0,0,0,1,1,4
ALID,0,0,0,2,2,4
LIDH,0,0,0,1,1,4
IDHL,0,0,0,1,1,4
DHLD,0,0,0,1,1,4
HLDT,0,0,0,1,1,4
LDTM,0,0,0,1,1,4
DTMA,0,0,0,1,1,4
TMAE,0,0,0,1,1,4
MAER,0,0,0,1,1,4
AERA,0,0,0,2,2,4
ERAV,0,0,0,1,1,4
RAVQ,0,0,0,1,1,4
FKAT,0,0,0,1,1,4
KATI,0,0,0,1,1,4
ATIA,0,0,0,1,1,4
TIAD,0,0,0,1,1,4
IADL,0,0,0,1,1,4
ADLS,0,0,0,1,1,4
DLSK,0,0,0,1,1,4
LSKK,0,0,0,1,1,4
SKKR,0,0,0,2,2,4
FKEA,0,0,0,1,1,4
KEAI,0,0,0,2,2,4
AESA,0,0,0,1,1,4
FKGK,0,0,0,1,1,4
KGKI,0,0,0,1,1,4
GKII,0,0,0,2,2,4
KVIS,0,0,0,1,1,4
ISTG,0,0,0,1,1,4
STGA,0,0,0,1,1,4
TGAK,0,0,0,1,1,4
GAKL,0,0,0,1,1,4
AKLI,0,0,0,1,1,4
FKSI,0,0,0,1,1,4
KSIY,0,0,0,1,1,4
SIYR,0,0,0,3,3,4
IYRF,0,0,0,1,1,4
YRFF,0,0,0,1,1,4
RFFE,0,0,0,2,2,4
FFEH,0,0,0,1,1,4
FEHG,0,0,0,1,1,4
EHGL,0,0,0,1,1,4
HGLK,0,0,0,1,1,4
KSVQ,0,0,0,1,1,4
SVQN,0,0,0,1,1,4
VQNS,0,0,0,1,1,4
QNSL,0,0,0,1,1,4
NSLQ,0,0,0,1,1,4
SLQR,0,0,0,1,1,4
LQRI,0,0,0,1,1,4
QRIL,0,0,0,1,1,4
RILY,0,0,0,1,1,4
ILYL,0,0,0,2,2,4
LYLW,0,0,0,1,1,4
YLWA,0,0,0,1,1,4
LWAI,0,0,0,2,2,4
WAIR,0,0,0,1,1,4
AIRH,0,0,0,1,1,4
FLDQ,0,0,0,1,1,4
LDQN,0,0,0,1,1,4
DQNM,0,0,0,1,1,4
QNML,0,0,0,1,1,4
NMLA,0,0,0,2,2,4
MLAV,0,0,0,1,1,4
LAVI,0,0,0,1,1,4
AVID,0,0,0,3,3,4
VIDE,0,0,0,1,1,4
IDEL,0,0,0,1,1,4
DELM,0,0,0,1,1,4
ELMQ,0,0,0,1,1,4
LMQA,0,0,0,2,2,4
MQAL,0,0,0,1,1,4
FLLK,0,0,0,1,1,4
KVAT,0,0,0,1,1,4
ATGF,0,0,0,1,1,4
TGFA,0,0,0,2,2,4
GFAK,0,0,0,1,1,4
FAKG,0,0,0,1,1,4
FLLS,0,0,0,1,1,4
LSKA,0,0,0,1,1,4
SKAK,0,0,0,1,1,4
KAKD,0,0,0,1,1,4
AKDA,0,0,0,1,1,4
KDAK,0,0,0,1,1,4
DAKS,0,0,0,1,1,4
AKSS,0,0,0,1,1,4
KSSA,0,0,0,1,1,4
SSAE,0,0,0,1,1,4
SAEG,0,0,0,1,1,4
AEGA,0,0,0,1,1,4
FNQR,0,0,0,1,1,4
NQRR,0,0,0,1,1,4
RRIS,0,0,0,1,1,4
RISS,0,0,0,1,1,4
ISSA,0,0,0,1,1,4
SSAK,0,0,0,1,1,4
SAKF,0,0,0,1,1,4
KFLG,0,0,0,1,1,4
LGEL,0,0,0,1,1,4
GELY,0,0,0,1,1,4
ELYN,0,0,0,1,1,4
LYNY,0,0,0,1,1,4
FNRM,0,0,0,2,2,4
NRMF,0,0,0,2,2,4
RMFE,0,0,0,2,2,4
FEKS,0,0,0,3,3,4
EKST,0,0,0,2,2,4
KSTH,0,0,0,2,2,4
STHH,0,0,0,2,2,4
THHY,0,0,0,2,2,4
HHYT,0,0,0,2,2,4
HYTD,0,0,0,2,2,4
YTDS,0,0,0,2,2,4
TDSV,0,0,0,2,2,4
DSVG,0,0,0,2,2,4
SVGG,0,0,0,2,2,4
VGGI,0,0,0,2,2,4
GGIL,0,0,0,1,1,4
GILR,0,0,0,1,1,4
FPLL,0,0,0,1,1,4
PLLV,0,0,0,1,1,4
LLVD,0,0,0,1,1,4
LVDH,0,0,0,1,1,4
VDHT,0,0,0,1,1,4
DHTS,0,0,0,1,1,4
HTSR,0,0,0,1,1,4
TSRE,0,0,0,1,1,4
SREA,0,0,0,1,1,4
READ,0,0,0,1,1,4
EADY,0,0,0,1,1,4
ADYF,0,0,0,1,1,4
DYFR,0,0,0,1,1,4
YFRK,0,0,0,1,1,4
FRKR,0,0,0,1,1,4
RKRL,0,0,0,2,2,4
KRLI,0,0,0,1,1,4
RLIQ,0,0,0,1,1,4
LIQL,0,0,0,1,1,4
IQLN,0,0,0,1,1,4
QLNE,0,0,0,1,1,4
LNEG,0,0,0,1,1,4
FPNL,0,0,0,1,1,4
PNLA,0,0,0,1,1,4
NLAS,0,0,0,1,1,4
LASA,0,0,0,2,2,4
ASAA,0,0,0,1,1,4
SAAF,0,0,0,1,1,4
AAFY,0,0,0,1,1,4
AFYW,0,0,0,1,1,4
FYWS,0,0,0,1,1,4
YWSK,0,0,0,1,1,4
WSKK,0,0,0,1,1,4
SKKE,0,0,0,1,1,4
KKEN,0,0,0,1,1,4
FPQL,0,0,0,1,1,4
PQLT,0,0,0,1,1,4
QLTQ,0,0,0,1,1,4
LTQN,0,0,0,1,1,4
TQNN,0,0,0,1,1,4
QNNS,0,0,0,1,1,4
NNSR,0,0,0,1,1,4
NSRE,0,0,0,2,2,4
FSAL,0,0,0,1,1,4
SALN,0,0,0,1,1,4
ALNI,0,0,0,1,1,4
LNIA,0,0,0,1,1,4
NIAV,0,0,0,1,1,4
VHEL,0,0,0,1,1,4
HELS,0,0,0,1,1,4
ELSD,0,0,0,1,1,4
LSDV,0,0,0,2,2,4
SDVG,0,0,0,1,1,4
DVGR,0,0,0,1,1,4
VGRA,0,0,0,1,1,4
RAIV,0,0,0,1,1,4
AIVR,0,0,0,1,1,4
IVRN,0,0,0,1,1,4
FSEF,0,0,0,1,1,4
SEFI,0,0,0,1,1,4
EFIQ,0,0,0,1,1,4
FIQA,0,0,0,2,2,4
IQAL,0,0,0,1,1,4
QALS,0,0,0,1,1,4
ALSV,0,0,0,1,1,4
LSVT,0,0,0,1,1,4
SVTS,0,0,0,1,1,4
VTSR,0,0,0,1,1,4
TSRG,0,0,0,1,1,4
FTEL,0,0,0,1,1,4
TELQ,0,0,0,2,2,4
ELQR,0,0,0,2,2,4
LQRD,0,0,0,1,1,4
QRDF,0,0,0,1,1,4
RDFL,0,0,0,1,1,4
DFLR,0,0,0,1,1,4
FLRN,0,0,0,1,1,4
FTRI,0,0,0,1,1,4
TRII,0,0,0,1,1,4
RIIK,0,0,0,1,1,4
KAAG,0,0,0,2,2,4
FVPV,0,0,0,1,1,4
VPVF,0,0,0,1,1,4
PVFF,0,0,0,1,1,4
VFFV,0,0,0,2,2,4
FFVV,0,0,0,2,2,4
FVVV,0,0,0,1,1,4
VVVR,0,0,0,1,1,4
VVRR,0,0,0,1,1,4
VRRR,0,0,0,1,1,4
FYQT,0,0,0,1,1,4
YQTF,0,0,0,1,1,4
QTFF,0,0,0,1,1,4
TFFD,0,0,0,1,1,4
FFDE,0,0,0,1,1,4
FDEA,0,0,0,1,1,4
DEAD,0,0,0,1,1,4
EADE,0,0,0,1,1,4
ELLA,0,0,0,1,1,4
LLAD,0,0,0,1,1,4
LADM,0,0,0,1,1,4
ADME,0,0,0,1,1,4
DMEQ,0,0,0,1,1,4
MEQH,0,0,0,1,1,4
EQHL,0,0,0,1,1,4
QHLL,0,0,0,1,1,4
HLLD,0,0,0,1,1,4
LLDL,0,0,0,2,2,4
GAFR,0,0,0,1,1,4
AFRK,0,0,0,1,1,4
FRKL,0,0,0,1,1,4
RKLL,0,0,0,2,2,4
KLLQ,0,0,0,2,2,4
LLQS,0,0,0,1,1,4
LQSA,0,0,0,1,1,4
QSAK,0,0,0,1,1,4
SAKD,0,0,0,1,1,4
AKDN,0,0,0,1,1,4
GAGT,0,0,0,1,1,4
AGTS,0,0,0,1,1,4
GTSV,0,0,0,1,1,4
TSVN,0,0,0,1,1,4
SVNM,0,0,0,1,1,4
VNMN,0,0,0,1,1,4
NMNT,0,0,0,1,1,4
MNTN,0,0,0,1,1,4
NTNE,0,0,0,1,1,4
TNEV,0,0,0,1,1,4
NEVL,0,0,0,1,1,4
VLAN,0,0,0,1,1,4
LANI,0,0,0,1,1,4
ANIG,0,0,0,1,1,4
NIGL,0,0,0,1,1,4
IGLE,0,0,0,1,1,4
GLEL,0,0,0,1,1,4
LELM,0,0,0,1,1,4
GAPL,0,0,0,1,1,4
APLA,0,0,0,1,1,4
PLAR,0,0,0,1,1,4
LARM,0,0,0,1,1,4
ARME,0,0,0,1,1,4
RMEV,0,0,0,1,1,4
MEVT,0,0,0,1,1,4
EVTL,0,0,0,1,1,4
VTLA,0,0,0,1,1,4
TLAL,0,0,0,1,1,4
LALE,0,0,0,1,1,4
ALES,0,0,0,1,1,4
LESL,0,0,0,2,2,4
ESLF,0,0,0,1,1,4
SLFG,0,0,0,1,1,4
LFGR,0,0,0,1,1,4
FGRF,0,0,0,1,1,4
GAQY,0,0,0,1,1,4
AQYI,0,0,0,1,1,4
QYIQ,0,0,0,1,1,4
YIQA,0,0,0,1,1,4
IQAA,0,0,0,2,2,4
QAAG,0,0,0,2,2,4
AAGV,0,0,0,1,1,4
AGVA,0,0,0,1,1,4
GVAL,0,0,0,1,1,4
VALG,0,0,0,1,1,4
ALGL,0,0,0,1,1,4
LGLK,0,0,0,1,1,4
GLKM,0,0,0,1,1,4
LKMR,0,0,0,1,1,4
GAVA,0,0,0,1,1,4
AVAI,0,0,0,1,1,4
VAIA,0,0,0,1,1,4
AIAR,0,0,0,3,3,4
RVFS,0,0,0,1,1,4
VFSY,0,0,0,1,1,4
GEAE,0,0,0,1,1,4
EAEI,0,0,0,2,2,4
AEIA,0,0,0,1,1,4
EIAS,0,0,0,2,2,4
IASL,0,0,0,1,1,4
ASLK,0,0,0,2,2,4
SLKS,0,0,0,1,1,4
LKSQ,0,0,0,1,1,4
KSQI,0,0,0,1,1,4
SQIR,0,0,0,1,1,4
QIRA,0,0,0,1,1,4
GEAY,0,0,0,1,1,4
EAYL,0,0,0,2,2,4
AYLL,0,0,0,2,2,4
YLLL,0,0,0,1,1,4
LLLE,0,0,0,1,1,4
LLER,0,0,0,2,2,4
LERY,0,0,0,1,1,4
ERYV,0,0,0,1,1,4
RYVA,0,0,0,1,1,4
YVAF,0,0,0,1,1,4
VAFL,0,0,0,1,1,4
AFLR,0,0,0,2,2,4
FLRA,0,0,0,1,1,4
GEDA,0,0,0,1,1,4
EDAI,0,0,0,1,1,4
DAIL,0,0,0,1,1,4
AILK,0,0,0,2,2,4
KVAE,0,0,0,2,2,4
VAEE,0,0,0,1,1,4
AEEA,0,0,0,1,1,4
EEAA,0,0,0,3,3,4
AETL,0,0,0,2,2,4
ETLM,0,0,0,1,1,4
TLMA,0,0,0,1,1,4
LMAS,0,0,0,1,1,4
MASK,0,0,0,1,1,4
ASKD,0,0,0,1,1,4
GEGW,0,0,0,1,1,4
EGWA,0,0,0,1,1,4
GWAK,0,0,0,1,1,4
WAKS,0,0,0,1,1,4
AKSI,0,0,0,1,1,4
KSIL,0,0,0,1,1,4
SILF,0,0,0,1,1,4
ILFN,0,0,0,1,1,4
GEKR,0,0,0,1,1,4
EKRA,0,0,0,1,1,4
AEEI,0,0,0,2,2,4
EEIK,0,0,0,2,2,4
EIKK,0,0,0,1,1,4
KILM,0,0,0,1,1,4
GFFG,0,0,0,1,1,4
FFGW,0,0,0,1,1,4
FGWF,0,0,0,1,1,4
GWFN,0,0,0,1,1,4
WFNR,0,0,0,1,1,4
GFKN,0,0,0,1,1,4
FKNE,0,0,0,1,1,4
KNEV,0,0,0,1,1,4
NEVR,0,0,0,1,1,4
EVRT,0,0,0,2,2,4
VRTP,0,0,0,1,1,4
RTPV,0,0,0,1,1,4
TPVT,0,0,0,1,1,4
PVTK,0,0,0,1,1,4
VTKF,0,0,0,1,1,4
TKFR,0,0,0,1,1,4
KFRI,0,0,0,1,1,4
FRIV,0,0,0,1,1,4
IVFF,0,0,0,2,2,4
GFMI,0,0,0,1,1,4
FMIW,0,0,0,1,1,4
MIWH,0,0,0,1,1,4
IWHP,0,0,0,1,1,4
WHPK,0,0,0,1,1,4
HPKM,0,0,0,1,1,4
PKMD,0,0,0,1,1,4
KMDE,0,0,0,1,1,4
MDEY,0,0,0,1,1,4
DEYM,0,0,0,1,1,4
EYME,0,0,0,1,1,4
YMEE,0,0,0,1,1,4
MEEI,0,0,0,1,1,4
EEID,0,0,0,1,1,4
EIDG,0,0,0,1,1,4
IDGY,0,0,0,1,1,4
DGYL,0,0,0,1,1,4
GYLD,0,0,0,2,2,4
YLDE,0,0,0,3,3,4
LDEM,0,0,0,2,2,4
DEMS,0,0,0,1,1,4
EMSE,0,0,0,1,1,4
MSER,0,0,0,1,1,4
SERL,0,0,0,1,1,4
RLIT,0,0,0,1,1,4
LITL,0,0,0,3,3,4
FSVQ,0,0,0,1,1,4
SVQR,0,0,0,1,1,4
VQRR,0,0,0,1,1,4
QRRL,0,0,0,1,1,4
RRLW,0,0,0,1,1,4
RLWL,0,0,0,1,1,4
LWLA,0,0,0,1,1,4
WLAS,0,0,0,2,2,4
GFYP,0,0,0,1,1,4
FYPM,0,0,0,1,1,4
YPMV,0,0,0,1,1,4
PMVA,0,0,0,1,1,4
VAAQ,0,0,0,2,2,4
AAQR,0,0,0,2,2,4
AQRI,0,0,0,1,1,4
GGFA,0,0,0,1,1,4
GFAA,0,0,0,1,1,4
FAAA,0,0,0,1,1,4
AAAI,0,0,0,3,3,4
AAIA,0,0,0,1,1,4
IARR,0,0,0,1,1,4
ARRA,0,0,0,1,1,4
GGKE,0,0,0,1,1,4
GKEA,0,0,0,1,1,4
KEAL,0,0,0,2,2,4
EALA,0,0,0,4,4,4
ALAI,0,0,0,2,2,4
LAIE,0,0,0,1,1,4
AIEN,0,0,0,1,1,4
IENF,0,0,0,1,1,4
ENFA,0,0,0,1,1,4
NFAD,0,0,0,2,2,4
FADA,0,0,0,1,1,4
ADAL,0,0,0,2,2,4
GGSS,0,0,0,1,1,4
GSSG,0,0,0,1,1,4
SSGV,0,0,0,1,1,4
SGVL,0,0,0,1,1,4
VLMS,0,0,0,1,1,4
LMSI,0,0,0,1,1,4
MSIF,0,0,0,1,1,4
SIFF,0,0,0,1,1,4
IFFT,0,0,0,1,1,4
FFTA,0,0,0,1,1,4
FTAA,0,0,0,1,1,4
TAAG,0,0,0,1,1,4
AAGQ,0,0,0,1,1,4
AGQK,0,0,0,1,1,4
GQKL,0,0,0,1,1,4
QKLE,0,0,0,1,1,4
KLEQ,0,0,0,1,1,4
GHNL,0,0,0,1,1,4
HNLI,0,0,0,1,1,4
NLIS,0,0,0,1,1,4
ISLL,0,0,0,1,1,4
SLLE,0,0,0,1,1,4
LLEV,0,0,0,1,1,4
EVLS,0,0,0,1,1,4
VLSG,0,0,0,1,1,4
GIHE,0,0,0,1,1,4
IHEL,0,0,0,2,2,4
HELA,0,0,0,1,1,4
ELAV,0,0,0,1,1,4
LAVF,0,0,0,1,1,4
AVFA,0,0,0,1,1,4
VFAE,0,0,0,1,1,4
FAEE,0,0,0,1,1,4
AEEH,0,0,0,1,1,4
KASL,0,0,0,1,1,4
ASLR,0,0,0,1,1,4
SLRA,0,0,0,1,1,4
LRAA,0,0,0,1,1,4
RAAE,0,0,0,2,2,4
AAEL,0,0,0,3,3,4
AELY,0,0,0,1,1,4
ELYS,0,0,0,2,2,4
LYSK,0,0,0,1,1,4
YSKY,0,0,0,1,1,4
GKDA,0,0,0,1,1,4
KDAA,0,0,0,1,1,4
AAAE,0,0,0,2,2,4
AAEE,0,0,0,1,1,4
EEIS,0,0,0,1,1,4
EISQ,0,0,0,1,1,4
ISQL,0,0,0,1,1,4
SQLL,0,0,0,2,2,4
QLLY,0,0,0,1,1,4
LLYH,0,0,0,1,1,4
LYHV,0,0,0,1,1,4
YHVQ,0,0,0,1,1,4
HVQV,0,0,0,1,1,4
VQVM,0,0,0,1,1,4
QVMM,0,0,0,1,1,4
VMMV,0,0,0,1,1,4
MMVA,0,0,0,1,1,4
MVAR,0,0,0,1,1,4
VARG,0,0,0,3,3,4
GKKG,0,0,0,1,1,4
KKGP,0,0,0,1,1,4
KGPK,0,0,0,1,1,4
GPKF,0,0,0,1,1,4
PKFI,0,0,0,1,1,4
KFIQ,0,0,0,1,1,4
QAVA,0,0,0,1,1,4
SLKA,0,0,0,1,1,4
GKSN,0,0,0,1,1,4
KSNM,0,0,0,1,1,4
SNMM,0,0,0,1,1,4
NMMD,0,0,0,1,1,4
MMDA,0,0,0,1,1,4
MDAI,0,0,0,1,1,4
DAIS,0,0,0,1,1,4
AISF,0,0,0,1,1,4
ISFV,0,0,0,1,1,4
SFVL,0,0,0,1,1,4
GKTT,0,0,0,3,3,4
KTTA,0,0,0,1,1,4
TTAA,0,0,0,1,1,4
ALAR,0,0,0,2,2,4
LARE,0,0,0,3,3,4
AREL,0,0,0,1,1,4
RELF,0,0,0,1,1,4
ELFG,0,0,0,1,1,4
KTTF,0,0,0,1,1,4
TTFV,0,0,0,1,1,4
TFVK,0,0,0,1,1,4
FVKR,0,0,0,1,1,4
VKRH,0,0,0,1,1,4
KRHL,0,0,0,1,1,4
RHLT,0,0,0,1,1,4
HLTG,0,0,0,1,1,4
KTTI,0,0,0,1,1,4
TTIL,0,0,0,1,1,4
TILY,0,0,0,1,1,4
ILYR,0,0,0,2,2,4
LYRL,0,0,0,3,3,4
YRLQ,0,0,0,1,1,4
RLQV,0,0,0,2,2,4
LQVG,0,0,0,1,1,4
GLEK,0,0,0,1,1,4
LEKL,0,0,0,4,4,4
EKLE,0,0,0,1,1,4
KLEE,0,0,0,2,2,4
LEES,0,0,0,2,2,4
EESI,0,0,0,1,1,4
ESIY,0,0,0,1,1,4
IYRE,0,0,0,1,1,4
LFDK,0,0,0,1,1,4
FDKV,0,0,0,2,2,4
DKVK,0,0,0,1,1,4
KVKS,0,0,0,1,1,4
VKSL,0,0,0,1,1,4
KSLV,0,0,0,1,1,4
SLVP,0,0,0,1,1,4
LVPK,0,0,0,1,1,4
VPKI,0,0,0,1,1,4
PKIA,0,0,0,1,1,4
IAKA,0,0,0,2,2,4
AKAV,0,0,0,1,1,4
DVIG,0,0,0,1,1,4
IGSQ,0,0,0,1,1,4
GSQA,0,0,0,1,1,4
SQAG,0,0,0,1,1,4
QAGG,0,0,0,1,1,4
AGGA,0,0,0,1,1,4
GGAA,0,0,0,1,1,4
GAAP,0,0,0,1,1,4
AAPH,0,0,0,1,1,4
APHF,0,0,0,1,1,4
PHFL,0,0,0,1,1,4
HFLG,0,0,0,1,1,4
LFKL,0,0,0,1,1,4
FKLI,0,0,0,1,1,4
LIKF,0,0,0,1,1,4
IKFA,0,0,0,1,1,4
AKKK,0,0,0,1,1,4
KKKS,0,0,0,1,1,4
KKSP,0,0,0,1,1,4
KSPG,0,0,0,1,1,4
SPGA,0,0,0,1,1,4
PGAF,0,0,0,1,1,4
GLGK,0,0,0,1,1,4
LGKI,0,0,0,1,1,4
KIIG,0,0,0,2,2,4
IIGK,0,0,0,1,1,4
GKVK,0,0,0,1,1,4
KVKK,0,0,0,1,1,4
KSLL,0,0,0,2,2,4
SLLK,0,0,0,2,2,4
LLKS,0,0,0,3,3,4
LKSI,0,0,0,1,1,4
GLGL,0,0,0,1,1,4
LGLV,0,0,0,1,1,4
GLVL,0,0,0,1,1,4
LVLK,0,0,0,1,1,4
VLKI,0,0,0,1,1,4
KIAV,0,0,0,1,1,4
IAVN,0,0,0,1,1,4
AVNA,0,0,0,1,1,4
VNAF,0,0,0,1,1,4
NAFL,0,0,0,1,1,4
AFLK,0,0,0,3,3,4
LKLV,0,0,0,1,1,4
KLVA,0,0,0,2,2,4
GLLD,0,0,0,1,1,4
LLDI,0,0,0,2,2,4
LDIA,0,0,0,2,2,4
DIAG,0,0,0,1,1,4
IAGG,0,0,0,2,2,4
AGGN,0,0,0,1,1,4
GGNA,0,0,0,1,1,4
GNAE,0,0,0,1,1,4
NAET,0,0,0,1,1,4
TLAG,0,0,0,1,1,4
LAGH,0,0,0,1,1,4
AGHA,0,0,0,1,1,4
GHAV,0,0,0,1,1,4
GLNA,0,0,0,1,1,4
LNAE,0,0,0,1,1,4
NAEL,0,0,0,1,1,4
ELTR,0,0,0,1,1,4
LTRY,0,0,0,1,1,4
TRYT,0,0,0,1,1,4
RYTL,0,0,0,1,1,4
YTLS,0,0,0,1,1,4
TLSL,0,0,0,1,1,4
LSLM,0,0,0,2,2,4
SLMV,0,0,0,1,1,4
LMVL,0,0,0,1,1,4
MVLE,0,0,0,1,1,4
VLER,0,0,0,1,1,4
LERK,0,0,0,1,1,4
ERKL,0,0,0,1,1,4
RKLS,0,0,0,1,1,4
KLSS,0,0,0,1,1,4
LSSA,0,0,0,1,1,4
GLTS,0,0,0,1,1,4
LTSL,0,0,0,2,2,4
TSLM,0,0,0,1,1,4
SLMA,0,0,0,1,1,4
LMAI,0,0,0,1,1,4
MAID,0,0,0,1,1,4
AIDK,0,0,0,1,1,4
IDKL,0,0,0,1,1,4
GLWA,0,0,0,1,1,4
WAIA,0,0,0,1,1,4
IAVK,0,0,0,1,1,4
AVKA,0,0,0,1,1,4
KAGK,0,0,0,1,1,4
AGKV,0,0,0,1,1,4
KVIL,0,0,0,1,1,4
VILK,0,0,0,1,1,4
ILKL,0,0,0,1,1,4
KLIV,0,0,0,1,1,4
VFIW,0,0,0,1,1,4
FIWI,0,0,0,1,1,4
IWIR,0,0,0,1,1,4
WIRV,0,0,0,2,2,4
GLWK,0,0,0,1,1,4
LWKS,0,0,0,1,1,4
WKSL,0,0,0,1,1,4
KSLG,0,0,0,1,1,4
SLGA,0,0,0,1,1,4
LGAV,0,0,0,1,1,4
GAVV,0,0,0,1,1,4
AVVK,0,0,0,3,3,4
VVKR,0,0,0,1,1,4
VKRV,0,0,0,1,1,4
KRVE,0,0,0,2,2,4
RVEG,0,0,0,1,1,4
VEGL,0,0,0,3,3,4
EGLW,0,0,0,1,1,4
GLWV,0,0,0,1,1,4
LWVG,0,0,0,1,1,4
WVGL,0,0,0,1,1,4
VGLF,0,0,0,1,1,4
GNFA,0,0,0,1,1,4
ADLL,0,0,0,1,1,4
DLLA,0,0,0,1,1,4
LLAH,0,0,0,2,2,4
LAHS,0,0,0,2,2,4
AHSD,0,0,0,1,1,4
HSDG,0,0,0,1,1,4
SDGL,0,0,0,1,1,4
DGLI,0,0,0,2,2,4
GLIK,0,0,0,2,2,4
LIKN,0,0,0,1,1,4
IKNI,0,0,0,1,1,4
KNIS,0,0,0,1,1,4
NISD,0,0,0,1,1,4
ISDD,0,0,0,1,1,4
SDDL,0,0,0,1,1,4
DDLR,0,0,0,2,2,4
DLRA,0,0,0,1,1,4
LRAL,0,0,0,2,2,4
ALDK,0,0,0,2,2,4
LDKL,0,0,0,4,4,4
DKLI,0,0,0,1,1,4
GNYL,0,0,0,1,1,4
NYLR,0,0,0,1,1,4
YLRA,0,0,0,1,1,4
LRAE,0,0,0,1,1,4
RAEI,0,0,0,1,1,4
AEIL,0,0,0,1,1,4
EILY,0,0,0,1,1,4
YRLK,0,0,0,1,1,4
GPDM,0,0,0,1,1,4
PDMT,0,0,0,1,1,4
DMTA,0,0,0,1,1,4
MTAM,0,0,0,2,2,4
TAMV,0,0,0,1,1,4
AMVA,0,0,0,1,1,4
MVAL,0,0,0,1,1,4
VALI,0,0,0,1,1,4
ALIA,0,0,0,2,2,4
LIAS,0,0,0,1,1,4
IASV,0,0,0,1,1,4
GPKD,0,0,0,1,1,4
PKDA,0,0,0,1,1,4
KDAV,0,0,0,1,1,4
DAVV,0,0,0,2,2,4
VVKV,0,0,0,1,1,4
VKVF,0,0,0,1,1,4
KVFN,0,0,0,1,1,4
VFNQ,0,0,0,1,1,4
FNQW,0,0,0,1,1,4
NQWG,0,0,0,1,1,4
GPKK,0,0,0,1,1,4
PKKA,0,0,0,1,1,4
KKAQ,0,0,0,1,1,4
KAQL,0,0,0,1,1,4
QLIV,0,0,0,1,1,4
LIVG,0,0,0,1,1,4
IVGW,0,0,0,1,1,4
VGWR,0,0,0,1,1,4
GWRE,0,0,0,1,1,4
WREL,0,0,0,1,1,4
RELH,0,0,0,1,1,4
ELHG,0,0,0,1,1,4
GSDF,0,0,0,1,1,4
SDFL,0,0,0,1,1,4
FLIH,0,0,0,1,1,4
LIHF,0,0,0,1,1,4
IHFI,0,0,0,1,1,4
HFID,0,0,0,1,1,4
FIDE,0,0,0,1,1,4
GSHA,0,0,0,1,1,4
SHAN,0,0,0,1,1,4
HANE,0,0,0,1,1,4
ANEF,0,0,0,2,2,4
NEFF,0,0,0,2,2,4
EFFF,0,0,0,1,1,4
FFFR,0,0,0,1,1,4
FFRA,0,0,0,1,1,4
GTLR,0,0,0,1,1,4
TLRH,0,0,0,1,1,4
LRHA,0,0,0,1,1,4
RHAA,0,0,0,1,1,4
HAAN,0,0,0,1,1,4
AANA,0,0,0,1,1,4
ANAA,0,0,0,2,2,4
NAAF,0,0,0,1,1,4
AAFI,0,0,0,1,1,4
AFIM,0,0,0,1,1,4
FIML,0,0,0,1,1,4
IMLE,0,0,0,1,1,4
MLEA,0,0,0,3,3,4
LEAA,0,0,0,1,1,4
GTTT,0,0,0,1,1,4
TTTA,0,0,0,1,1,4
TTAV,0,0,0,1,1,4
TAVI,0,0,0,1,1,4
AVII,0,0,0,1,1,4
VIIA,0,0,0,1,1,4
IIAG,0,0,0,1,1,4
AGGL,0,0,0,1,1,4
GGLL,0,0,0,1,1,4
GLLQ,0,0,0,1,1,4
LLQQ,0,0,0,2,2,4
QQAQ,0,0,0,1,1,4
QAQG,0,0,0,1,1,4
AQGL,0,0,0,1,1,4
QGLI,0,0,0,1,1,4
GLIN,0,0,0,1,1,4
GVSG,0,0,0,1,1,4
VSGL,0,0,0,1,1,4
SGLA,0,0,0,1,1,4
GLAA,0,0,0,1,1,4
LAAA,0,0,0,2,2,4
AAAR,0,0,0,2,2,4
AARQ,0,0,0,1,1,4
ARQL,0,0,0,1,1,4
RQLQ,0,0,0,2,2,4
QLQS,0,0,0,2,2,4
LQSF,0,0,0,1,1,4
GWQN,0,0,0,1,1,4
WQNE,0,0,0,1,1,4
QNEL,0,0,0,1,1,4
NELL,0,0,0,2,2,4
ELLL,0,0,0,1,1,4
LLLL,0,0,0,3,3,4
LLLR,0,0,0,1,1,4
LLRY,0,0,0,1,1,4
LRYL,0,0,0,1,1,4
RYLD,0,0,0,1,1,4
LDEN,0,0,0,1,1,4
GYKK,0,0,0,1,1,4
YKKV,0,0,0,1,1,4
KKVS,0,0,0,1,1,4
KVSK,0,0,0,2,2,4
VSKS,0,0,0,1,1,4
SKSY,0,0,0,1,1,4
KSYT,0,0,0,1,1,4
SYTG,0,0,0,1,1,4
YTGE,0,0,0,1,1,4
TGEW,0,0,0,1,1,4
GEWK,0,0,0,1,1,4
EWKK,0,0,0,1,1,4
WKKY,0,0,0,1,1,4
KKYL,0,0,0,2,2,4
KYLN,0,0,0,1,1,4
YLNS,0,0,0,1,1,4
HAHA,0,0,0,1,1,4
AHAS,0,0,0,1,1,4
HASA,0,0,0,1,1,4
ASAI,0,0,0,1,1,4
SAIA,0,0,0,2,2,4
AIAK,0,0,0,1,1,4
AKAY,0,0,0,2,2,4
KAYA,0,0,0,2,2,4
AYAS,0,0,0,1,1,4
YASE,0,0,0,1,1,4
ASEI,0,0,0,1,1,4
SEIA,0,0,0,1,1,4
EIAF,0,0,0,1,1,4
IAFE,0,0,0,1,1,4
AFEA,0,0,0,2,2,4
FEAA,0,0,0,2,2,4
EAAN,0,0,0,1,1,4
AANQ,0,0,0,2,2,4
ANQA,0,0,0,1,1,4
NQAI,0,0,0,1,1,4
QAIQ,0,0,0,1,1,4
AIQI,0,0,0,1,1,4
IQIH,0,0,0,1,1,4
QIHG,0,0,0,3,3,4
HALR,0,0,0,1,1,4
ALRT,0,0,0,2,2,4
LRTI,0,0,0,1,1,4
RTIV,0,0,0,1,1,4
TIVF,0,0,0,1,1,4
IVFE,0,0,0,1,1,4
VFEL,0,0,0,1,1,4
FELL,0,0,0,1,1,4
ELLT,0,0,0,3,3,4
LLTR,0,0,0,1,1,4
LTRH,0,0,0,2,2,4
HDKH,0,0,0,1,1,4
DKHI,0,0,0,1,1,4
KHIE,0,0,0,1,1,4
HIEI,0,0,0,1,1,4
IEIV,0,0,0,1,1,4
EIVV,0,0,0,1,1,4
IVVR,0,0,0,1,1,4
VVRQ,0,0,0,1,1,4
VRQM,0,0,0,1,1,4
DLVT,0,0,0,1,1,4
LVTD,0,0,0,1,1,4
VTDG,0,0,0,1,1,4
TDGL,0,0,0,1,1,4
GLIT,0,0,0,1,1,4
ITLY,0,0,0,1,1,4
TLYI,0,0,0,1,1,4
LYIE,0,0,0,2,2,4
YIET,0,0,0,1,1,4
IETK,0,0,0,1,1,4
HFGS,0,0,0,1,1,4
GSLL,0,0,0,2,2,4
SLLL,0,0,0,1,1,4
LLLA,0,0,0,3,3,4
LLAA,0,0,0,1,1,4
LAAW,0,0,0,1,1,4
AAWL,0,0,0,1,1,4
AWLA,0,0,0,2,2,4
WLAE,0,0,0,1,1,4
HGLV,0,0,0,1,1,4
GLVK,0,0,0,1,1,4
LVKA,0,0,0,1,1,4
KAGH,0,0,0,1,1,4
AGHP,0,0,0,1,1,4
GHPL,0,0,0,1,1,4
HPLK,0,0,0,1,1,4
PLKR,0,0,0,1,1,4
LKRK,0,0,0,1,1,4
KRKL,0,0,0,1,1,4
RKLG,0,0,0,1,1,4
KLGH,0,0,0,1,1,4
HHKA,0,0,0,1,1,4
HKAY,0,0,0,2,2,4
KAYV,0,0,0,1,1,4
AYVD,0,0,0,1,1,4
YVDG,0,0,0,1,1,4
VDGA,0,0,0,1,1,4
DGAN,0,0,0,1,1,4
GANT,0,0,0,1,1,4
ANTA,0,0,0,1,1,4
NTAL,0,0,0,1,1,4
TALD,0,0,0,1,1,4
AEAR,0,0,0,2,2,4
EARD,0,0,0,1,1,4
ARDK,0,0,0,1,1,4
HKEM,0,0,0,1,1,4
KEMA,0,0,0,1,1,4
MAKA,0,0,0,1,1,4
KAFE,0,0,0,2,2,4
AFEE,0,0,0,2,2,4
FEEW,0,0,0,1,1,4
HLDL,0,0,0,1,1,4
LDLI,0,0,0,1,1,4
DLIN,0,0,0,1,1,4
LINM,0,0,0,1,1,4
INMM,0,0,0,1,1,4
NMMS,0,0,0,1,1,4
MMSR,0,0,0,1,1,4
MSRL,0,0,0,1,1,4
SRLA,0,0,0,4,4,4
RLAR,0,0,0,1,1,4
AREE,0,0,0,1,1,4
EELV,0,0,0,1,1,4
ELVH,0,0,0,1,1,4
LVHH,0,0,0,1,1,4
VHHE,0,0,0,1,1,4
HHEQ,0,0,0,1,1,4
HEQV,0,0,0,1,1,4
QVLR,0,0,0,1,1,4
LRLM,0,0,0,1,1,4
RLMK,0,0,0,1,1,4
LMKR,0,0,0,1,1,4
MKRR,0,0,0,1,1,4
HMKM,0,0,0,1,1,4
MKMR,0,0,0,1,1,4
KMRS,0,0,0,1,1,4
MRSQ,0,0,0,1,1,4
RSQL,0,0,0,1,1,4
QLLI,0,0,0,1,1,4
LLIV,0,0,0,2,2,4
LIVL,0,0,0,1,1,4
IVLQ,0,0,0,1,1,4
VLQE,0,0,0,1,1,4
LQEH,0,0,0,1,1,4
QEHL,0,0,0,1,1,4
EHLR,0,0,0,2,2,4
HLRN,0,0,0,1,1,4
HPAF,0,0,0,1,1,4
PAFI,0,0,0,1,1,4
AFIA,0,0,0,1,1,4
FIAH,0,0,0,1,1,4
IAHA,0,0,0,1,1,4
AHAD,0,0,0,1,1,4
HADR,0,0,0,1,1,4
ADRV,0,0,0,1,1,4
DRVL,0,0,0,2,2,4
RVLG,0,0,0,2,2,4
VLGG,0,0,0,1,1,4
LGGL,0,0,0,1,1,4
GGLD,0,0,0,1,1,4
GLDI,0,0,0,1,1,4
DIAI,0,0,0,1,1,4
IAIS,0,0,0,1,1,4
AIST,0,0,0,1,1,4
HPFY,0,0,0,1,1,4
PFYQ,0,0,0,1,1,4
FYQA,0,0,0,1,1,4
YQAL,0,0,0,1,1,4
QALG,0,0,0,1,1,4
ALGQ,0,0,0,1,1,4
LGQL,0,0,0,1,1,4
GQLA,0,0,0,1,1,4
QLAR,0,0,0,1,1,4
RLTL,0,0,0,1,1,4
LTLA,0,0,0,1,1,4
TLAQ,0,0,0,1,1,4
LAQW,0,0,0,3,3,4
AQWQ,0,0,0,1,1,4
QWQA,0,0,0,2,2,4
WQAQ,0,0,0,2,2,4
QAQL,0,0,0,1,1,4
HQAA,0,0,0,1,1,4
QAAM,0,0,0,1,1,4
AMQM,0,0,0,1,1,4
MQML,0,0,0,1,1,4
QMLK,0,0,0,1,1,4
MLKE,0,0,0,1,1,4
LKET,0,0,0,1,1,4
KETI,0,0,0,1,1,4
TINE,0,0,0,1,1,4
INEE,0,0,0,1,1,4
NEEA,0,0,0,1,1,4
AAEW,0,0,0,1,1,4
AEWD,0,0,0,1,1,4
EWDR,0,0,0,1,1,4
WDRL,0,0,0,1,1,4
DRLH,0,0,0,1,1,4
SATR,0,0,0,1,1,4
ATRA,0,0,0,1,1,4
TRAA,0,0,0,1,1,4
AAML,0,0,0,1,1,4
AMLV,0,0,0,1,1,4
MLVR,0,0,0,1,1,4
LVRI,0,0,0,2,2,4
VRIN,0,0,0,1,1,4
RINT,0,0,0,1,1,4
HSDW,0,0,0,1,1,4
SDWI,0,0,0,1,1,4
DWIS,0,0,0,1,1,4
WISN,0,0,0,1,1,4
ISNA,0,0,0,1,1,4
SNAN,0,0,0,1,1,4
NANK,0,0,0,1,1,4
ANKV,0,0,0,1,1,4
NKVR,0,0,0,1,1,4
KVRV,0,0,0,1,1,4
VRVI,0,0,0,1,1,4
RVIY,0,0,0,1,1,4
VIYW,0,0,0,1,1,4
IYWQ,0,0,0,1,1,4
YWQM,0,0,0,1,1,4
WQMT,0,0,0,1,1,4
HSRR,0,0,0,1,1,4
SRRG,0,0,0,1,1,4
RGLL,0,0,0,1,1,4
LLKM,0,0,0,1,1,4
LKMV,0,0,0,1,1,4
KMVG,0,0,0,1,1,4
MVGK,0,0,0,1,1,4
VGKR,0,0,0,1,1,4
GKRR,0,0,0,2,2,4
KRRR,0,0,0,1,1,4
LLAY,0,0,0,1,1,4
LAYL,0,0,0,2,2,4
AYLR,0,0,0,1,1,4
YLRN,0,0,0,1,1,4
LRNK,0,0,0,1,1,4
HTFL,0,0,0,1,1,4
TFLD,0,0,0,1,1,4
FLDD,0,0,0,1,1,4
LDDI,0,0,0,1,1,4
DDIV,0,0,0,1,1,4
DIVG,0,0,0,1,1,4
IVGA,0,0,0,1,1,4
VGAI,0,0,0,1,1,4
GAIA,0,0,0,1,1,4
IAAA,0,0,0,1,1,4
AAAA,0,0,0,3,3,4
AAAS,0,0,0,1,1,4
AASR,0,0,0,1,1,4
ASRL,0,0,0,2,2,4
RLAH,0,0,0,1,1,4
AHSY,0,0,0,1,1,4
HSYH,0,0,0,1,1,4
SYHD,0,0,0,1,1,4
HVVD,0,0,0,1,1,4
VVDE,0,0,0,1,1,4
VDEK,0,0,0,1,1,4
EKAR,0,0,0,1,1,4
KARL,0,0,0,1,1,4
ARLI,0,0,0,1,1,4
RLIY,0,0,0,1,1,4
LIYE,0,0,0,1,1,4
IYED,0,0,0,1,1,4
HWDK,0,0,0,1,1,4
WDKV,0,0,0,1,1,4
DKVA,0,0,0,1,1,4
KVAD,0,0,0,1,1,4
VADM,0,0,0,2,2,4
ADMV,0,0,0,1,1,4
DMVA,0,0,0,1,1,4
MVAN,0,0,0,1,1,4
VANF,0,0,0,1,1,4
ANFA,0,0,0,1,1,4
NFAH,0,0,0,1,1,4
FAHE,0,0,0,1,1,4
AHEI,0,0,0,1,1,4
HEID,0,0,0,1,1,4
EIDT,0,0,0,1,1,4
IDTY,0,0,0,2,2,4
DTYG,0,0,0,1,1,4
IAMV,0,0,0,1,1,4
AMVN,0,0,0,1,1,4
MVNG,0,0,0,1,1,4
VNGL,0,0,0,1,1,4
NGLM,0,0,0,1,1,4
GLMG,0,0,0,1,1,4
LMGV,0,0,0,1,1,4
MGVL,0,0,0,1,1,4
GVLD,0,0,0,1,1,4
VLDK,0,0,0,1,1,4
KLAH,0,0,0,1,1,4
LAHL,0,0,0,1,1,4
AHLI,0,0,0,1,1,4
HLID,0,0,0,1,1,4
LIDE,0,0,0,1,1,4
IASE,0,0,0,1,1,4
ASEF,0,0,0,1,1,4
SEFK,0,0,0,1,1,4
EFKN,0,0,0,1,1,4
FKNI,0,0,0,1,1,4
KNIA,0,0,0,1,1,4
NIAT,0,0,0,1,1,4
IATN,0,0,0,1,1,4
ATNS,0,0,0,2,2,4
IDDL,0,0,0,1,1,4
DLRV,0,0,0,1,1,4
LRVI,0,0,0,1,1,4
RVIA,0,0,0,1,1,4
VIAR,0,0,0,1,1,4
IARE,0,0,0,2,2,4
AREN,0,0,0,1,1,4
RENL,0,0,0,1,1,4
ENLE,0,0,0,1,1,4
NLER,0,0,0,1,1,4
LERR,0,0,0,1,1,4
ERRR,0,0,0,1,1,4
RRRK,0,0,0,1,1,4
IDDS,0,0,0,1,1,4
DDSV,0,0,0,1,1,4
SVNN,0,0,0,1,1,4
VNNL,0,0,0,2,2,4
NNLI,0,0,0,1,1,4
NLIP,0,0,0,1,1,4
LIPF,0,0,0,1,1,4
IPFM,0,0,0,1,1,4
PFMQ,0,0,0,1,1,4
FMQK,0,0,0,2,2,4
MQKH,0,0,0,1,1,4
IEEA,0,0,0,1,1,4
EEAT,0,0,0,1,1,4
EATE,0,0,0,1,1,4
ATEF,0,0,0,1,1,4
TEFY,0,0,0,1,1,4
EFYE,0,0,0,1,1,4
FYEN,0,0,0,1,1,4
YEND,0,0,0,1,1,4
ENDV,0,0,0,1,1,4
IEFR,0,0,0,1,1,4
EFRK,0,0,0,1,1,4
FRKA,0,0,0,2,2,4
RKAF,0,0,0,2,2,4
LKIL,0,0,0,1,1,4
IGVQ,0,0,0,1,1,4
GVQQ,0,0,0,1,1,4
VQQH,0,0,0,1,1,4
QQHA,0,0,0,1,1,4
QHAD,0,0,0,1,1,4
HADK,0,0,0,1,1,4
ADKV,0,0,0,1,1,4
DKVQ,0,0,0,1,1,4
KVQR,0,0,0,1,1,4
VQRA,0,0,0,1,1,4
QRAL,0,0,0,2,2,4
ALGE,0,0,0,1,1,4
GEAI,0,0,0,1,1,4
EAID,0,0,0,1,1,4
AIDD,0,0,0,1,1,4
IHNV,0,0,0,1,1,4
HNVV,0,0,0,1,1,4
NVVG,0,0,0,1,1,4
VVGK,0,0,0,1,1,4
IKPL,0,0,0,1,1,4
KPLN,0,0,0,1,1,4
PLNN,0,0,0,1,1,4
LNNF,0,0,0,2,2,4
NNFA,0,0,0,1,1,4
NFAA,0,0,0,1,1,4
FAAE,0,0,0,1,1,4
AAEV,0,0,0,1,1,4
AEVG,0,0,0,1,1,4
EVGK,0,0,0,1,1,4
VGKI,0,0,0,1,1,4
GKIR,0,0,0,1,1,4
KIRD,0,0,0,1,1,4
IRDS,0,0,0,1,1,4
IMEL,0,0,0,1,1,4
MELL,0,0,0,2,2,4
ELLG,0,0,0,2,2,4
LLGT,0,0,0,1,1,4
LGTV,0,0,0,1,1,4
GTVI,0,0,0,1,1,4
TVIQ,0,0,0,1,1,4
VIQH,0,0,0,1,1,4
IQHE,0,0,0,1,1,4
QHEG,0,0,0,1,1,4
HEGI,0,0,0,1,1,4
EGIH,0,0,0,1,1,4
GIHQ,0,0,0,1,1,4
IHQG,0,0,0,1,1,4
HQGQ,0,0,0,1,1,4
QGQY,0,0,0,1,1,4
GQYY,0,0,0,1,1,4
QYYV,0,0,0,1,1,4
YYVA,0,0,0,1,1,4
YVAL,0,0,0,1,1,4
VALK,0,0,0,1,1,4
ALKQ,0,0,0,3,3,4
LKQS,0,0,0,1,1,4
KQSG,0,0,0,1,1,4
IPAA,0,0,0,1,1,4
PAAK,0,0,0,1,1,4
AAKI,0,0,0,1,1,4
AKIN,0,0,0,1,1,4
KINW,0,0,0,1,1,4
INWD,0,0,0,1,1,4
NWDR,0,0,0,1,1,4
WDRD,0,0,0,1,1,4
DRDI,0,0,0,1,1,4
RDIE,0,0,0,1,1,4
DIEY,0,0,0,1,1,4
IEYM,0,0,0,1,1,4
EYMA,0,0,0,1,1,4
YMAG,0,0,0,1,1,4
MAGI,0,0,0,1,1,4
AGIL,0,0,0,1,1,4
GILE,0,0,0,2,2,4
ILEN,0,0,0,2,2,4
IPAV,0,0,0,1,1,4
PAVA,0,0,0,1,1,4
AVAN,0,0,0,1,1,4
VANW,0,0,0,1,1,4
ANWI,0,0,0,1,1,4
NWIK,0,0,0,1,1,4
IKRR,0,0,0,1,1,4
IPEA,0,0,0,1,1,4
PEAK,0,0,0,1,1,4
EAKS,0,0,0,1,1,4
AKSF,0,0,0,1,1,4
KSFY,0,0,0,2,2,4
SFYG,0,0,0,1,1,4
FYGF,0,0,0,1,1,4
YGFQ,0,0,0,1,1,4
GFQI,0,0,0,1,1,4
FQIM,0,0,0,1,1,4
QIMI,0,0,0,1,1,4
IMIE,0,0,0,1,1,4
MIEN,0,0,0,1,1,4
IENI,0,0,0,2,2,4
ENIH,0,0,0,1,1,4
NIHS,0,0,0,1,1,4
IHSE,0,0,0,1,1,4
HSET,0,0,0,1,1,4
SETY,0,0,0,1,1,4
ETYS,0,0,0,1,1,4
TYSL,0,0,0,1,1,4
YSLL,0,0,0,1,1,4
SLLI,0,0,0,1,1,4
LLID,0,0,0,1,1,4
LIDT,0,0,0,1,1,4
DTYI,0,0,0,1,1,4
IRVN,0,0,0,1,1,4
RVNA,0,0,0,2,2,4
VNAT,0,0,0,1,1,4
NATK,0,0,0,1,1,4
ATKA,0,0,0,1,1,4
TKAY,0,0,0,1,1,4
KAYE,0,0,0,2,2,4
AYEM,0,0,0,1,1,4
YEMA,0,0,0,1,1,4
EMAL,0,0,0,1,1,4
KDAE,0,0,0,1,1,4
AENH,0,0,0,1,1,4
ENHK,0,0,0,1,1,4
NHKA,0,0,0,1,1,4
KAYL,0,0,0,2,2,4
AYLK,0,0,0,1,1,4
YLKS,0,0,0,2,2,4
LKSH,0,0,0,1,1,4
KDFE,0,0,0,1,1,4
DFET,0,0,0,1,1,4
FETL,0,0,0,1,1,4
TLKV,0,0,0,1,1,4
LKVD,0,0,0,1,1,4
KVDF,0,0,0,1,1,4
DFLS,0,0,0,2,2,4
FLSK,0,0,0,1,1,4
SKLP,0,0,0,1,1,4
KLPE,0,0,0,1,1,4
LPEM,0,0,0,2,2,4
EMLK,0,0,0,1,1,4
MLKM,0,0,0,1,1,4
LKMF,0,0,0,1,1,4
KMFE,0,0,0,1,1,4
MFED,0,0,0,1,1,4
FEDR,0,0,0,1,1,4
EDRL,0,0,0,1,1,4
KDTV,0,0,0,1,1,4
DTVI,0,0,0,1,1,4
TVIE,0,0,0,1,1,4
VIED,0,0,0,1,1,4
IEDI,0,0,0,1,1,4
EDII,0,0,0,1,1,4
DIID,0,0,0,3,3,4
IIDK,0,0,0,1,1,4
IDKT,0,0,0,1,1,4
DKTF,0,0,0,1,1,4
KTFE,0,0,0,1,1,4
TFEE,0,0,0,1,1,4
FEEA,0,0,0,1,1,4
EEAD,0,0,0,1,1,4
KEDI,0,0,0,2,2,4
EDIH,0,0,0,1,1,4
DIHR,0,0,0,1,1,4
IHRS,0,0,0,1,1,4
HRSL,0,0,0,1,1,4
RSLV,0,0,0,1,1,4
EELT,0,0,0,1,1,4
ELTK,0,0,0,1,1,4
LTKI,0,0,0,2,2,4
TKIS,0,0,0,1,1,4
KISA,0,0,0,1,1,4
ISAK,0,0,0,1,1,4
SAKE,0,0,0,1,1,4
AKEK,0,0,0,1,1,4
KEEG,0,0,0,1,1,4
EEGY,0,0,0,1,1,4
EGYF,0,0,0,1,1,4
GYFY,0,0,0,1,1,4
YFYF,0,0,0,1,1,4
FYFR,0,0,0,1,1,4
YFRS,0,0,0,1,1,4
FRSR,0,0,0,1,1,4
RSRL,0,0,0,2,2,4
SRLS,0,0,0,1,1,4
RLSQ,0,0,0,1,1,4
KEEV,0,0,0,1,1,4
EEVQ,0,0,0,1,1,4
EVQK,0,0,0,2,2,4
VQKV,0,0,0,2,2,4
QKVL,0,0,0,1,1,4
KVLE,0,0,0,1,1,4
VLED,0,0,0,1,1,4
KEIA,0,0,0,1,1,4
EIAE,0,0,0,1,1,4
AEKM,0,0,0,2,2,4
EKMV,0,0,0,1,1,4
KMVE,0,0,0,1,1,4
MVEG,0,0,0,1,1,4
VEGR,0,0,0,1,1,4
EGRM,0,0,0,1,1,4
GRMK,0,0,0,1,1,4
RMKK,0,0,0,1,1,4
MKKF,0,0,0,1,1,4
KKFT,0,0,0,1,1,4
KFTG,0,0,0,1,1,4
FTGE,0,0,0,1,1,4
TGEV,0,0,0,1,1,4
LKKW,0,0,0,1,1,4
KKWE,0,0,0,1,1,4
KWEG,0,0,0,1,1,4
WEGI,0,0,0,1,1,4
EGIW,0,0,0,1,1,4
GIWA,0,0,0,1,1,4
IWAT,0,0,0,1,1,4
WATF,0,0,0,1,1,4
ATFK,0,0,0,1,1,4
TFKP,0,0,0,1,1,4
FKPA,0,0,0,1,1,4
KPAL,0,0,0,1,1,4
PALS,0,0,0,1,1,4
ALSA,0,0,0,3,3,4
LSAV,0,0,0,1,1,4
SAVV,0,0,0,1,1,4
KFLR,0,0,0,1,1,4
FLRF,0,0,0,1,1,4
LRFI,0,0,0,1,1,4
RFIL,0,0,0,1,1,4
FILK,0,0,0,1,1,4
ILKW,0,0,0,1,1,4
LKWF,0,0,0,1,1,4
KWFK,0,0,0,1,1,4
WFKV,0,0,0,1,1,4
KVIF,0,0,0,1,1,4
VIFQ,0,0,0,1,1,4
LTKL,0,0,0,3,3,4
TKLK,0,0,0,1,1,4
KLKN,0,0,0,1,1,4
LKNI,0,0,0,1,1,4
KNIV,0,0,0,1,1,4
NIVA,0,0,0,1,1,4
IVAN,0,0,0,1,1,4
VANI,0,0,0,1,1,4
ANIR,0,0,0,1,1,4
NIRI,0,0,0,1,1,4
IRIW,0,0,0,1,1,4
RIWW,0,0,0,1,1,4
IWWV,0,0,0,1,1,4
WWVI,0,0,0,1,1,4
WVIL,0,0,0,1,1,4
VILL,0,0,0,1,1,4
KGQE,0,0,0,1,1,4
GQEY,0,0,0,1,1,4
QEYI,0,0,0,1,1,4
EYIN,0,0,0,1,1,4
YINN,0,0,0,1,1,4
INNI,0,0,0,1,1,4
NNIH,0,0,0,1,1,4
NIHL,0,0,0,1,1,4
KHFD,0,0,0,1,1,4
HFDF,0,0,0,1,1,4
FDFL,0,0,0,1,1,4
DFLA,0,0,0,1,1,4
FLAE,0,0,0,2,2,4
LAEF,0,0,0,1,1,4
AEFN,0,0,0,1,1,4
EFNA,0,0,0,1,1,4
FNAK,0,0,0,1,1,4
NAKA,0,0,0,1,1,4
AKAN,0,0,0,1,1,4
KAND,0,0,0,1,1,4
KHHA,0,0,0,1,1,4
HHAA,0,0,0,1,1,4
HAAY,0,0,0,1,1,4
AAYV,0,0,0,1,1,4
AYVN,0,0,0,1,1,4
YVNN,0,0,0,1,1,4
NNLN,0,0,0,2,2,4
NLNN,0,0,0,1,1,4
LNNA,0,0,0,1,1,4
NNAL,0,0,0,1,1,4
NALK,0,0,0,2,2,4
KIPD,0,0,0,1,1,4
IPDD,0,0,0,1,1,4
PDDL,0,0,0,1,1,4
DDLQ,0,0,0,1,1,4
DLQA,0,0,0,1,1,4
LQAD,0,0,0,1,1,4
QADF,0,0,0,1,1,4
ADFN,0,0,0,1,1,4
DFNK,0,0,0,1,1,4
FNKF,0,0,0,1,1,4
NKFR,0,0,0,1,1,4
KKAE,0,0,0,1,1,4
KAEA,0,0,0,1,1,4
AEAV,0,0,0,1,1,4
EAVA,0,0,0,1,1,4
AVAT,0,0,0,1,1,4
VATV,0,0,0,1,1,4
ATVV,0,0,0,1,1,4
TVVA,0,0,0,1,1,4
VVAA,0,0,0,2,2,4
AAVD,0,0,0,1,1,4
AVDQ,0,0,0,1,1,4
VDQA,0,0,0,1,1,4
DQAR,0,0,0,1,1,4
QARV,0,0,0,3,3,4
KKDV,0,0,0,1,1,4
KDVK,0,0,0,1,1,4
DVKL,0,0,0,1,1,4
VKLI,0,0,0,2,2,4
KLIL,0,0,0,1,1,4
LILD,0,0,0,1,1,4
ILDT,0,0,0,1,1,4
LDTI,0,0,0,1,1,4
DTIL,0,0,0,1,1,4
TILE,0,0,0,1,1,4
ILET,0,0,0,2,2,4
LETI,0,0,0,1,1,4
ETIT,0,0,0,2,2,4
TITE,0,0,0,2,2,4
ITEA,0,0,0,1,1,4
TEAL,0,0,0,1,1,4
KKEE,0,0,0,2,2,4
EELQ,0,0,0,1,1,4
LQRS,0,0,0,1,1,4
QRSL,0,0,0,1,1,4
RSLN,0,0,0,1,1,4
SLNI,0,0,0,1,1,4
LNIL,0,0,0,3,3,4
NILT,0,0,0,1,1,4
ILTA,0,0,0,1,1,4
LTAF,0,0,0,1,1,4
KKQE,0,0,0,1,1,4
KQEL,0,0,0,1,1,4
QELL,0,0,0,4,4,4
ELLE,0,0,0,1,1,4
LTKH,0,0,0,1,1,4
TKHF,0,0,0,1,1,4
KHFQ,0,0,0,1,1,4
KKTA,0,0,0,1,1,4
KTAE,0,0,0,1,1,4
RLIV,0,0,0,1,1,4
LIVE,0,0,0,1,1,4
IVEM,0,0,0,1,1,4
VEMK,0,0,0,1,1,4
EMKD,0,0,0,1,1,4
MKDR,0,0,0,1,1,4
KDRF,0,0,0,1,1,4
DRFK,0,0,0,1,1,4
RFKG,0,0,0,1,1,4
KKVK,0,0,0,1,1,4
KVKG,0,0,0,1,1,4
KGYK,0,0,0,1,1,4
GYKR,0,0,0,1,1,4
YKRA,0,0,0,1,1,4
RALT,0,0,0,2,2,4
ALTE,0,0,0,2,2,4
KLDS,0,0,0,1,1,4
LDSR,0,0,0,1,1,4
DSRF,0,0,0,1,1,4
SRFD,0,0,0,1,1,4
RFDN,0,0,0,1,1,4
FDNN,0,0,0,1,1,4
DNNL,0,0,0,1,1,4
NNLG,0,0,0,1,1,4
NLGK,0,0,0,1,1,4
LGKF,0,0,0,1,1,4
GKFR,0,0,0,1,1,4
KFRF,0,0,0,1,1,4
FRFV,0,0,0,1,1,4
RFVL,0,0,0,1,1,4
FVLL,0,0,0,1,1,4
VLLL,0,0,0,1,1,4
LLLF,0,0,0,1,1,4
LLFV,0,0,0,1,1,4
LEEK,0,0,0,1,1,4
EEKF,0,0,0,1,1,4
EKFP,0,0,0,1,1,4
KFPQ,0,0,0,1,1,4
FPQV,0,0,0,1,1,4
PQVA,0,0,0,1,1,4
QVAA,0,0,0,1,1,4
VAAT,0,0,0,2,2,4
LKEL,0,0,0,1,1,4
KELA,0,0,0,1,1,4
ELAL,0,0,0,2,2,4
LALI,0,0,0,1,1,4
ALIF,0,0,0,1,1,4
LIFI,0,0,0,1,1,4
IFIS,0,0,0,1,1,4
FISN,0,0,0,1,1,4
ISNL,0,0,0,1,1,4
SNLV,0,0,0,1,1,4
NLVA,0,0,0,2,2,4
LVAN,0,0,0,2,2,4
KNIK,0,0,0,1,1,4
NIKR,0,0,0,1,1,4
IKRN,0,0,0,1,1,4
RNVE,0,0,0,1,1,4
NVEK,0,0,0,1,1,4
VEKI,0,0,0,1,1,4
IIAQ,0,0,0,1,1,4
IAQW,0,0,0,1,1,4
AQWD,0,0,0,1,1,4
QWDE,0,0,0,1,1,4
WDER,0,0,0,1,1,4
DERT,0,0,0,1,1,4
ERTR,0,0,0,1,1,4
RTRK,0,0,0,1,1,4
KPEE,0,0,0,1,1,4
EEVE,0,0,0,1,1,4
EVEQ,0,0,0,1,1,4
VEQI,0,0,0,1,1,4
EQIK,0,0,0,1,1,4
QIKL,0,0,0,1,1,4
IKLY,0,0,0,1,1,4
KLYV,0,0,0,1,1,4
LYVM,0,0,0,1,1,4
YVMS,0,0,0,1,1,4
VMSR,0,0,0,1,1,4
MSRE,0,0,0,1,1,4
SREY,0,0,0,1,1,4
REYE,0,0,0,1,1,4
EYED,0,0,0,1,1,4
YEDY,0,0,0,1,1,4
EDYM,0,0,0,1,1,4
DYMA,0,0,0,1,1,4
YMAR,0,0,0,1,1,4
KPEQ,0,0,0,1,1,4
PEQY,0,0,0,1,1,4
EQYN,0,0,0,1,1,4
QYNI,0,0,0,1,1,4
YNIV,0,0,0,1,1,4
NIVG,0,0,0,1,1,4
IVGE,0,0,0,1,1,4
VGEH,0,0,0,1,1,4
GEHL,0,0,0,1,1,4
EHLL,0,0,0,2,2,4
HLLA,0,0,0,1,1,4
LLAT,0,0,0,1,1,4
LATL,0,0,0,1,1,4
ATLD,0,0,0,1,1,4
TLDE,0,0,0,1,1,4
DEMF,0,0,0,1,1,4
EMFS,0,0,0,1,1,4
KPQE,0,0,0,2,2,4
PQEL,0,0,0,1,1,4
LLSL,0,0,0,2,2,4
SLII,0,0,0,1,1,4
IIER,0,0,0,1,1,4
IERF,0,0,0,1,1,4
ERFE,0,0,0,1,1,4
PQER,0,0,0,1,1,4
QERA,0,0,0,1,1,4
ERAD,0,0,0,1,1,4
RADL,0,0,0,1,1,4
ADLI,0,0,0,1,1,4
DLIS,0,0,0,1,1,4
LISY,0,0,0,1,1,4
ISYL,0,0,0,1,1,4
SYLK,0,0,0,1,1,4
LKEA,0,0,0,2,2,4
KEAT,0,0,0,1,1,4
EATS,0,0,0,1,1,4
KPWL,0,0,0,1,1,4
PWLS,0,0,0,1,1,4
WLSV,0,0,0,1,1,4
LSVI,0,0,0,1,1,4
SVIL,0,0,0,1,1,4
VILF,0,0,0,1,1,4
ILFL,0,0,0,1,1,4
LFLI,0,0,0,1,1,4
FLIR,0,0,0,3,3,4
LIRE,0,0,0,4,4,4
IRER,0,0,0,1,1,4
RERS,0,0,0,1,1,4
ERSR,0,0,0,1,1,4
QAEA,0,0,0,3,3,4
AEAE,0,0,0,1,1,4
EAEE,0,0,0,1,1,4
AEEF,0,0,0,1,1,4
EEFV,0,0,0,1,1,4
EFVQ,0,0,0,1,1,4
FVQT,0,0,0,1,1,4
VQTL,0,0,0,2,2,4
QTLG,0,0,0,1,1,4
TLGQ,0,0,0,1,1,4
LGQS,0,0,0,1,1,4
GQSL,0,0,0,1,1,4
QSLA,0,0,0,2,2,4
KQLT,0,0,0,1,1,4
QLTA,0,0,0,1,1,4
LTAI,0,0,0,1,1,4
TAIA,0,0,0,1,1,4
IAAL,0,0,0,2,2,4
KREI,0,0,0,1,1,4
REII,0,0,0,1,1,4
EIIH,0,0,0,1,1,4
IIHA,0,0,0,1,1,4
IHAV,0,0,0,1,1,4
AVLT,0,0,0,1,1,4
VLTG,0,0,0,1,1,4
LTGL,0,0,0,1,1,4
TGLA,0,0,0,1,1,4
GLAL,0,0,0,1,1,4
LALD,0,0,0,1,1,4
ALDQ,0,0,0,1,1,4
DQLA,0,0,0,2,2,4
QLAE,0,0,0,1,1,4
KREV,0,0,0,1,1,4
REVQ,0,0,0,1,1,4
EVQN,0,0,0,1,1,4
VQNA,0,0,0,1,1,4
QNAI,0,0,0,2,2,4
NAIL,0,0,0,2,2,4
AILT,0,0,0,2,2,4
ILTG,0,0,0,1,1,4
LTGI,0,0,0,1,1,4
TGIQ,0,0,0,1,1,4
GIQL,0,0,0,1,1,4
IQLD,0,0,0,1,1,4
QLDK,0,0,0,1,1,4
KSEA,0,0,0,1,1,4
SEAL,0,0,0,1,1,4
LAKM,0,0,0,1,1,4
AKMW,0,0,0,1,1,4
KMWG,0,0,0,1,1,4
MWGQ,0,0,0,1,1,4
WGQR,0,0,0,1,1,4
KTAS,0,0,0,1,1,4
TAST,0,0,0,1,1,4
ASTG,0,0,0,2,2,4
STGF,0,0,0,1,1,4
GFAE,0,0,0,1,1,4
FAEL,0,0,0,1,1,4
AELL,0,0,0,1,1,4
ELLK,0,0,0,1,1,4
LLKD,0,0,0,2,2,4
LKDR,0,0,0,2,2,4
KDRR,0,0,0,1,1,4
DRRE,0,0,0,1,1,4
RREQ,0,0,0,1,1,4
REQV,0,0,0,2,2,4
KTFR,0,0,0,1,1,4
TFRT,0,0,0,1,1,4
FRTT,0,0,0,1,1,4
RTTF,0,0,0,1,1,4
TTFK,0,0,0,1,1,4
TFKT,0,0,0,1,1,4
KTLL,0,0,0,1,1,4
VAEF,0,0,0,1,1,4
AEFE,0,0,0,1,1,4
EFER,0,0,0,1,1,4
FERL,0,0,0,2,2,4
ERLF,0,0,0,1,1,4
LFRQ,0,0,0,1,1,4
FRQA,0,0,0,2,2,4
RQAA,0,0,0,1,1,4
KVNR,0,0,0,1,1,4
VNRA,0,0,0,1,1,4
NRAV,0,0,0,1,1,4
RAVA,0,0,0,3,3,4
VAAE,0,0,0,1,1,4
AAEI,0,0,0,1,1,4
AEIR,0,0,0,2,2,4
EIRN,0,0,0,1,1,4
IRNW,0,0,0,1,1,4
RNWT,0,0,0,1,1,4
NWTW,0,0,0,1,1,4
WTWV,0,0,0,1,1,4
TWVF,0,0,0,1,1,4
WVFL,0,0,0,1,1,4
VFLI,0,0,0,1,1,4
FLIW,0,0,0,1,1,4
KVRE,0,0,0,2,2,4
VRET,0,0,0,1,1,4
RETR,0,0,0,1,1,4
TREI,0,0,0,1,1,4
REIL,0,0,0,1,1,4
EILD,0,0,0,2,2,4
ILDI,0,0,0,1,1,4
LDII,0,0,0,1,1,4
IIDT,0,0,0,1,1,4
IDTV,0,0,0,1,1,4
DTVY,0,0,0,1,1,4
TVYN,0,0,0,1,1,4
VYNS,0,0,0,1,1,4
KVRG,0,0,0,1,1,4
VRGL,0,0,0,1,1,4
RGLI,0,0,0,1,1,4
GLIE,0,0,0,2,2,4
LIEI,0,0,0,1,1,4
IEII,0,0,0,1,1,4
EIIS,0,0,0,1,1,4
IISN,0,0,0,1,1,4
KVSD,0,0,0,1,1,4
VSDI,0,0,0,1,1,4
SDIL,0,0,0,1,1,4
DILT,0,0,0,1,1,4
ILTV,0,0,0,1,1,4
LTVA,0,0,0,2,2,4
TVAI,0,0,0,1,1,4
VAIR,0,0,0,1,1,4
AIRL,0,0,0,1,1,4
IRLE,0,0,0,1,1,4
RLEE,0,0,0,2,2,4
LEEE,0,0,0,1,1,4
EEEG,0,0,0,1,1,4
EEGE,0,0,0,1,1,4
GERF,0,0,0,2,2,4
ERFY,0,0,0,1,1,4
RFYR,0,0,0,1,1,4
FYRE,0,0,0,1,1,4
RELS,0,0,0,2,2,4
KVVD,0,0,0,1,1,4
VVDN,0,0,0,1,1,4
VDNF,0,0,0,1,1,4
DNFE,0,0,0,1,1,4
NFEN,0,0,0,1,1,4
FENI,0,0,0,1,1,4
ENIL,0,0,0,1,1,4
NILI,0,0,0,1,1,4
ILII,0,0,0,1,1,4
KVWK,0,0,0,1,1,4
VWKG,0,0,0,1,1,4
WKGV,0,0,0,1,1,4
KGVK,0,0,0,1,1,4
GVKT,0,0,0,1,1,4
VKTI,0,0,0,2,2,4
KTII,0,0,0,1,1,4
TIIA,0,0,0,1,1,4
IIAD,0,0,0,1,1,4
IADV,0,0,0,1,1,4
ADVW,0,0,0,1,1,4
DVWQ,0,0,0,1,1,4
VWQV,0,0,0,1,1,4
KWEA,0,0,0,1,1,4
WEAE,0,0,0,1,1,4
EAEK,0,0,0,1,1,4
AEKI,0,0,0,2,2,4
EKIH,0,0,0,1,1,4
KIHI,0,0,0,1,1,4
IHIG,0,0,0,1,1,4
HIGF,0,0,0,1,1,4
IGFR,0,0,0,1,1,4
GFRQ,0,0,0,1,1,4
RQAY,0,0,0,1,1,4
KWVR,0,0,0,1,1,4
WVRI,0,0,0,1,1,4
VRIW,0,0,0,1,1,4
RIWI,0,0,0,1,1,4
IWIK,0,0,0,1,1,4
WIKV,0,0,0,1,1,4
LRGL,0,0,0,1,1,4
RGLF,0,0,0,1,1,4
GLFV,0,0,0,1,1,4
LFVW,0,0,0,1,1,4
FVWV,0,0,0,1,1,4
VWVW,0,0,0,1,1,4
WVWF,0,0,0,1,1,4
VWFF,0,0,0,1,1,4
KYDH,0,0,0,1,1,4
YDHF,0,0,0,1,1,4
DHFA,0,0,0,1,1,4
HFAG,0,0,0,1,1,4
FAGR,0,0,0,1,1,4
AGRA,0,0,0,1,1,4
GRAY,0,0,0,1,1,4
RAYV,0,0,0,1,1,4
AYVR,0,0,0,1,1,4
YVRL,0,0,0,1,1,4
VRLH,0,0,0,1,1,4
RLHQ,0,0,0,1,1,4
LHQD,0,0,0,1,1,4
LADL,0,0,0,2,2,4
ADLQ,0,0,0,1,1,4
DLQE,0,0,0,2,2,4
LQEQ,0,0,0,1,1,4
QEQL,0,0,0,1,1,4
EQLY,0,0,0,1,1,4
QLYN,0,0,0,1,1,4
LYNG,0,0,0,1,1,4
DAYI,0,0,0,1,1,4
AYIN,0,0,0,1,1,4
YINL,0,0,0,1,1,4
INLG,0,0,0,1,1,4
NLGN,0,0,0,1,1,4
LGNV,0,0,0,1,1,4
GNVL,0,0,0,1,1,4
NVLK,0,0,0,1,1,4
LDEA,0,0,0,2,2,4
EAAT,0,0,0,1,1,4
AATR,0,0,0,1,1,4
ATRS,0,0,0,1,1,4
TRSK,0,0,0,1,1,4
RSKA,0,0,0,1,1,4
SKAW,0,0,0,1,1,4
KAWM,0,0,0,1,1,4
AWMV,0,0,0,1,1,4
WMVD,0,0,0,1,1,4
MVDA,0,0,0,1,1,4
VDAL,0,0,0,1,1,4
DALA,0,0,0,2,2,4
LEAR,0,0,0,1,1,4
EARM,0,0,0,1,1,4
ARMK,0,0,0,1,1,4
RMKQ,0,0,0,1,1,4
MKQF,0,0,0,1,1,4
KQFK,0,0,0,1,1,4
QFKD,0,0,0,1,1,4
FKDM,0,0,0,1,1,4
KDML,0,0,0,1,1,4
DMLL,0,0,0,1,1,4
MLLE,0,0,0,1,1,4
LEEF,0,0,0,2,2,4
EEFD,0,0,0,1,1,4
EFDK,0,0,0,1,1,4
DKVS,0,0,0,1,1,4
VSKN,0,0,0,1,1,4
SKNV,0,0,0,1,1,4
KNVD,0,0,0,1,1,4
LEPI,0,0,0,1,1,4
EPIK,0,0,0,1,1,4
PIKA,0,0,0,1,1,4
IKAW,0,0,0,1,1,4
KAWI,0,0,0,1,1,4
AWIE,0,0,0,1,1,4
IEKR,0,0,0,1,1,4
LEQV,0,0,0,1,1,4
EQVE,0,0,0,2,2,4
QVEF,0,0,0,1,1,4
VEFK,0,0,0,1,1,4
EFKL,0,0,0,1,1,4
FKLN,0,0,0,1,1,4
KLNQ,0,0,0,2,2,4
LNQL,0,0,0,2,2,4
NQLL,0,0,0,2,2,4
QLLE,0,0,0,1,1,4
LLEN,0,0,0,1,1,4
LENL,0,0,0,1,1,4
LHDA,0,0,0,1,1,4
DAIH,0,0,0,1,1,4
AIHM,0,0,0,1,1,4
IHMA,0,0,0,1,1,4
HMAA,0,0,0,1,1,4
MAAD,0,0,0,1,1,4
AADN,0,0,0,1,1,4
ADNA,0,0,0,1,1,4
DNAV,0,0,0,1,1,4
RAEA,0,0,0,1,1,4
AEAL,0,0,0,3,3,4
EALI,0,0,0,1,1,4
ALIH,0,0,0,1,1,4
IHLA,0,0,0,1,1,4
HLAN,0,0,0,2,2,4
NAAL,0,0,0,1,1,4
AALE,0,0,0,1,1,4
LKYV,0,0,0,1,1,4
KYVG,0,0,0,1,1,4
YVGM,0,0,0,1,1,4
GMVL,0,0,0,1,1,4
MVLN,0,0,0,1,1,4
VLNE,0,0,0,1,1,4
LNEA,0,0,0,1,1,4
NEAL,0,0,0,1,1,4
LRLW,0,0,0,1,1,4
LLNI,0,0,0,2,2,4
LNIR,0,0,0,1,1,4
NIRR,0,0,0,1,1,4
IRRE,0,0,0,1,1,4
RREF,0,0,0,1,1,4
REFI,0,0,0,1,1,4
EFIE,0,0,0,1,1,4
FIEK,0,0,0,1,1,4
LLPA,0,0,0,1,1,4
PALL,0,0,0,1,1,4
ALLQ,0,0,0,1,1,4
LQQI,0,0,0,1,1,4
QQIG,0,0,0,1,1,4
QIGR,0,0,0,1,1,4
IGRE,0,0,0,1,1,4
GREN,0,0,0,1,1,4
LLTE,0,0,0,1,1,4
LTEV,0,0,0,1,1,4
TEVE,0,0,0,1,1,4
EVET,0,0,0,1,1,4
VETY,0,0,0,1,1,4
ETYV,0,0,0,1,1,4
TYVL,0,0,0,1,1,4
YVLS,0,0,0,1,1,4
VLSI,0,0,0,1,1,4
LMEP,0,0,0,1,1,4
MEPV,0,0,0,1,1,4
EPVR,0,0,0,1,1,4
REAA,0,0,0,1,1,4
EAAG,0,0,0,2,2,4
AAGR,0,0,0,1,1,4
AGRL,0,0,0,1,1,4
GRLA,0,0,0,1,1,4
RLAD,0,0,0,1,1,4
LADA,0,0,0,3,3,4
LMGH,0,0,0,1,1,4
MGHQ,0,0,0,1,1,4
GHQK,0,0,0,1,1,4
HQKK,0,0,0,1,1,4
QKKI,0,0,0,1,1,4
KILG,0,0,0,1,1,4
ILGS,0,0,0,1,1,4
LGSI,0,0,0,2,2,4
GSIQ,0,0,0,1,1,4
SIQT,0,0,0,1,1,4
IQTM,0,0,0,1,1,4
QTMR,0,0,0,1,1,4
TMRA,0,0,0,1,1,4
MRAQ,0,0,0,1,1,4
RAQL,0,0,0,1,1,4
AQLT,0,0,0,1,1,4
NNFS,0,0,0,1,1,4
NFSR,0,0,0,1,1,4
FSRY,0,0,0,1,1,4
SRYF,0,0,0,1,1,4
RYFL,0,0,0,1,1,4
YFLH,0,0,0,1,1,4
FLHQ,0,0,0,1,1,4
LHQS,0,0,0,1,1,4
HQSR,0,0,0,1,1,4
QSRE,0,0,0,1,1,4
SREE,0,0,0,1,1,4
REET,0,0,0,1,1,4
EETE,0,0,0,1,1,4
ETEH,0,0,0,1,1,4
TEHA,0,0,0,1,1,4
EHAE,0,0,0,1,1,4
HAEK,0,0,0,1,1,4
EKLM,0,0,0,1,1,4
KLMR,0,0,0,1,1,4
MRLQ,0,0,0,1,1,4
RLQN,0,0,0,1,1,4
LQNQ,0,0,0,1,1,4
QNQR,0,0,0,1,1,4
NQRG,0,0,0,1,1,4
LPED,0,0,0,1,1,4
PEDQ,0,0,0,1,1,4
EDQE,0,0,0,1,1,4
DQEL,0,0,0,1,1,4
ELLF,0,0,0,2,2,4
LLFQ,0,0,0,1,1,4
LFQS,0,0,0,1,1,4
FQSA,0,0,0,1,1,4
QSAS,0,0,0,1,1,4
SASL,0,0,0,1,1,4
ASLE,0,0,0,1,1,4
SLEL,0,0,0,1,1,4
LELF,0,0,0,1,1,4
ELFV,0,0,0,1,1,4
LFVL,0,0,0,2,2,4
FVLR,0,0,0,1,1,4
RLAY,0,0,0,2,2,4
LAYR,0,0,0,1,1,4
AYRA,0,0,0,1,1,4
LPHF,0,0,0,1,1,4
PHFY,0,0,0,1,1,4
HFYE,0,0,0,1,1,4
FYEL,0,0,0,1,1,4
YELF,0,0,0,1,1,4
ELFS,0,0,0,1,1,4
FSLW,0,0,0,1,1,4
SLWA,0,0,0,1,1,4
LPIH,0,0,0,1,1,4
PIHY,0,0,0,1,1,4
IHYK,0,0,0,1,1,4
HYKL,0,0,0,1,1,4
YKLS,0,0,0,1,1,4
KLSQ,0,0,0,1,1,4
LSQE,0,0,0,1,1,4
SQEF,0,0,0,1,1,4
QEFF,0,0,0,1,1,4
EFFL,0,0,0,1,1,4
FFLK,0,0,0,1,1,4
FLKA,0,0,0,2,2,4
LKAY,0,0,0,3,3,4
LQAP,0,0,0,1,1,4
QAPL,0,0,0,1,1,4
APLQ,0,0,0,1,1,4
PLQR,0,0,0,1,1,4
LQRR,0,0,0,1,1,4
RRIL,0,0,0,1,1,4
RILE,0,0,0,1,1,4
ILEI,0,0,0,1,1,4
LEIG,0,0,0,1,1,4
EIGK,0,0,0,1,1,4
IGKK,0,0,0,1,1,4
GKKH,0,0,0,1,1,4
LQME,0,0,0,1,1,4
QMEF,0,0,0,1,1,4
MEFK,0,0,0,1,1,4
EFKY,0,0,0,1,1,4
FKYL,0,0,0,1,1,4
KYLA,0,0,0,1,1,4
YLAY,0,0,0,1,1,4
AYLT,0,0,0,2,2,4
YLTG,0,0,0,2,2,4
LQNA,0,0,0,2,2,4
NAII,0,0,0,1,1,4
AIIE,0,0,0,1,1,4
IIEF,0,0,0,1,1,4
IEFY,0,0,0,1,1,4
EFYT,0,0,0,1,1,4
FYTE,0,0,0,1,1,4
YTEY,0,0,0,1,1,4
TEYY,0,0,0,1,1,4
LQWY,0,0,0,1,1,4
QWYV,0,0,0,1,1,4
WYVS,0,0,0,1,1,4
YVSE,0,0,0,1,1,4
VSEQ,0,0,0,1,1,4
SEQH,0,0,0,1,1,4
EQHE,0,0,0,1,1,4
QHEE,0,0,0,1,1,4
HEEE,0,0,0,1,1,4
EEEA,0,0,0,1,1,4
EEAL,0,0,0,1,1,4
EALF,0,0,0,1,1,4
LFRG,0,0,0,1,1,4
FRGI,0,0,0,1,1,4
RGIV,0,0,0,1,1,4
GIVD,0,0,0,1,1,4
IVDK,0,0,0,1,1,4
VDKI,0,0,0,1,1,4
DKIK,0,0,0,2,2,4
KIKL,0,0,0,1,1,4
IKLI,0,0,0,1,1,4
REIV,0,0,0,1,1,4
EIVE,0,0,0,1,1,4
IVEN,0,0,0,1,1,4
VENM,0,0,0,1,1,4
ENMI,0,0,0,1,1,4
NMIK,0,0,0,1,1,4
MIKS,0,0,0,2,2,4
IKSS,0,0,0,1,1,4
KSSL,0,0,0,2,2,4
SSLE,0,0,0,1,1,4
SLER,0,0,0,1,1,4
RAIA,0,0,0,2,2,4
IAAY,0,0,0,1,1,4
LRSW,0,0,0,1,1,4
RSWF,0,0,0,1,1,4
SWFR,0,0,0,1,1,4
WFRE,0,0,0,1,1,4
LIAH,0,0,0,1,1,4
IAHR,0,0,0,2,2,4
HRLA,0,0,0,1,1,4
RLAS,0,0,0,1,1,4
LASV,0,0,0,1,1,4
ASVN,0,0,0,1,1,4
SVNL,0,0,0,1,1,4
LRTY,0,0,0,1,1,4
RTYF,0,0,0,1,1,4
TYFM,0,0,0,1,1,4
YFME,0,0,0,1,1,4
MERL,0,0,0,1,1,4
RLRH,0,0,0,1,1,4
LRHY,0,0,0,1,1,4
RHYR,0,0,0,1,1,4
HYRQ,0,0,0,1,1,4
YRQL,0,0,0,1,1,4
RQLS,0,0,0,1,1,4
QLSL,0,0,0,1,1,4
LSTV,0,0,0,1,1,4
STVS,0,0,0,1,1,4
TVSN,0,0,0,1,1,4
VSNF,0,0,0,1,1,4
SNFF,0,0,0,1,1,4
NFFM,0,0,0,1,1,4
FFMN,0,0,0,1,1,4
FMNA,0,0,0,1,1,4
LVGA,0,0,0,1,1,4
VGAL,0,0,0,1,1,4
GALM,0,0,0,1,1,4
ALMH,0,0,0,1,1,4
LMHV,0,0,0,1,1,4
MHVM,0,0,0,1,1,4
HVMQ,0,0,0,1,1,4
VMQK,0,0,0,1,1,4
MQKR,0,0,0,1,1,4
QKRS,0,0,0,1,1,4
KRSR,0,0,0,2,2,4
LVLP,0,0,0,1,1,4
VLPI,0,0,0,1,1,4
LPIA,0,0,0,1,1,4
PIAQ,0,0,0,1,1,4
IAQA,0,0,0,1,1,4
QALK,0,0,0,1,1,4
ALKV,0,0,0,1,1,4
MEAL,0,0,0,1,1,4
EALK,0,0,0,1,1,4
LKKQ,0,0,0,1,1,4
KKQI,0,0,0,1,1,4
KQIL,0,0,0,1,1,4
QILQ,0,0,0,1,1,4
ILQI,0,0,0,1,1,4
EKLN,0,0,0,1,1,4
NQLW,0,0,0,1,1,4
QLWE,0,0,0,1,1,4
LWEK,0,0,0,1,1,4
WEKA,0,0,0,1,1,4
EKAQ,0,0,0,1,1,4
KAQR,0,0,0,1,1,4
AQRL,0,0,0,2,2,4
QRLH,0,0,0,1,1,4
MLEE,0,0,0,1,1,4
LEEY,0,0,0,1,1,4
EEYR,0,0,0,1,1,4
EYRK,0,0,0,1,1,4
YRKH,0,0,0,1,1,4
ERAA,0,0,0,1,1,4
MPEV,0,0,0,1,1,4
PEVF,0,0,0,1,1,4
EVFN,0,0,0,1,1,4
VFNY,0,0,0,1,1,4
FNYL,0,0,0,1,1,4
NYLG,0,0,0,1,1,4
YLGI,0,0,0,1,1,4
LGIY,0,0,0,1,1,4
GIYL,0,0,0,1,1,4
IYLT,0,0,0,1,1,4
YLTQ,0,0,0,1,1,4
LTQA,0,0,0,1,1,4
MPGT,0,0,0,1,1,4
PGTA,0,0,0,1,1,4
GTAT,0,0,0,1,1,4
TATH,0,0,0,1,1,4
ATHT,0,0,0,1,1,4
THTV,0,0,0,1,1,4
HTVK,0,0,0,1,1,4
TVKM,0,0,0,1,1,4
VKMF,0,0,0,1,1,4
KMFS,0,0,0,1,1,4
MPYT,0,0,0,1,1,4
PYTD,0,0,0,1,1,4
YTDA,0,0,0,1,1,4
TDAV,0,0,0,1,1,4
AVVH,0,0,0,1,1,4
VVHE,0,0,0,1,1,4
VHEV,0,0,0,1,1,4
HEVQ,0,0,0,1,1,4
EVQR,0,0,0,1,1,4
VQRY,0,0,0,1,1,4
QRYI,0,0,0,1,1,4
RYID,0,0,0,1,1,4
MTDQ,0,0,0,1,1,4
TDQQ,0,0,0,2,2,4
DQQA,0,0,0,1,1,4
QQAE,0,0,0,2,2,4
EARA,0,0,0,1,1,4
ARAF,0,0,0,1,1,4
MVFK,0,0,0,1,1,4
VFKQ,0,0,0,1,1,4
FKQM,0,0,0,1,1,4
KQME,0,0,0,3,3,4
QMEQ,0,0,0,1,1,4
MEQV,0,0,0,1,1,4
EQVA,0,0,0,1,1,4
QVAQ,0,0,0,1,1,4
VAQF,0,0,0,1,1,4
AQFL,0,0,0,1,1,4
QFLK,0,0,0,1,1,4
KAAE,0,0,0,1,1,4
AAED,0,0,0,1,1,4
AEDY,0,0,0,1,1,4
MYSN,0,0,0,1,1,4
YSNR,0,0,0,1,1,4
SNRM,0,0,0,1,1,4
NRMR,0,0,0,1,1,4
RMRS,0,0,0,1,1,4
MRSY,0,0,0,1,1,4
RSYK,0,0,0,1,1,4
SYKQ,0,0,0,1,1,4
YKQE,0,0,0,1,1,4
KQEM,0,0,0,1,1,4
QEMG,0,0,0,1,1,4
EMGK,0,0,0,1,1,4
MGKL,0,0,0,1,1,4
GKLE,0,0,0,2,2,4
KLET,0,0,0,1,1,4
LETD,0,0,0,1,1,4
ETDF,0,0,0,1,1,4
TDFK,0,0,0,1,1,4
DFKR,0,0,0,1,1,4
FKRS,0,0,0,1,1,4
RSRI,0,0,0,1,1,4
NAAG,0,0,0,1,1,4
AAGW,0,0,0,1,1,4
AGWD,0,0,0,1,1,4
GWDL,0,0,0,1,1,4
WDLL,0,0,0,1,1,4
DLLL,0,0,0,1,1,4
LLLT,0,0,0,1,1,4
LLTL,0,0,0,1,1,4
LTLY,0,0,0,1,1,4
TLYR,0,0,0,2,2,4
LYRS,0,0,0,1,1,4
NAAQ,0,0,0,1,1,4
AAQL,0,0,0,2,2,4
AQLD,0,0,0,1,1,4
QLDA,0,0,0,1,1,4
ALAH,0,0,0,1,1,4
LAHA,0,0,0,1,1,4
AHAL,0,0,0,2,2,4
HALL,0,0,0,1,1,4
ALLE,0,0,0,1,1,4
LLEI,0,0,0,1,1,4
LEIP,0,0,0,1,1,4
EIPR,0,0,0,1,1,4
IPRF,0,0,0,1,1,4
PRFS,0,0,0,1,1,4
RFSY,0,0,0,1,1,4
FSYA,0,0,0,1,1,4
SYAT,0,0,0,1,1,4
YATR,0,0,0,1,1,4
NAGQ,0,0,0,1,1,4
AGQA,0,0,0,1,1,4
GQAN,0,0,0,1,1,4
QANE,0,0,0,1,1,4
EFFN,0,0,0,1,1,4
FFNE,0,0,0,1,1,4
FNEF,0,0,0,1,1,4
NEFW,0,0,0,1,1,4
EFWS,0,0,0,1,1,4
NAKI,0,0,0,1,1,4
KIAR,0,0,0,1,1,4
IARI,0,0,0,1,1,4
ARIN,0,0,0,1,1,4
RINE,0,0,0,1,1,4
INEL,0,0,0,3,3,4
NELA,0,0,0,1,1,4
ELAA,0,0,0,2,2,4
AKAG,0,0,0,1,1,4
KAGV,0,0,0,1,1,4
NAKY,0,0,0,1,1,4
AKYV,0,0,0,1,1,4
KYVA,0,0,0,1,1,4
YVAE,0,0,0,2,2,4
VAEA,0,0,0,1,1,4
EATG,0,0,0,1,1,4
ATGN,0,0,0,1,1,4
TGNF,0,0,0,2,2,4
GNFI,0,0,0,1,1,4
NFIT,0,0,0,1,1,4
FITV,0,0,0,1,1,4
ITVM,0,0,0,1,1,4
TVMD,0,0,0,1,1,4
VMDA,0,0,0,1,1,4
MDAL,0,0,0,2,2,4
DALK,0,0,0,3,3,4
NASR,0,0,0,1,1,4
ASRT,0,0,0,1,1,4
SRTV,0,0,0,1,1,4
RTVG,0,0,0,1,1,4
TVGV,0,0,0,1,1,4
VGVV,0,0,0,1,1,4
GVVA,0,0,0,1,1,4
AALL,0,0,0,1,1,4
NDAE,0,0,0,1,1,4
DAEV,0,0,0,1,1,4
AEVK,0,0,0,2,2,4
KIAA,0,0,0,1,1,4
IAAQ,0,0,0,1,1,4
AAQY,0,0,0,1,1,4
AQYG,0,0,0,1,1,4
QYGK,0,0,0,1,1,4
YGKD,0,0,0,1,1,4
NDEE,0,0,0,1,1,4
EETV,0,0,0,1,1,4
ETVA,0,0,0,1,1,4
TVAL,0,0,0,1,1,4
VALT,0,0,0,1,1,4
ALTA,0,0,0,1,1,4
LTAG,0,0,0,1,1,4
TAGG,0,0,0,1,1,4
AGGH,0,0,0,1,1,4
GGHT,0,0,0,1,1,4
NEEV,0,0,0,1,1,4
EEVR,0,0,0,1,1,4
EVRI,0,0,0,1,1,4
VRIE,0,0,0,1,1,4
RIEA,0,0,0,2,2,4
EAII,0,0,0,1,1,4
AIIG,0,0,0,1,1,4
IIGL,0,0,0,1,1,4
IGLS,0,0,0,1,1,4
GLSY,0,0,0,1,1,4
LSYR,0,0,0,1,1,4
NEQD,0,0,0,1,1,4
EQDL,0,0,0,2,2,4
QDLG,0,0,0,1,1,4
DLGI,0,0,0,1,1,4
LGIQ,0,0,0,1,1,4
GIQY,0,0,0,1,1,4
IQYK,0,0,0,1,1,4
QYKA,0,0,0,1,1,4
YKAL,0,0,0,1,1,4
ALKP,0,0,0,1,1,4
LKPE,0,0,0,1,1,4
KPEV,0,0,0,1,1,4
PEVD,0,0,0,1,1,4
EVDK,0,0,0,1,1,4
DKLN,0,0,0,1,1,4
KLNI,0,0,0,2,2,4
LNIM,0,0,0,1,1,4
NIMA,0,0,0,2,2,4
IMAA,0,0,0,1,1,4
MAAK,0,0,0,1,1,4
AAKR,0,0,0,2,2,4
AKRQ,0,0,0,1,1,4
RQQE,0,0,0,1,1,4
QQEL,0,0,0,1,1,4
NEYI,0,0,0,1,1,4
EYIM,0,0,0,1,1,4
YIMS,0,0,0,1,1,4
IMSL,0,0,0,1,1,4
MSLI,0,0,0,1,1,4
SLIS,0,0,0,1,1,4
LISD,0,0,0,1,1,4
ISDN,0,0,0,1,1,4
NFKD,0,0,0,1,1,4
FKDV,0,0,0,1,1,4
KDVI,0,0,0,1,1,4
DVIE,0,0,0,1,1,4
VIET,0,0,0,1,1,4
IETA,0,0,0,1,1,4
ETAK,0,0,0,1,1,4
TAKK,0,0,0,1,1,4
KKVM,0,0,0,1,1,4
KVMN,0,0,0,1,1,4
VMNF,0,0,0,1,1,4
NGET,0,0,0,1,1,4
GETF,0,0,0,1,1,4
ETFL,0,0,0,1,1,4
TFLT,0,0,0,2,2,4
FLTE,0,0,0,1,1,4
LTEL,0,0,0,1,1,4
TELL,0,0,0,1,1,4
ELLD,0,0,0,2,2,4
GLEV,0,0,0,1,1,4
LEVV,0,0,0,1,1,4
EVVK,0,0,0,2,2,4
VVKA,0,0,0,1,1,4
VKAL,0,0,0,1,1,4
LAQG,0,0,0,1,1,4
NIDE,0,0,0,1,1,4
IDEI,0,0,0,1,1,4
EIER,0,0,0,1,1,4
IERK,0,0,0,1,1,4
ERKI,0,0,0,1,1,4
RKID,0,0,0,1,1,4
KIDE,0,0,0,1,1,4
IDEA,0,0,0,1,1,4
DEAI,0,0,0,1,1,4
NIDS,0,0,0,1,1,4
IDSY,0,0,0,1,1,4
DSYL,0,0,0,1,1,4
SYLN,0,0,0,1,1,4
YLNA,0,0,0,1,1,4
LNAV,0,0,0,1,1,4
NAVN,0,0,0,1,1,4
AVNI,0,0,0,1,1,4
VNII,0,0,0,2,2,4
NIIN,0,0,0,1,1,4
IINI,0,0,0,1,1,4
INIF,0,0,0,1,1,4
NIFK,0,0,0,2,2,4
IFKI,0,0,0,1,1,4
NIEQ,0,0,0,1,1,4
IEQL,0,0,0,2,2,4
EQLW,0,0,0,1,1,4
QLWR,0,0,0,1,1,4
LWRD,0,0,0,1,1,4
WRDY,0,0,0,1,1,4
RDYN,0,0,0,1,1,4
DYNK,0,0,0,1,1,4
YNKY,0,0,0,1,1,4
NKYE,0,0,0,1,1,4
KYEE,0,0,0,1,1,4
YEEG,0,0,0,1,1,4
EEGI,0,0,0,2,2,4
EGIN,0,0,0,1,1,4
NILK,0,0,0,1,1,4
LKQI,0,0,0,2,2,4
KQIF,0,0,0,1,1,4
QIFK,0,0,0,1,1,4
IFKL,0,0,0,1,1,4
FKLL,0,0,0,1,1,4
LLQA,0,0,0,2,2,4
NINE,0,0,0,1,1,4
NELF,0,0,0,1,1,4
ELFI,0,0,0,1,1,4
LFIE,0,0,0,1,1,4
FIEI,0,0,0,1,1,4
IEIS,0,0,0,1,1,4
EISR,0,0,0,1,1,4
ISRR,0,0,0,1,1,4
SRRI,0,0,0,1,1,4
NIPK,0,0,0,1,1,4
IPKH,0,0,0,1,1,4
PKHT,0,0,0,1,1,4
KHTH,0,0,0,1,1,4
HTHR,0,0,0,1,1,4
THRF,0,0,0,1,1,4
HRFF,0,0,0,1,1,4
RFFI,0,0,0,1,1,4
FFIL,0,0,0,1,1,4
FILV,0,0,0,1,1,4
ILVL,0,0,0,1,1,4
LVLE,0,0,0,1,1,4
VLEI,0,0,0,1,1,4
NKDQ,0,0,0,1,1,4
KDQW,0,0,0,1,1,4
DQWE,0,0,0,1,1,4
QWEE,0,0,0,1,1,4
WEER,0,0,0,1,1,4
EERI,0,0,0,2,2,4
ERIQ,0,0,0,1,1,4
RIQV,0,0,0,1,1,4
IQVW,0,0,0,1,1,4
QVWH,0,0,0,1,1,4
VWHE,0,0,0,1,1,4
WHEE,0,0,0,1,1,4
HEEH,0,0,0,1,1,4
NKEE,0,0,0,1,1,4
EEMM,0,0,0,1,1,4
EMMD,0,0,0,1,1,4
MMDI,0,0,0,1,1,4
MDIV,0,0,0,1,1,4
VKAI,0,0,0,1,1,4
KAIY,0,0,0,1,1,4
AIYD,0,0,0,1,1,4
IYDM,0,0,0,1,1,4
YDMM,0,0,0,1,1,4
DMMG,0,0,0,1,1,4
NKLV,0,0,0,1,1,4
KLVD,0,0,0,1,1,4
LVDR,0,0,0,2,2,4
VDRW,0,0,0,1,1,4
DRWL,0,0,0,1,1,4
RWLH,0,0,0,1,1,4
WLHV,0,0,0,1,1,4
LHVR,0,0,0,1,1,4
HVRK,0,0,0,1,1,4
RKHL,0,0,0,1,1,4
KHLL,0,0,0,1,1,4
HLLV,0,0,0,1,1,4
LLVA,0,0,0,2,2,4
LVAY,0,0,0,1,1,4
AYYN,0,0,0,1,1,4
YYNL,0,0,0,1,1,4
YNLV,0,0,0,1,1,4
NLVG,0,0,0,2,2,4
NKQA,0,0,0,1,1,4
KQAD,0,0,0,1,1,4
QADS,0,0,0,1,1,4
ADSI,0,0,0,1,1,4
DSIK,0,0,0,1,1,4
SIKQ,0,0,0,2,2,4
IKQM,0,0,0,1,1,4
QMEE,0,0,0,1,1,4
MEER,0,0,0,1,1,4
EERN,0,0,0,1,1,4
ERNK,0,0,0,1,1,4
RNKK,0,0,0,1,1,4
NKKR,0,0,0,1,1,4
KKRV,0,0,0,2,2,4
RVEN,0,0,0,1,1,4
VENF,0,0,0,1,1,4
ENFK,0,0,0,1,1,4
NFKK,0,0,0,1,1,4
FKKT,0,0,0,1,1,4
KKTG,0,0,0,1,1,4
NKRA,0,0,0,1,1,4
RAVD,0,0,0,1,1,4
AVDW,0,0,0,1,1,4
VDWA,0,0,0,1,1,4
DWAM,0,0,0,1,1,4
WAMR,0,0,0,1,1,4
AMRA,0,0,0,1,1,4
MRAA,0,0,0,1,1,4
AAMA,0,0,0,1,1,4
AMAL,0,0,0,1,1,4
NKSV,0,0,0,1,1,4
KSVG,0,0,0,1,1,4
SVGA,0,0,0,1,1,4
VGAV,0,0,0,1,1,4
GAVY,0,0,0,2,2,4
AVYA,0,0,0,1,1,4
VYAI,0,0,0,1,1,4
YAIL,0,0,0,1,1,4
AILY,0,0,0,1,1,4
LYLS,0,0,0,1,1,4
NLDS,0,0,0,1,1,4
DSIQ,0,0,0,1,1,4
SIQE,0,0,0,1,1,4
IQEE,0,0,0,2,2,4
QEEL,0,0,0,2,2,4
EELA,0,0,0,1,1,4
ELAD,0,0,0,1,1,4
LADV,0,0,0,1,1,4
ADVI,0,0,0,1,1,4
VIAW,0,0,0,1,1,4
IAWT,0,0,0,1,1,4
AWTV,0,0,0,1,1,4
WTVS,0,0,0,1,1,4
TVSI,0,0,0,1,1,4
VSIA,0,0,0,2,2,4
SIAN,0,0,0,1,1,4
IANL,0,0,0,1,1,4
ANLE,0,0,0,1,1,4
NLEG,0,0,0,1,1,4
NLEQ,0,0,0,1,1,4
LEQT,0,0,0,1,1,4
EQTA,0,0,0,1,1,4
QTAR,0,0,0,1,1,4
TARR,0,0,0,1,1,4
ARRW,0,0,0,1,1,4
RRWL,0,0,0,1,1,4
RWLE,0,0,0,1,1,4
WLEE,0,0,0,1,1,4
LEER,0,0,0,2,2,4
EERG,0,0,0,2,2,4
NLES,0,0,0,1,1,4
LESE,0,0,0,1,1,4
ESEI,0,0,0,1,1,4
SEIH,0,0,0,1,1,4
EIHT,0,0,0,1,1,4
IHTV,0,0,0,1,1,4
HTVL,0,0,0,1,1,4
TVLK,0,0,0,1,1,4
VLKH,0,0,0,1,1,4
LKHL,0,0,0,2,2,4
KHLV,0,0,0,1,1,4
HLVE,0,0,0,1,1,4
LVEN,0,0,0,2,2,4
VENN,0,0,0,1,1,4
NLFD,0,0,0,1,1,4
LFDH,0,0,0,1,1,4
FDHF,0,0,0,1,1,4
DHFS,0,0,0,1,1,4
HFSA,0,0,0,1,1,4
FSAV,0,0,0,1,1,4
SAVA,0,0,0,1,1,4
AVAQ,0,0,0,1,1,4
VAQR,0,0,0,2,2,4
NLFP,0,0,0,1,1,4
LFPI,0,0,0,1,1,4
FPIV,0,0,0,1,1,4
PIVF,0,0,0,1,1,4
IVFG,0,0,0,1,1,4
VFGV,0,0,0,1,1,4
FGVI,0,0,0,1,1,4
GVIF,0,0,0,1,1,4
VIFD,0,0,0,1,1,4
IFDA,0,0,0,1,1,4
NLLY,0,0,0,1,1,4
LLYD,0,0,0,1,1,4
LYDI,0,0,0,1,1,4
YDIV,0,0,0,1,1,4
IVKE,0,0,0,2,2,4
VKEN,0,0,0,1,1,4
KENG,0,0,0,1,1,4
NLNQ,0,0,0,1,1,4
LNQS,0,0,0,1,1,4
NQSI,0,0,0,1,1,4
QSID,0,0,0,1,1,4
SIDN,0,0,0,1,1,4
IDNF,0,0,0,1,1,4
DNFV,0,0,0,1,1,4
NFVN,0,0,0,1,1,4
FVNM,0,0,0,1,1,4
VNMA,0,0,0,1,1,4
NMAF,0,0,0,1,1,4
MAFF,0,0,0,1,1,4
AFFA,0,0,0,1,1,4
NLST,0,0,0,1,1,4
LSTL,0,0,0,1,1,4
STLA,0,0,0,1,1,4
AALV,0,0,0,2,2,4
ALVA,0,0,0,2,2,4
LVAA,0,0,0,3,3,4
VAAA,0,0,0,2,2,4
AAAG,0,0,0,1,1,4
NLTQ,0,0,0,1,1,4
LTQL,0,0,0,1,1,4
TQLK,0,0,0,1,1,4
QLKA,0,0,0,1,1,4
LKAS,0,0,0,1,1,4
KASF,0,0,0,2,2,4
ASFA,0,0,0,1,1,4
SFAV,0,0,0,2,2,4
FAVQ,0,0,0,1,1,4
LVAD,0,0,0,2,2,4
ADMR,0,0,0,1,1,4
DMRF,0,0,0,1,1,4
MRFN,0,0,0,1,1,4
RFNV,0,0,0,1,1,4
FNVV,0,0,0,1,1,4
NVVR,0,0,0,1,1,4
VVRE,0,0,0,1,1,4
VRES,0,0,0,1,1,4
RESE,0,0,0,1,1,4
ESEA,0,0,0,1,1,4
SEAR,0,0,0,1,1,4
EARL,0,0,0,1,1,4
ARLQ,0,0,0,2,2,4
LQVS,0,0,0,1,1,4
QVSR,0,0,0,1,1,4
VSRL,0,0,0,1,1,4
SRLY,0,0,0,1,1,4
RLYS,0,0,0,1,1,4
NNAI,0,0,0,1,1,4
NAIT,0,0,0,1,1,4
AITK,0,0,0,1,1,4
ITKG,0,0,0,1,1,4
TKGF,0,0,0,1,1,4
KGFT,0,0,0,1,1,4
GFTA,0,0,0,1,1,4
FTAL,0,0,0,1,1,4
KLLV,0,0,0,1,1,4
NPAA,0,0,0,1,1,4
PAAE,0,0,0,1,1,4
AAEK,0,0,0,1,1,4
EKMQ,0,0,0,1,1,4
KMQV,0,0,0,1,1,4
MQVL,0,0,0,2,2,4
QVLQ,0,0,0,1,1,4
LQVL,0,0,0,1,1,4
VLDR,0,0,0,1,1,4
LDRL,0,0,0,1,1,4
DRLR,0,0,0,1,1,4
RLRG,0,0,0,1,1,4
LRGK,0,0,0,1,1,4
RGKL,0,0,0,1,1,4
GKLQ,0,0,0,1,1,4
LQEK,0,0,0,2,2,4
QEKG,0,0,0,1,1,4
NPAQ,0,0,0,1,1,4
PAQY,0,0,0,1,1,4
AQYL,0,0,0,1,1,4
QYLA,0,0,0,1,1,4
YLAQ,0,0,0,1,1,4
LAQH,0,0,0,1,1,4
AQHE,0,0,0,1,1,4
QHEQ,0,0,0,1,1,4
HEQL,0,0,0,1,1,4
EQLL,0,0,0,2,2,4
NPAR,0,0,0,1,1,4
RALY,0,0,0,1,1,4
ALYQ,0,0,0,1,1,4
LYQT,0,0,0,1,1,4
YQTV,0,0,0,1,1,4
QTVR,0,0,0,1,1,4
TVRE,0,0,0,1,1,4
VREL,0,0,0,1,1,4
LIEN,0,0,0,1,1,4
IENS,0,0,0,1,1,4
ENSL,0,0,0,1,1,4
NSLD,0,0,0,1,1,4
NPEI,0,0,0,1,1,4
PEIL,0,0,0,1,1,4
ILLA,0,0,0,1,1,4
LARV,0,0,0,1,1,4
ARVK,0,0,0,1,1,4
RVKR,0,0,0,1,1,4
VKRF,0,0,0,1,1,4
KRFL,0,0,0,1,1,4
RFLE,0,0,0,1,1,4
FLER,0,0,0,2,2,4
LERE,0,0,0,2,2,4
NPER,0,0,0,1,1,4
PERV,0,0,0,1,1,4
ERVL,0,0,0,1,1,4
RVLL,0,0,0,1,1,4
VLLQ,0,0,0,2,2,4
LLQL,0,0,0,4,4,4
LQLK,0,0,0,1,1,4
QLKY,0,0,0,1,1,4
LKYR,0,0,0,1,1,4
KYRY,0,0,0,1,1,4
YRYD,0,0,0,1,1,4
RYDV,0,0,0,1,1,4
YDVE,0,0,0,1,1,4
DVEI,0,0,0,1,1,4
NPGQ,0,0,0,1,1,4
PGQA,0,0,0,1,1,4
GQAI,0,0,0,1,1,4
QAIW,0,0,0,1,1,4
AIWL,0,0,0,1,1,4
IWLG,0,0,0,1,1,4
WLGE,0,0,0,1,1,4
LGEF,0,0,0,1,1,4
GEFS,0,0,0,1,1,4
EFSK,0,0,0,1,1,4
FSKR,0,0,0,1,1,4
SKRH,0,0,0,1,1,4
NPMI,0,0,0,1,1,4
PMII,0,0,0,1,1,4
MIIE,0,0,0,1,1,4
IIEG,0,0,0,1,1,4
IEGQ,0,0,0,1,1,4
EGQI,0,0,0,1,1,4
GQIH,0,0,0,1,1,4
IHGG,0,0,0,1,1,4
HGGL,0,0,0,1,1,4
GGLT,0,0,0,1,1,4
GLTE,0,0,0,2,2,4
LTEG,0,0,0,3,3,4
TEGY,0,0,0,1,1,4
EGYA,0,0,0,1,1,4
GYAV,0,0,0,1,1,4
YAVA,0,0,0,1,1,4
AVAM,0,0,0,1,1,4
VAMG,0,0,0,1,1,4
NPQV,0,0,0,1,1,4
PQVL,0,0,0,1,1,4
QVLA,0,0,0,1,1,4
VLAD,0,0,0,2,2,4
LADI,0,0,0,1,1,4
ADIG,0,0,0,1,1,4
DIGA,0,0,0,1,1,4
IGAE,0,0,0,1,1,4
GAEA,0,0,0,1,1,4
NPRW,0,0,0,1,1,4
PRWI,0,0,0,1,1,4
RWIG,0,0,0,1,1,4
WIGR,0,0,0,1,1,4
IGRH,0,0,0,1,1,4
GRHK,0,0,0,1,1,4
RHKH,0,0,0,1,1,4
HKHM,0,0,0,1,1,4
KHMF,0,0,0,1,1,4
HMFN,0,0,0,1,1,4
MFNF,0,0,0,1,1,4
FNFL,0,0,0,1,1,4
NFLD,0,0,0,1,1,4
NPVL,0,0,0,1,1,4
PVLQ,0,0,0,1,1,4
LQQH,0,0,0,1,1,4
QQHF,0,0,0,1,1,4
QHFR,0,0,0,1,1,4
HFRN,0,0,0,1,1,4
FRNL,0,0,0,1,1,4
RNLE,0,0,0,1,1,4
NLEA,0,0,0,1,1,4
NQDE,0,0,0,1,1,4
QDEL,0,0,0,2,2,4
DELE,0,0,0,1,1,4
ELEG,0,0,0,1,1,4
LEGY,0,0,0,1,1,4
EGYN,0,0,0,1,1,4
GYNL,0,0,0,1,1,4
YNLF,0,0,0,1,1,4
NLFK,0,0,0,1,1,4
LFKG,0,0,0,1,1,4
FKGS,0,0,0,1,1,4
KGSG,0,0,0,1,1,4
NQPF,0,0,0,1,1,4
QPFA,0,0,0,1,1,4
PFAL,0,0,0,1,1,4
FALE,0,0,0,1,1,4
ALEM,0,0,0,1,1,4
LEMI,0,0,0,1,1,4
EMIK,0,0,0,1,1,4
IKSR,0,0,0,1,1,4
KSRQ,0,0,0,2,2,4
SRQK,0,0,0,1,1,4
RQKK,0,0,0,1,1,4
QKKD,0,0,0,2,2,4
NQRA,0,0,0,1,1,4
RALL,0,0,0,1,1,4
LKSL,0,0,0,2,2,4
KSLQ,0,0,0,2,2,4
SLQD,0,0,0,2,2,4
LQDY,0,0,0,1,1,4
QDYR,0,0,0,1,1,4
DYRQ,0,0,0,1,1,4
YRQH,0,0,0,1,1,4
RQHL,0,0,0,1,1,4
QHLD,0,0,0,1,1,4
HLDQ,0,0,0,1,1,4
DQLI,0,0,0,1,1,4
QLIT,0,0,0,1,1,4
ITLI,0,0,0,1,1,4
LISN,0,0,0,1,1,4
NREA,0,0,0,1,1,4
REAN,0,0,0,1,1,4
EANL,0,0,0,1,1,4
ANLQ,0,0,0,1,1,4
NLQA,0,0,0,1,1,4
LQAL,0,0,0,1,1,4
QALI,0,0,0,1,1,4
LIAT,0,0,0,1,1,4
IATG,0,0,0,1,1,4
NRKM,0,0,0,1,1,4
RKMA,0,0,0,1,1,4
KMAM,0,0,0,1,1,4
MAMG,0,0,0,1,1,4
AMGR,0,0,0,1,1,4
MGRK,0,0,0,1,1,4
GRKK,0,0,0,1,1,4
RKKF,0,0,0,1,1,4
KKFN,0,0,0,1,1,4
KFNM,0,0,0,1,1,4
FNMD,0,0,0,1,1,4
NSDQ,0,0,0,1,1,4
SDQD,0,0,0,1,1,4
DQDA,0,0,0,1,1,4
QDAG,0,0,0,1,1,4
DAGI,0,0,0,1,1,4
AGIA,0,0,0,1,1,4
GIAI,0,0,0,1,1,4
IAII,0,0,0,1,1,4
AIIR,0,0,0,1,1,4
IIRR,0,0,0,1,1,4
IRRA,0,0,0,1,1,4
RRAL,0,0,0,2,2,4
NSNH,0,0,0,1,1,4
SNHQ,0,0,0,1,1,4
NHQM,0,0,0,1,1,4
HQML,0,0,0,1,1,4
QMLL,0,0,0,1,1,4
MLLV,0,0,0,1,1,4
LLVQ,0,0,0,3,3,4
LVQQ,0,0,0,1,1,4
VQQA,0,0,0,1,1,4
QAED,0,0,0,1,1,4
AEDK,0,0,0,1,1,4
EDKI,0,0,0,1,1,4
KIKE,0,0,0,2,2,4
IKEL,0,0,0,3,3,4
KELL,0,0,0,1,1,4
ELLN,0,0,0,1,1,4
LLNT,0,0,0,1,1,4
NSNT,0,0,0,1,1,4
SNTF,0,0,0,1,1,4
NTFL,0,0,0,1,1,4
FLTR,0,0,0,1,1,4
LTRL,0,0,0,2,2,4
TRLL,0,0,0,1,1,4
RLLV,0,0,0,1,1,4
LLVH,0,0,0,1,1,4
LVHM,0,0,0,1,1,4
SRER,0,0,0,1,1,4
RERE,0,0,0,1,1,4
EREM,0,0,0,2,2,4
REMF,0,0,0,1,1,4
EMFV,0,0,0,1,1,4
MFVQ,0,0,0,1,1,4
FVQE,0,0,0,1,1,4
VQEV,0,0,0,2,2,4
QEVR,0,0,0,1,1,4
EVRR,0,0,0,2,2,4
VRRY,0,0,0,1,1,4
RRYY,0,0,0,1,1,4
NSSD,0,0,0,1,1,4
SSDS,0,0,0,1,1,4
SDSI,0,0,0,1,1,4
DSID,0,0,0,1,1,4
SIDW,0,0,0,1,1,4
IDWL,0,0,0,1,1,4
DWLT,0,0,0,1,1,4
WLTS,0,0,0,1,1,4
LTSM,0,0,0,1,1,4
NSVL,0,0,0,1,1,4
SVLR,0,0,0,1,1,4
VLRA,0,0,0,1,1,4
LRAV,0,0,0,2,2,4
AVAE,0,0,0,2,2,4
VAEV,0,0,0,1,1,4
AEVY,0,0,0,2,2,4
NTDT,0,0,0,1,1,4
TDTL,0,0,0,1,1,4
DTLE,0,0,0,2,2,4
TLER,0,0,0,1,1,4
LERV,0,0,0,1,1,4
ERVT,0,0,0,1,1,4
RVTE,0,0,0,1,1,4
VTEI,0,0,0,1,1,4
TEIF,0,0,0,1,1,4
IFKA,0,0,0,1,1,4
NTEK,0,0,0,1,1,4
TEKL,0,0,0,1,1,4
LLKT,0,0,0,1,1,4
LKTV,0,0,0,1,1,4
KTVP,0,0,0,1,1,4
TVPI,0,0,0,1,1,4
VPII,0,0,0,1,1,4
PIIQ,0,0,0,1,1,4
IIQN,0,0,0,1,1,4
IQNQ,0,0,0,1,1,4
QNQM,0,0,0,1,1,4
NQMD,0,0,0,1,1,4
QMDA,0,0,0,1,1,4
DALL,0,0,0,1,1,4
ALLD,0,0,0,1,1,4
NTPE,0,0,0,1,1,4
TPEA,0,0,0,1,1,4
PEAY,0,0,0,1,1,4
EAYS,0,0,0,1,1,4
AYSV,0,0,0,1,1,4
YSVL,0,0,0,1,1,4
SVLF,0,0,0,2,2,4
VLFD,0,0,0,1,1,4
LFDM,0,0,0,1,1,4
FDMA,0,0,0,1,1,4
DMAR,0,0,0,1,1,4
MARE,0,0,0,1,1,4
AREV,0,0,0,1,1,4
REVN,0,0,0,1,1,4
VNRL,0,0,0,2,2,4
NRLK,0,0,0,1,1,4
RLKA,0,0,0,1,1,4
LKAE,0,0,0,1,1,4
KAED,0,0,0,1,1,4
VGKA,0,0,0,1,1,4
GKAW,0,0,0,1,1,4
KAWA,0,0,0,1,1,4
AWAE,0,0,0,2,2,4
WAED,0,0,0,1,1,4
AEDV,0,0,0,2,2,4
EDVL,0,0,0,1,1,4
LALV,0,0,0,1,1,4
ALVK,0,0,0,1,1,4
LVKH,0,0,0,1,1,4
NVKD,0,0,0,2,2,4
VKDL,0,0,0,1,1,4
KDLA,0,0,0,2,2,4
DLAD,0,0,0,1,1,4
ADAA,0,0,0,1,1,4
DAAK,0,0,0,1,1,4
AKRT,0,0,0,1,1,4
VKDV,0,0,0,1,1,4
KDVT,0,0,0,1,1,4
DVTK,0,0,0,1,1,4
VTKL,0,0,0,1,1,4
TKLV,0,0,0,1,1,4
NWDD,0,0,0,1,1,4
WDDM,0,0,0,1,1,4
DDME,0,0,0,1,1,4
DMEK,0,0,0,1,1,4
MEKI,0,0,0,1,1,4
EKIW,0,0,0,1,1,4
KIWH,0,0,0,1,1,4
IWHH,0,0,0,1,1,4
WHHT,0,0,0,1,1,4
HHTF,0,0,0,1,1,4
HTFY,0,0,0,1,1,4
TFYN,0,0,0,1,1,4
NYAH,0,0,0,1,1,4
YAHL,0,0,0,1,1,4
AHLN,0,0,0,1,1,4
HLNR,0,0,0,1,1,4
LNRG,0,0,0,1,1,4
NRGI,0,0,0,1,1,4
RGIA,0,0,0,1,1,4
GIAL,0,0,0,1,1,4
IALY,0,0,0,1,1,4
ALYY,0,0,0,1,1,4
LYYG,0,0,0,1,1,4
NYEE,0,0,0,1,1,4
YEEI,0,0,0,1,1,4
EEIY,0,0,0,2,2,4
EIYI,0,0,0,1,1,4
IYIL,0,0,0,1,1,4
YILN,0,0,0,1,1,4
ILNH,0,0,0,1,1,4
LNHI,0,0,0,1,1,4
NHIL,0,0,0,1,1,4
HILR,0,0,0,1,1,4
NYEK,0,0,0,1,1,4
YEKF,0,0,0,1,1,4
EKFS,0,0,0,1,1,4
KFSE,0,0,0,1,1,4
SETK,0,0,0,1,1,4
ETKE,0,0,0,1,1,4
TKER,0,0,0,2,2,4
KERL,0,0,0,2,2,4
RLLE,0,0,0,2,2,4
LLEK,0,0,0,2,2,4
PAER,0,0,0,1,1,4
AERY,0,0,0,1,1,4
ERYY,0,0,0,1,1,4
RYYR,0,0,0,1,1,4
YYRD,0,0,0,1,1,4
YRDA,0,0,0,1,1,4
RDAR,0,0,0,1,1,4
DARI,0,0,0,1,1,4
ARIT,0,0,0,1,1,4
PALD,0,0,0,1,1,4
ALDI,0,0,0,1,1,4
LDIL,0,0,0,1,1,4
DILK,0,0,0,1,1,4
ILKA,0,0,0,2,2,4
KALV,0,0,0,1,1,4
ALVD,0,0,0,2,2,4
LVDN,0,0,0,1,1,4
VDNL,0,0,0,1,1,4
DNLY,0,0,0,2,2,4
NLYV,0,0,0,1,1,4
LYVE,0,0,0,1,1,4
YVEN,0,0,0,1,1,4
PATS,0,0,0,1,1,4
ATSR,0,0,0,1,1,4
TSRK,0,0,0,1,1,4
SRKI,0,0,0,2,2,4
RKIF,0,0,0,2,2,4
KIFK,0,0,0,1,1,4
IFKY,0,0,0,1,1,4
FKYI,0,0,0,1,1,4
KYIR,0,0,0,1,1,4
YIRE,0,0,0,1,1,4
IREL,0,0,0,3,3,4
RELD,0,0,0,1,1,4
PDEV,0,0,0,1,1,4
DEVS,0,0,0,1,1,4
EVSA,0,0,0,1,1,4
VSAL,0,0,0,1,1,4
ALRR,0,0,0,2,2,4
LRRT,0,0,0,1,1,4
RRTT,0,0,0,1,1,4
RTTE,0,0,0,1,1,4
TTEK,0,0,0,1,1,4
TEKN,0,0,0,1,1,4
EKNT,0,0,0,1,1,4
KNTT,0,0,0,1,1,4
NTTT,0,0,0,1,1,4
TTTL,0,0,0,1,1,4
TTLI,0,0,0,1,1,4
TLIN,0,0,0,1,1,4
LINL,0,0,0,1,1,4
INLA,0,0,0,2,2,4
NLAK,0,0,0,1,1,4
AKQH,0,0,0,1,1,4
PDFR,0,0,0,1,1,4
DFRK,0,0,0,1,1,4
AFKR,0,0,0,2,2,4
KRLL,0,0,0,1,1,4
PDIK,0,0,0,1,1,4
DIKA,0,0,0,1,1,4
IKAQ,0,0,0,1,1,4
KAQY,0,0,0,1,1,4
AQYQ,0,0,0,1,1,4
QYQQ,0,0,0,1,1,4
YQQR,0,0,0,1,1,4
QQRW,0,0,0,1,1,4
QRWL,0,0,0,1,1,4
PDYR,0,0,0,1,1,4
DYRE,0,0,0,1,1,4
YREV,0,0,0,1,1,4
REVM,0,0,0,1,1,4
EVME,0,0,0,1,1,4
VMET,0,0,0,1,1,4
METF,0,0,0,1,1,4
ETFQ,0,0,0,1,1,4
TFQE,0,0,0,1,1,4
PEAL,0,0,0,1,1,4
ALTV,0,0,0,1,1,4
TVAA,0,0,0,1,1,4
AATE,0,0,0,1,1,4
ATEV,0,0,0,1,1,4
TEVR,0,0,0,1,1,4
VRRI,0,0,0,1,1,4
RIRD,0,0,0,1,1,4
IRDR,0,0,0,1,1,4
RDRA,0,0,0,1,1,4
DRAI,0,0,0,1,1,4
AIQS,0,0,0,1,1,4
IQSD,0,0,0,1,1,4
QSDA,0,0,0,1,1,4
SDAQ,0,0,0,1,1,4
DAQV,0,0,0,1,1,4
QVAP,0,0,0,1,1,4
VAPM,0,0,0,1,1,4
APMT,0,0,0,1,1,4
PMTT,0,0,0,1,1,4
PEDF,0,0,0,1,1,4
EDFA,0,0,0,1,1,4
DFAN,0,0,0,2,2,4
FANH,0,0,0,1,1,4
ANHL,0,0,0,1,1,4
NHLF,0,0,0,1,1,4
HLFT,0,0,0,1,1,4
LFTV,0,0,0,1,1,4
FTVF,0,0,0,1,1,4
TVFD,0,0,0,1,1,4
PEKE,0,0,0,1,1,4
EKEA,0,0,0,2,2,4
EAVT,0,0,0,1,1,4
AVTL,0,0,0,1,1,4
VTLG,0,0,0,1,1,4
TLGI,0,0,0,1,1,4
LGIK,0,0,0,1,1,4
GIKA,0,0,0,1,1,4
IKAL,0,0,0,1,1,4
ALKS,0,0,0,2,2,4
LKSS,0,0,0,1,1,4
PEVQ,0,0,0,2,2,4
EVQI,0,0,0,1,1,4
VQIA,0,0,0,1,1,4
QIAI,0,0,0,1,1,4
IAIL,0,0,0,1,1,4
ILTE,0,0,0,1,1,4
LTEQ,0,0,0,1,1,4
TEQI,0,0,0,1,1,4
EQIN,0,0,0,1,1,4
QINN,0,0,0,1,1,4
INNL,0,0,0,1,1,4
NLNE,0,0,0,1,1,4
LNEH,0,0,0,1,1,4
NEHL,0,0,0,1,1,4
HLRV,0,0,0,1,1,4
PEYE,0,0,0,1,1,4
EYEH,0,0,0,1,1,4
YEHL,0,0,0,1,1,4
EHLY,0,0,0,1,1,4
HLYT,0,0,0,1,1,4
LYTE,0,0,0,1,1,4
YTEL,0,0,0,1,1,4
TELT,0,0,0,1,1,4
ELTG,0,0,0,1,1,4
LTGT,0,0,0,1,1,4
TGTI,0,0,0,1,1,4
GTIV,0,0,0,1,1,4
TIVL,0,0,0,1,1,4
IVLL,0,0,0,1,1,4
VLLI,0,0,0,1,1,4
LLIE,0,0,0,2,2,4
LIES,0,0,0,1,1,4
PGLR,0,0,0,1,1,4
GLRR,0,0,0,1,1,4
LRRA,0,0,0,2,2,4
RRAW,0,0,0,1,1,4
RAWK,0,0,0,1,1,4
AWKR,0,0,0,1,1,4
WKRL,0,0,0,1,1,4
PGRI,0,0,0,1,1,4
GRIQ,0,0,0,1,1,4
RIQR,0,0,0,1,1,4
IQRV,0,0,0,1,1,4
QRVA,0,0,0,1,1,4
RVAR,0,0,0,1,1,4
ARGS,0,0,0,1,1,4
PIAF,0,0,0,1,1,4
IAFI,0,0,0,1,1,4
AFIH,0,0,0,1,1,4
FIHK,0,0,0,1,1,4
IHKA,0,0,0,1,1,4
HKAI,0,0,0,1,1,4
PIDI,0,0,0,1,1,4
IDID,0,0,0,1,1,4
DIDY,0,0,0,1,1,4
IDYM,0,0,0,1,1,4
DYMI,0,0,0,1,1,4
YMIS,0,0,0,1,1,4
MISD,0,0,0,1,1,4
ISDT,0,0,0,1,1,4
SDTL,0,0,0,1,1,4
TLEL,0,0,0,1,1,4
LELL,0,0,0,2,2,4
ELLR,0,0,0,2,2,4
PIEA,0,0,0,1,1,4
IEAF,0,0,0,1,1,4
EAFL,0,0,0,1,1,4
FLRL,0,0,0,1,1,4
LRLN,0,0,0,1,1,4
RLNE,0,0,0,1,1,4
LNEE,0,0,0,1,1,4
NEEL,0,0,0,1,1,4
PIKF,0,0,0,1,1,4
IKFI,0,0,0,1,1,4
KFIR,0,0,0,1,1,4
FIRK,0,0,0,1,1,4
IRKA,0,0,0,1,1,4
PKAY,0,0,0,1,1,4
AYAQ,0,0,0,1,1,4
YAQH,0,0,0,1,1,4
AQHV,0,0,0,1,1,4
QHVF,0,0,0,1,1,4
HVFR,0,0,0,1,1,4
VFRS,0,0,0,1,1,4
PKPL,0,0,0,1,1,4
KPLV,0,0,0,1,1,4
PLVS,0,0,0,1,1,4
LVSF,0,0,0,2,2,4
VSFF,0,0,0,1,1,4
SFFQ,0,0,0,1,1,4
FFQS,0,0,0,1,1,4
FQSL,0,0,0,1,1,4
QSLL,0,0,0,1,1,4
SLLQ,0,0,0,3,3,4
LQLV,0,0,0,2,2,4
QLVN,0,0,0,1,1,4
LVNH,0,0,0,1,1,4
VNHD,0,0,0,1,1,4
NHDL,0,0,0,1,1,4
HDLL,0,0,0,1,1,4
DLLE,0,0,0,1,1,4
LLEQ,0,0,0,1,1,4
LEQQ,0,0,0,2,2,4
EQQN,0,0,0,1,1,4
PLEE,0,0,0,1,1,4
EELF,0,0,0,1,1,4
ELFL,0,0,0,1,1,4
LFLE,0,0,0,2,2,4
FLEQ,0,0,0,1,1,4
LEQL,0,0,0,1,1,4
QLEA,0,0,0,1,1,4
PLGR,0,0,0,1,1,4
LGRL,0,0,0,1,1,4
GRLI,0,0,0,1,1,4
RLIH,0,0,0,1,1,4
LIHM,0,0,0,1,1,4
IHMV,0,0,0,1,1,4
HMVN,0,0,0,1,1,4
MVNQ,0,0,0,1,1,4
VNQK,0,0,0,1,1,4
NQKK,0,0,0,1,1,4
KKDR,0,0,0,1,1,4
KDRL,0,0,0,1,1,4
DRLL,0,0,0,1,1,4
RLLN,0,0,0,1,1,4
LLNE,0,0,0,1,1,4
LNEY,0,0,0,1,1,4
NEYL,0,0,0,1,1,4
EYLS,0,0,0,1,1,4
PLTK,0,0,0,1,1,4
TKGI,0,0,0,1,1,4
KGIL,0,0,0,1,1,4
GILG,0,0,0,1,1,4
ILGF,0,0,0,1,1,4
LGFV,0,0,0,1,1,4
GFVF,0,0,0,1,1,4
FVFT,0,0,0,1,1,4
FTLT,0,0,0,1,1,4
PNDM,0,0,0,1,1,4
NDMS,0,0,0,1,1,4
DMSR,0,0,0,1,1,4
MSRI,0,0,0,1,1,4
SRIF,0,0,0,1,1,4
RIFN,0,0,0,1,1,4
IFNI,0,0,0,1,1,4
FNIV,0,0,0,1,1,4
NIVK,0,0,0,2,2,4
VKES,0,0,0,1,1,4
KESL,0,0,0,1,1,4
PNGP,0,0,0,1,1,4
NGPT,0,0,0,1,1,4
GPTH,0,0,0,1,1,4
PTHA,0,0,0,1,1,4
THAP,0,0,0,1,1,4
HAPW,0,0,0,1,1,4
APWL,0,0,0,1,1,4
PWLL,0,0,0,1,1,4
WLLA,0,0,0,1,1,4
LAHK,0,0,0,1,1,4
AHKI,0,0,0,1,1,4
HKIQ,0,0,0,1,1,4
PQHE,0,0,0,1,1,4
QHER,0,0,0,1,1,4
HERD,0,0,0,1,1,4
ERDV,0,0,0,1,1,4
RDVI,0,0,0,1,1,4
DVIY,0,0,0,1,1,4
VIYE,0,0,0,1,1,4
IYEE,0,0,0,1,1,4
YEEE,0,0,0,1,1,4
EEES,0,0,0,1,1,4
PQSY,0,0,0,1,1,4
QSYA,0,0,0,1,1,4
SYAM,0,0,0,1,1,4
YAMA,0,0,0,1,1,4
AMAI,0,0,0,1,1,4
MAIA,0,0,0,1,1,4
IARQ,0,0,0,1,1,4
ARQE,0,0,0,1,1,4
RQES,0,0,0,1,1,4
QESA,0,0,0,1,1,4
PQYA,0,0,0,1,1,4
QYAL,0,0,0,2,2,4
YALE,0,0,0,1,1,4
ALEL,0,0,0,1,1,4
LLTV,0,0,0,1,1,4
LTVY,0,0,0,1,1,4
TVYA,0,0,0,1,1,4
VYAW,0,0,0,1,1,4
YAWE,0,0,0,1,1,4
AWEQ,0,0,0,1,1,4
WEQG,0,0,0,1,1,4
EQGS,0,0,0,1,1,4
PQYS,0,0,0,1,1,4
QYSQ,0,0,0,1,1,4
YSQA,0,0,0,1,1,4
SQAR,0,0,0,1,1,4
ARVM,0,0,0,1,1,4
RVML,0,0,0,1,1,4
VMLV,0,0,0,1,1,4
MLVK,0,0,0,1,1,4
LVKT,0,0,0,1,1,4
KTIS,0,0,0,1,1,4
TISM,0,0,0,1,1,4
ISMI,0,0,0,1,1,4
SMIS,0,0,0,1,1,4
MISI,0,0,0,1,1,4
ISIV,0,0,0,1,1,4
SIVD,0,0,0,1,1,4
IVDD,0,0,0,1,1,4
VDDT,0,0,0,1,1,4
DDTF,0,0,0,1,1,4
DTFD,0,0,0,1,1,4
TFDA,0,0,0,1,1,4
PRES,0,0,0,1,1,4
RESF,0,0,0,1,1,4
ESFA,0,0,0,1,1,4
FAVL,0,0,0,1,1,4
AVLA,0,0,0,1,1,4
VLAS,0,0,0,1,1,4
ASAL,0,0,0,1,1,4
SALA,0,0,0,1,1,4
LALM,0,0,0,1,1,4
ALMA,0,0,0,1,1,4
LMAA,0,0,0,1,1,4
MAAV,0,0,0,1,1,4
AAVF,0,0,0,1,1,4
AVFE,0,0,0,2,2,4
VFER,0,0,0,1,1,4
ERLA,0,0,0,1,1,4
RLAV,0,0,0,1,1,4
LAVE,0,0,0,1,1,4
VEIR,0,0,0,1,1,4
EIRE,0,0,0,1,1,4
PRRQ,0,0,0,1,1,4
RRQQ,0,0,0,1,1,4
RQQS,0,0,0,1,1,4
QQSL,0,0,0,1,1,4
SLAL,0,0,0,1,1,4
LALR,0,0,0,1,1,4
ALRW,0,0,0,1,1,4
LRWL,0,0,0,1,1,4
RWLV,0,0,0,1,1,4
WLVQ,0,0,0,1,1,4
LVQA,0,0,0,3,3,4
VQAA,0,0,0,1,1,4
QAAN,0,0,0,1,1,4
PSAL,0,0,0,1,1,4
SALI,0,0,0,2,2,4
LIDQ,0,0,0,2,2,4
IDQE,0,0,0,1,1,4
DQEI,0,0,0,1,1,4
QEIN,0,0,0,1,1,4
EINV,0,0,0,1,1,4
INVL,0,0,0,1,1,4
NVLR,0,0,0,2,2,4
VLRQ,0,0,0,1,1,4
LRQQ,0,0,0,1,1,4
RQQA,0,0,0,1,1,4
QQAA,0,0,0,1,1,4
QAAQ,0,0,0,1,1,4
AQRF,0,0,0,1,1,4
PSDQ,0,0,0,1,1,4
SDQQ,0,0,0,1,1,4
DQQN,0,0,0,1,1,4
QQNE,0,0,0,1,1,4
QNEM,0,0,0,1,1,4
NEMV,0,0,0,1,1,4
MVRE,0,0,0,1,1,4
PSFF,0,0,0,1,1,4
SFFR,0,0,0,1,1,4
FFRL,0,0,0,1,1,4
LHKY,0,0,0,1,1,4
HKYM,0,0,0,1,1,4
KYMD,0,0,0,1,1,4
YMDN,0,0,0,1,1,4
MDNI,0,0,0,1,1,4
DNIF,0,0,0,1,1,4
IFKK,0,0,0,1,1,4
FKKH,0,0,0,1,1,4
KKHT,0,0,0,1,1,4
KHTD,0,0,0,1,1,4
PSSQ,0,0,0,1,1,4
SSQI,0,0,0,1,1,4
SQIV,0,0,0,1,1,4
QIVG,0,0,0,1,1,4
IVGT,0,0,0,1,1,4
VGTQ,0,0,0,1,1,4
GTQA,0,0,0,1,1,4
TQAV,0,0,0,1,1,4
QAVF,0,0,0,1,1,4
AVFN,0,0,0,1,1,4
VFNV,0,0,0,1,1,4
FNVM,0,0,0,1,1,4
NVMM,0,0,0,1,1,4
VMMG,0,0,0,1,1,4
PSVV,0,0,0,1,1,4
SVVA,0,0,0,1,1,4
VVAN,0,0,0,1,1,4
VANT,0,0,0,1,1,4
ANTV,0,0,0,1,1,4
NTVK,0,0,0,1,1,4
TVKG,0,0,0,1,1,4
VKGG,0,0,0,1,1,4
PTKE,0,0,0,1,1,4
KERE,0,0,0,1,1,4
EREQ,0,0,0,2,2,4
EQVI,0,0,0,1,1,4
QVIA,0,0,0,2,2,4
VIAH,0,0,0,1,1,4
IAHL,0,0,0,1,1,4
AHLG,0,0,0,1,1,4
HLGL,0,0,0,1,1,4
PTLL,0,0,0,1,1,4
TLLD,0,0,0,2,2,4
LDLF,0,0,0,1,1,4
DLFA,0,0,0,1,1,4
LFAE,0,0,0,2,2,4
FAED,0,0,0,1,1,4
AEDI,0,0,0,1,1,4
EDIG,0,0,0,1,1,4
DIGH,0,0,0,1,1,4
IGHA,0,0,0,1,1,4
GHAN,0,0,0,1,1,4
HANQ,0,0,0,1,1,4
ANQL,0,0,0,1,1,4
QLLQ,0,0,0,1,1,4
QLVD,0,0,0,2,2,4
LVDE,0,0,0,1,1,4
VDEE,0,0,0,1,1,4
DEEF,0,0,0,1,1,4
EEFQ,0,0,0,1,1,4
EFQA,0,0,0,1,1,4
FQAL,0,0,0,1,1,4
QALE,0,0,0,1,1,4
ALER,0,0,0,1,1,4
PVSD,0,0,0,1,1,4
VSDT,0,0,0,1,1,4
SDTM,0,0,0,1,1,4
DTMD,0,0,0,1,1,4
TMDM,0,0,0,1,1,4
MDML,0,0,0,1,1,4
DMLT,0,0,0,1,1,4
MLTK,0,0,0,1,1,4
PWTQ,0,0,0,1,1,4
WTQR,0,0,0,1,1,4
TQRF,0,0,0,1,1,4
QRFF,0,0,0,1,1,4
FFES,0,0,0,1,1,4
FESF,0,0,0,1,1,4
ESFG,0,0,0,1,1,4
QAGN,0,0,0,1,1,4
AGNY,0,0,0,1,1,4
GNYA,0,0,0,1,1,4
NYAS,0,0,0,1,1,4
YASM,0,0,0,1,1,4
ASMF,0,0,0,1,1,4
SMFW,0,0,0,1,1,4
MFWL,0,0,0,1,1,4
FWLT,0,0,0,1,1,4
QAKE,0,0,0,2,2,4
AKEV,0,0,0,1,1,4
EVLK,0,0,0,1,1,4
VLKQ,0,0,0,1,1,4
LKQH,0,0,0,3,3,4
KQHF,0,0,0,1,1,4
QHFE,0,0,0,1,1,4
HFEK,0,0,0,1,1,4
ARVW,0,0,0,1,1,4
RVWV,0,0,0,1,1,4
VWVA,0,0,0,1,1,4
WVAR,0,0,0,1,1,4
VARA,0,0,0,1,1,4
ARAV,0,0,0,1,1,4
RAVS,0,0,0,1,1,4
AVSE,0,0,0,1,1,4
VSEH,0,0,0,1,1,4
SEHQ,0,0,0,1,1,4
EHQR,0,0,0,1,1,4
HQRF,0,0,0,1,1,4
QRFT,0,0,0,1,1,4
RFTA,0,0,0,1,1,4
QAST,0,0,0,1,1,4
STGS,0,0,0,1,1,4
TGSL,0,0,0,1,1,4
SLLN,0,0,0,1,1,4
NILR,0,0,0,1,1,4
QDDV,0,0,0,1,1,4
DDVL,0,0,0,1,1,4
DVLE,0,0,0,1,1,4
VLEA,0,0,0,2,2,4
EALS,0,0,0,1,1,4
LSAA,0,0,0,1,1,4
SAAV,0,0,0,1,1,4
AAVR,0,0,0,1,1,4
DELV,0,0,0,1,1,4
ELVW,0,0,0,1,1,4
LVWG,0,0,0,1,1,4
VWGA,0,0,0,1,1,4
WGAY,0,0,0,1,1,4
GAYW,0,0,0,1,1,4
AYWL,0,0,0,1,1,4
YWLY,0,0,0,1,1,4
WLYK,0,0,0,1,1,4
LYKA,0,0,0,1,1,4
YKAT,0,0,0,1,1,4
QDLL,0,0,0,1,1,4
DLLD,0,0,0,1,1,4
LLDR,0,0,0,1,1,4
LDRV,0,0,0,1,1,4
RVLA,0,0,0,1,1,4
VLAA,0,0,0,2,2,4
LAAH,0,0,0,1,1,4
AAHA,0,0,0,1,1,4
AHAY,0,0,0,1,1,4
HAYW,0,0,0,1,1,4
AYWS,0,0,0,1,1,4
YWSQ,0,0,0,1,1,4
QEWV,0,0,0,1,1,4
EWVE,0,0,0,1,1,4
WVEL,0,0,0,1,1,4
VELM,0,0,0,1,1,4
ELMV,0,0,0,1,1,4
LMVE,0,0,0,1,1,4
MVEA,0,0,0,1,1,4
VEAK,0,0,0,1,1,4
EAKE,0,0,0,1,1,4
QFRR,0,0,0,1,1,4
FRRG,0,0,0,1,1,4
RRGA,0,0,0,1,1,4
RGAN,0,0,0,1,1,4
GANF,0,0,0,1,1,4
ANFK,0,0,0,1,1,4
NFKF,0,0,0,1,1,4
FKFE,0,0,0,1,1,4
KFEL,0,0,0,1,1,4
FELG,0,0,0,1,1,4
ELGE,0,0,0,1,1,4
LGEI,0,0,0,1,1,4
EILE,0,0,0,1,1,4
LEND,0,0,0,1,1,4
QFSR,0,0,0,1,1,4
FSRQ,0,0,0,1,1,4
SRQM,0,0,0,1,1,4
RQML,0,0,0,1,1,4
QMLD,0,0,0,1,1,4
MLDR,0,0,0,1,1,4
LDRK,0,0,0,1,1,4
DRKL,0,0,0,1,1,4
KLLL,0,0,0,1,1,4
LLLG,0,0,0,1,1,4
QGLA,0,0,0,1,1,4
GLAE,0,0,0,1,1,4
EKIF,0,0,0,1,1,4
KIFW,0,0,0,1,1,4
IFWS,0,0,0,1,1,4
FWSL,0,0,0,1,1,4
WSLK,0,0,0,1,1,4
QHLA,0,0,0,1,1,4
AKLE,0,0,0,1,1,4
KLEM,0,0,0,1,1,4
LEMK,0,0,0,1,1,4
EMKI,0,0,0,1,1,4
MKIF,0,0,0,1,1,4
KIFF,0,0,0,1,1,4
IFFE,0,0,0,1,1,4
FFEE,0,0,0,1,1,4
FEEL,0,0,0,1,1,4
QIKQ,0,0,0,1,1,4
IKQT,0,0,0,1,1,4
KQTN,0,0,0,1,1,4
QTNA,0,0,0,1,1,4
TNAG,0,0,0,1,1,4
NAGA,0,0,0,1,1,4
AGAV,0,0,0,1,1,4
AVYR,0,0,0,1,1,4
VYRL,0,0,0,1,1,4
YRLI,0,0,0,1,1,4
RLID,0,0,0,1,1,4
IDQL,0,0,0,1,1,4
DQLG,0,0,0,1,1,4
QINE,0,0,0,1,1,4
INEM,0,0,0,1,1,4
NEMH,0,0,0,1,1,4
EMHL,0,0,0,1,1,4
MHLL,0,0,0,1,1,4
HLLI,0,0,0,1,1,4
LIQQ,0,0,0,2,2,4
IQQA,0,0,0,1,1,4
QQAR,0,0,0,1,1,4
QIPR,0,0,0,1,1,4
IPRI,0,0,0,1,1,4
PRIA,0,0,0,1,1,4
RIAR,0,0,0,1,1,4
AREK,0,0,0,1,1,4
REKI,0,0,0,2,2,4
EKIR,0,0,0,1,1,4
KIRG,0,0,0,1,1,4
IRGL,0,0,0,1,1,4
RGLT,0,0,0,1,1,4
LTEY,0,0,0,1,1,4
TEYF,0,0,0,1,1,4
QLEE,0,0,0,1,1,4
EESM,0,0,0,1,1,4
SMLY,0,0,0,1,1,4
MLYS,0,0,0,1,1,4
LYSL,0,0,0,1,1,4
YSLN,0,0,0,1,1,4
QLLR,0,0,0,2,2,4
LLRG,0,0,0,1,1,4
LRGV,0,0,0,1,1,4
RGVG,0,0,0,1,1,4
GVGA,0,0,0,1,1,4
VGAA,0,0,0,1,1,4
GAAA,0,0,0,1,1,4
AAAT,0,0,0,1,1,4
AATA,0,0,0,2,2,4
ATAV,0,0,0,1,1,4
TAVT,0,0,0,1,1,4
AVTQ,0,0,0,1,1,4
VTQA,0,0,0,1,1,4
TQAL,0,0,0,1,1,4
QALN,0,0,0,1,1,4
ALNE,0,0,0,1,1,4
LNEL,0,0,0,1,1,4
ELLQ,0,0,0,2,2,4
LLQH,0,0,0,2,2,4
LQHV,0,0,0,1,1,4
QHVK,0,0,0,1,1,4
HVKA,0,0,0,1,1,4
VDRL,0,0,0,1,1,4
DRLD,0,0,0,1,1,4
RLDQ,0,0,0,1,1,4
LDQS,0,0,0,1,1,4
DQSW,0,0,0,1,1,4
QSWQ,0,0,0,1,1,4
SWQY,0,0,0,1,1,4
WQYY,0,0,0,1,1,4
QYYQ,0,0,0,1,1,4
YYQD,0,0,0,1,1,4
YQDR,0,0,0,1,1,4
QDRL,0,0,0,1,1,4
DRLM,0,0,0,1,1,4
RLMA,0,0,0,1,1,4
QLVS,0,0,0,1,1,4
VSFL,0,0,0,1,1,4
SFLI,0,0,0,1,1,4
LIRL,0,0,0,1,1,4
IRLL,0,0,0,2,2,4
RLLK,0,0,0,1,1,4
LLKV,0,0,0,2,2,4
LKVW,0,0,0,1,1,4
KVWI,0,0,0,1,1,4
VWIR,0,0,0,1,1,4
IRVV,0,0,0,1,1,4
RVVI,0,0,0,1,1,4
QMSF,0,0,0,1,1,4
MSFW,0,0,0,1,1,4
SFWG,0,0,0,1,1,4
FWGA,0,0,0,1,1,4
WGAT,0,0,0,1,1,4
GATV,0,0,0,1,1,4
ATVI,0,0,0,1,1,4
TVIT,0,0,0,1,1,4
VITG,0,0,0,1,1,4
ITGL,0,0,0,1,1,4
TGLF,0,0,0,1,1,4
GLFG,0,0,0,1,1,4
QPNA,0,0,0,1,1,4
PNAI,0,0,0,1,1,4
AILE,0,0,0,1,1,4
ILEK,0,0,0,2,2,4
LEKV,0,0,0,2,2,4
EKVF,0,0,0,1,1,4
KVFT,0,0,0,1,1,4
VFTA,0,0,0,1,1,4
QRAF,0,0,0,1,1,4
RAFL,0,0,0,1,1,4
LKLY,0,0,0,1,1,4
KLYM,0,0,0,1,1,4
LYMI,0,0,0,1,1,4
YMIT,0,0,0,1,1,4
MITM,0,0,0,1,1,4
ITMT,0,0,0,1,1,4
QTRE,0,0,0,1,1,4
REHL,0,0,0,1,1,4
HLLL,0,0,0,2,2,4
LARQ,0,0,0,1,1,4
ARQI,0,0,0,1,1,4
IAKW,0,0,0,1,1,4
AKWG,0,0,0,1,1,4
KWGA,0,0,0,1,1,4
WGAW,0,0,0,1,1,4
GAWV,0,0,0,1,1,4
AWVK,0,0,0,1,1,4
WVKR,0,0,0,1,1,4
VKRI,0,0,0,1,1,4
KRIE,0,0,0,2,2,4
IEAK,0,0,0,1,1,4
EAKF,0,0,0,1,1,4
AKFR,0,0,0,1,1,4
KFRS,0,0,0,1,1,4
FRSL,0,0,0,1,1,4
QVIE,0,0,0,1,1,4
VIEV,0,0,0,1,1,4
IEVL,0,0,0,2,2,4
EVLN,0,0,0,1,1,4
VLNK,0,0,0,1,1,4
LNKQ,0,0,0,1,1,4
NKQV,0,0,0,1,1,4
KQVA,0,0,0,2,2,4
QVAD,0,0,0,1,1,4
VADW,0,0,0,1,1,4
ADWS,0,0,0,1,1,4
DWSV,0,0,0,1,1,4
WSVL,0,0,0,1,1,4
VLFT,0,0,0,1,1,4
LFTK,0,0,0,1,1,4
FTKL,0,0,0,1,1,4
TKLH,0,0,0,1,1,4
KLHN,0,0,0,1,1,4
LHNF,0,0,0,2,2,4
HNFH,0,0,0,2,2,4
NFHW,0,0,0,1,1,4
FHWY,0,0,0,1,1,4
HWYV,0,0,0,1,1,4
QVTQ,0,0,0,1,1,4
VTQE,0,0,0,1,1,4
TQEL,0,0,0,1,1,4
QELR,0,0,0,1,1,4
ELRA,0,0,0,1,1,4
RALM,0,0,0,1,1,4
ALMD,0,0,0,1,1,4
LMDE,0,0,0,1,1,4
MDET,0,0,0,1,1,4
DETM,0,0,0,1,1,4
ETMK,0,0,0,1,1,4
TMKE,0,0,0,1,1,4
MKEL,0,0,0,1,1,4
KELK,0,0,0,1,1,4
ELKA,0,0,0,1,1,4
KAYK,0,0,0,1,1,4
AYKS,0,0,0,2,2,4
YKSE,0,0,0,1,1,4
KSEL,0,0,0,1,1,4
SELE,0,0,0,1,1,4
RAAA,0,0,0,2,2,4
AIEQ,0,0,0,1,1,4
EQLK,0,0,0,1,1,4
QLKI,0,0,0,1,1,4
LKIW,0,0,0,1,1,4
KIWG,0,0,0,1,1,4
IWGE,0,0,0,1,1,4
WGER,0,0,0,1,1,4
GERV,0,0,0,1,1,4
ERVG,0,0,0,1,1,4
RDIP,0,0,0,1,1,4
DIPE,0,0,0,1,1,4
IPEL,0,0,0,1,1,4
PELA,0,0,0,1,1,4
ELAQ,0,0,0,1,1,4
AQLQ,0,0,0,2,2,4
LQSE,0,0,0,1,1,4
QSEI,0,0,0,2,2,4
SEIL,0,0,0,3,3,4
ILDA,0,0,0,1,1,4
LDAI,0,0,0,1,1,4
DAIW,0,0,0,1,1,4
REEE,0,0,0,1,1,4
EEEK,0,0,0,1,1,4
EEKE,0,0,0,2,2,4
ALRF,0,0,0,1,1,4
LRFA,0,0,0,1,1,4
RFAE,0,0,0,1,1,4
FAEA,0,0,0,1,1,4
AEAQ,0,0,0,1,1,4
REEI,0,0,0,1,1,4
EIYQ,0,0,0,2,2,4
IYQA,0,0,0,1,1,4
YQAF,0,0,0,1,1,4
QAFE,0,0,0,1,1,4
FEAI,0,0,0,1,1,4
EAIY,0,0,0,1,1,4
AIYP,0,0,0,1,1,4
IYPV,0,0,0,1,1,4
YPVL,0,0,0,1,1,4
PVLS,0,0,0,1,1,4
VLSE,0,0,0,1,1,4
LSEF,0,0,0,1,1,4
REGF,0,0,0,1,1,4
EGFL,0,0,0,1,1,4
GFLS,0,0,0,1,1,4
FLSP,0,0,0,1,1,4
LSPL,0,0,0,1,1,4
SPLK,0,0,0,1,1,4
PLKA,0,0,0,2,2,4
AYLI,0,0,0,1,1,4
RFES,0,0,0,1,1,4
FESA,0,0,0,1,1,4
ESAV,0,0,0,2,2,4
SAVE,0,0,0,1,1,4
AVET,0,0,0,1,1,4
VETL,0,0,0,1,1,4
ETLL,0,0,0,1,1,4
LDIE,0,0,0,1,1,4
DIES,0,0,0,1,1,4
IESQ,0,0,0,1,1,4
ESQL,0,0,0,1,1,4
SQLE,0,0,0,1,1,4
LEDL,0,0,0,1,1,4
RFLI,0,0,0,1,1,4
LIRV,0,0,0,1,1,4
IRVY,0,0,0,1,1,4
RVYH,0,0,0,1,1,4
VYHP,0,0,0,1,1,4
YHPL,0,0,0,1,1,4
HPLL,0,0,0,1,1,4
PLLL,0,0,0,1,1,4
LLLK,0,0,0,1,1,4
RFLK,0,0,0,1,1,4
FLKR,0,0,0,1,1,4
KRVQ,0,0,0,1,1,4
RVQP,0,0,0,1,1,4
VQPL,0,0,0,1,1,4
QPLV,0,0,0,1,1,4
PLVN,0,0,0,1,1,4
LVNR,0,0,0,1,1,4
VNRW,0,0,0,1,1,4
NRWL,0,0,0,1,1,4
RWLL,0,0,0,1,1,4
WLLL,0,0,0,2,2,4
LLLI,0,0,0,2,2,4
RFSG,0,0,0,1,1,4
FSGK,0,0,0,1,1,4
SGKV,0,0,0,1,1,4
GKVR,0,0,0,1,1,4
REDL,0,0,0,1,1,4
EDLT,0,0,0,1,1,4
DLTK,0,0,0,1,1,4
TKIV,0,0,0,1,1,4
KIVW,0,0,0,1,1,4
IVWV,0,0,0,1,1,4
VWVF,0,0,0,1,1,4
WVFF,0,0,0,1,1,4
VFFW,0,0,0,1,1,4
RFVP,0,0,0,1,1,4
FVPR,0,0,0,1,1,4
VPRW,0,0,0,1,1,4
PRWR,0,0,0,1,1,4
RWRT,0,0,0,1,1,4
WRTV,0,0,0,1,1,4
RTVV,0,0,0,1,1,4
TVVG,0,0,0,1,1,4
VVGQ,0,0,0,1,1,4
VGQF,0,0,0,1,1,4
GQFK,0,0,0,1,1,4
QFKR,0,0,0,1,1,4
FKRD,0,0,0,1,1,4
KRDI,0,0,0,1,1,4
RDIL,0,0,0,1,1,4
DILV,0,0,0,1,1,4
ILVI,0,0,0,1,1,4
LVIF,0,0,0,1,1,4
VIFL,0,0,0,1,1,4
IFLW,0,0,0,1,1,4
RGEQ,0,0,0,2,2,4
GEQM,0,0,0,1,1,4
EQMK,0,0,0,1,1,4
QMKG,0,0,0,1,1,4
MKGH,0,0,0,1,1,4
KGHA,0,0,0,1,1,4
GHAA,0,0,0,1,1,4
HAAT,0,0,0,1,1,4
AATI,0,0,0,1,1,4
ATIE,0,0,0,1,1,4
TIED,0,0,0,1,1,4
IEDQ,0,0,0,1,1,4
EDQV,0,0,0,1,1,4
DQVR,0,0,0,1,1,4
QVRR,0,0,0,1,1,4
VRRM,0,0,0,1,1,4
RRMI,0,0,0,1,1,4
RMIA,0,0,0,1,1,4
RGFR,0,0,0,1,1,4
GFRG,0,0,0,1,1,4
FRGW,0,0,0,1,1,4
RGWW,0,0,0,1,1,4
GWWL,0,0,0,1,1,4
WWLA,0,0,0,1,1,4
LAST,0,0,0,1,1,4
ASTI,0,0,0,1,1,4
STIL,0,0,0,2,2,4
TILL,0,0,0,1,1,4
LLLV,0,0,0,1,1,4
LVAE,0,0,0,1,1,4
RGQL,0,0,0,1,1,4
GQLI,0,0,0,1,1,4
QLIR,0,0,0,1,1,4
IREA,0,0,0,1,1,4
REAY,0,0,0,2,2,4
EAYE,0,0,0,1,1,4
AYED,0,0,0,1,1,4
RHSD,0,0,0,1,1,4
HSDN,0,0,0,1,1,4
SDNI,0,0,0,1,1,4
DNIN,0,0,0,1,1,4
NINK,0,0,0,1,1,4
INKF,0,0,0,1,1,4
NKFL,0,0,0,1,1,4
KFLD,0,0,0,1,1,4
FLDF,0,0,0,1,1,4
LDFI,0,0,0,1,1,4
DFIH,0,0,0,1,1,4
FIHG,0,0,0,1,1,4
IHGI,0,0,0,1,1,4
RIEN,0,0,0,1,1,4
IENG,0,0,0,1,1,4
ENGL,0,0,0,1,1,4
NGLR,0,0,0,1,1,4
GLRK,0,0,0,1,1,4
LRKR,0,0,0,1,1,4
RLQS,0,0,0,1,1,4
LQSI,0,0,0,1,1,4
QSIY,0,0,0,1,1,4
IYRH,0,0,0,1,1,4
YRHL,0,0,0,1,1,4
RHLE,0,0,0,1,1,4
ILKN,0,0,0,2,2,4
KNFD,0,0,0,1,1,4
NFDS,0,0,0,1,1,4
FDSW,0,0,0,1,1,4
DSWW,0,0,0,1,1,4
SWWG,0,0,0,1,1,4
WWGK,0,0,0,1,1,4
WGKV,0,0,0,1,1,4
KVIV,0,0,0,1,1,4
VIVI,0,0,0,1,1,4
IVIL,0,0,0,1,1,4
RILQ,0,0,0,1,1,4
ILQW,0,0,0,1,1,4
LQWI,0,0,0,1,1,4
QWII,0,0,0,1,1,4
WIIR,0,0,0,1,1,4
IIRL,0,0,0,1,1,4
RLLL,0,0,0,1,1,4
LIVW,0,0,0,1,1,4
IVWW,0,0,0,1,1,4
RIWA,0,0,0,1,1,4
IWAR,0,0,0,1,1,4
WARL,0,0,0,1,1,4
RLQG,0,0,0,2,2,4
LQGV,0,0,0,1,1,4
GVFR,0,0,0,1,1,4
VFRV,0,0,0,1,1,4
FRVV,0,0,0,1,1,4
RVVF,0,0,0,1,1,4
VVFW,0,0,0,1,1,4
VFWL,0,0,0,1,1,4
RKQS,0,0,0,1,1,4
KQSL,0,0,0,1,1,4
QSLE,0,0,0,1,1,4
SLEQ,0,0,0,2,2,4
LEQD,0,0,0,1,1,4
QDLQ,0,0,0,1,1,4
DLQF,0,0,0,1,1,4
LQFY,0,0,0,1,1,4
QFYY,0,0,0,1,1,4
FYYG,0,0,0,1,1,4
RLDE,0,0,0,1,1,4
EAEA,0,0,0,1,1,4
AEAS,0,0,0,1,1,4
EASA,0,0,0,1,1,4
ASAR,0,0,0,1,1,4
SARS,0,0,0,1,1,4
ARSG,0,0,0,1,1,4
RSGI,0,0,0,1,1,4
SGIE,0,0,0,1,1,4
GIEV,0,0,0,1,1,4
RLFE,0,0,0,1,1,4
LFEQ,0,0,0,1,1,4
FEQA,0,0,0,1,1,4
EQAS,0,0,0,1,1,4
QASR,0,0,0,1,1,4
RLAE,0,0,0,1,1,4
LAEH,0,0,0,1,1,4
AEHY,0,0,0,1,1,4
RLKS,0,0,0,1,1,4
LKSG,0,0,0,1,1,4
KSGW,0,0,0,1,1,4
SGWR,0,0,0,1,1,4
GWRD,0,0,0,1,1,4
WRDA,0,0,0,1,1,4
RDAL,0,0,0,1,1,4
KQIV,0,0,0,1,1,4
QIVF,0,0,0,1,1,4
VFFF,0,0,0,1,1,4
FFFF,0,0,0,2,2,4
FFFL,0,0,0,1,1,4
RLLG,0,0,0,1,1,4
LLGK,0,0,0,2,2,4
LGKW,0,0,0,1,1,4
GKWS,0,0,0,1,1,4
KWSA,0,0,0,1,1,4
WSAI,0,0,0,1,1,4
SAIL,0,0,0,1,1,4
KNVR,0,0,0,2,2,4
NVRF,0,0,0,1,1,4
VRFF,0,0,0,1,1,4
RFFF,0,0,0,1,1,4
FFFW,0,0,0,1,1,4
FFWL,0,0,0,1,1,4
RLVV,0,0,0,1,1,4
LVVL,0,0,0,1,1,4
VVLE,0,0,0,1,1,4
ALTN,0,0,0,2,2,4
LTNF,0,0,0,2,2,4
TNFL,0,0,0,1,1,4
NFLN,0,0,0,1,1,4
FLNH,0,0,0,1,1,4
RLWT,0,0,0,1,1,4
LWTQ,0,0,0,1,1,4
WTQW,0,0,0,1,1,4
TQWQ,0,0,0,1,1,4
WQAI,0,0,0,1,1,4
QAIV,0,0,0,1,1,4
AIVQ,0,0,0,1,1,4
IVQE,0,0,0,1,1,4
VQEI,0,0,0,1,1,4
QEIR,0,0,0,1,1,4
EIRF,0,0,0,1,1,4
IRFL,0,0,0,1,1,4
RFLW,0,0,0,1,1,4
FLWL,0,0,0,1,1,4
LWLL,0,0,0,1,1,4
RMDE,0,0,0,1,1,4
MDEV,0,0,0,1,1,4
DEVR,0,0,0,1,1,4
RTLQ,0,0,0,1,1,4
TLQE,0,0,0,1,1,4
LQEN,0,0,0,1,1,4
QENL,0,0,0,1,1,4
ENLR,0,0,0,1,1,4
NLRQ,0,0,0,1,1,4
QLQD,0,0,0,1,1,4
LQDE,0,0,0,1,1,4
QDEY,0,0,0,1,1,4
DEYD,0,0,0,1,1,4
EYDQ,0,0,0,1,1,4
YDQQ,0,0,0,1,1,4
DQQQ,0,0,0,1,1,4
QQQT,0,0,0,1,1,4
RNEV,0,0,0,1,1,4
NEVV,0,0,0,1,1,4
EVVS,0,0,0,1,1,4
VVSL,0,0,0,1,1,4
VSLM,0,0,0,2,2,4
SLMQ,0,0,0,1,1,4
MQAN,0,0,0,1,1,4
QANG,0,0,0,1,1,4
RPED,0,0,0,1,1,4
PEDK,0,0,0,1,1,4
EDKS,0,0,0,1,1,4
DKSK,0,0,0,1,1,4
KSKI,0,0,0,1,1,4
SKIV,0,0,0,1,1,4
KIVA,0,0,0,1,1,4
IVAE,0,0,0,1,1,4
RPEV,0,0,0,1,1,4
EVQD,0,0,0,1,1,4
VQDA,0,0,0,1,1,4
QDAL,0,0,0,1,1,4
DALS,0,0,0,1,1,4
LSAE,0,0,0,1,1,4
RPQL,0,0,0,1,1,4
PQLR,0,0,0,1,1,4
QLRN,0,0,0,1,1,4
LRNL,0,0,0,2,2,4
RNLL,0,0,0,1,1,4
NLLH,0,0,0,1,1,4
LLHE,0,0,0,1,1,4
LHEK,0,0,0,1,1,4
RPRI,0,0,0,1,1,4
PRII,0,0,0,1,1,4
RIIA,0,0,0,1,1,4
IIAA,0,0,0,1,1,4
IAAI,0,0,0,1,1,4
AAIW,0,0,0,1,1,4
AIWH,0,0,0,1,1,4
IWHY,0,0,0,1,1,4
WHYV,0,0,0,1,1,4
HYVK,0,0,0,1,1,4
YVKA,0,0,0,1,1,4
VKAR,0,0,0,1,1,4
RRQE,0,0,0,1,1,4
RQEL,0,0,0,2,2,4
QELE,0,0,0,1,1,4
EEFS,0,0,0,1,1,4
EFSA,0,0,0,1,1,4
FSAA,0,0,0,1,1,4
LARR,0,0,0,1,1,4
RVIE,0,0,0,1,1,4
VIEG,0,0,0,1,1,4
IEGI,0,0,0,1,1,4
EGIK,0,0,0,1,1,4
GIKN,0,0,0,1,1,4
IKNV,0,0,0,2,2,4
KNVI,0,0,0,1,1,4
NVIP,0,0,0,1,1,4
VIPK,0,0,0,1,1,4
PKLL,0,0,0,1,1,4
KLLT,0,0,0,1,1,4
LLTW,0,0,0,1,1,4
LTWW,0,0,0,1,1,4
TWWP,0,0,0,1,1,4
VNAA,0,0,0,1,1,4
NAAI,0,0,0,2,2,4
AAIP,0,0,0,1,1,4
AIPN,0,0,0,1,1,4
IPNI,0,0,0,1,1,4
PNII,0,0,0,1,1,4
NIIV,0,0,0,1,1,4
RVWR,0,0,0,2,2,4
VWRW,0,0,0,2,2,4
WRWI,0,0,0,1,1,4
RWIV,0,0,0,1,1,4
WIVK,0,0,0,1,1,4
IVKW,0,0,0,1,1,4
VKWW,0,0,0,1,1,4
KWWL,0,0,0,1,1,4
WLFV,0,0,0,2,2,4
RYGW,0,0,0,1,1,4
YGWR,0,0,0,1,1,4
GWRT,0,0,0,1,1,4
WRTA,0,0,0,1,1,4
RTAV,0,0,0,1,1,4
TAVD,0,0,0,1,1,4
AVDY,0,0,0,1,1,4
VDYS,0,0,0,1,1,4
DYSW,0,0,0,1,1,4
YSWF,0,0,0,1,1,4
SWFG,0,0,0,1,1,4
SAAT,0,0,0,1,1,4
TADF,0,0,0,1,1,4
ADFV,0,0,0,1,1,4
DFVA,0,0,0,1,1,4
FVAM,0,0,0,1,1,4
VAMT,0,0,0,1,1,4
AMTA,0,0,0,1,1,4
TAMA,0,0,0,1,1,4
AMAA,0,0,0,1,1,4
MAAR,0,0,0,1,1,4
AARI,0,0,0,1,1,4
ARIF,0,0,0,1,1,4
SAAW,0,0,0,1,1,4
AAWA,0,0,0,1,1,4
WAEW,0,0,0,1,1,4
AEWQ,0,0,0,1,1,4
EWQK,0,0,0,1,1,4
WQKA,0,0,0,1,1,4
QKAR,0,0,0,1,1,4
SAEE,0,0,0,1,1,4
AEEM,0,0,0,1,1,4
EEMV,0,0,0,1,1,4
EMVQ,0,0,0,1,1,4
MVQT,0,0,0,1,1,4
QTLV,0,0,0,1,1,4
TLVN,0,0,0,1,1,4
LVND,0,0,0,1,1,4
VNDY,0,0,0,1,1,4
NDYS,0,0,0,1,1,4
DYSA,0,0,0,1,1,4
YSAL,0,0,0,1,1,4
ALIQ,0,0,0,1,1,4
LIQE,0,0,0,2,2,4
IQEL,0,0,0,1,1,4
QELK,0,0,0,1,1,4
ELKE,0,0,0,1,1,4
LKEG,0,0,0,1,1,4
KEGM,0,0,0,1,1,4
EGME,0,0,0,1,1,4
GMEV,0,0,0,1,1,4
MEVA,0,0,0,1,1,4
EVAG,0,0,0,1,1,4
VAGE,0,0,0,1,1,4
AGEA,0,0,0,1,1,4
SANN,0,0,0,1,1,4
ANNI,0,0,0,1,1,4
NNII,0,0,0,1,1,4
NIIE,0,0,0,1,1,4
IIEE,0,0,0,1,1,4
IEEI,0,0,0,1,1,4
EEIQ,0,0,0,1,1,4
EIQM,0,0,0,1,1,4
IQMQ,0,0,0,1,1,4
QMQK,0,0,0,1,1,4
SASS,0,0,0,1,1,4
ASSQ,0,0,0,1,1,4
SSQN,0,0,0,2,2,4
SQNA,0,0,0,1,1,4
QNAW,0,0,0,1,1,4
NAWL,0,0,0,1,1,4
WLAA,0,0,0,1,1,4
AANR,0,0,0,1,1,4
ANRN,0,0,0,1,1,4
AVKV,0,0,0,1,1,4
VKVL,0,0,0,1,1,4
KVLA,0,0,0,1,1,4
LAEE,0,0,0,2,2,4
AEES,0,0,0,1,1,4
EESK,0,0,0,2,2,4
SDEF,0,0,0,1,1,4
DEFN,0,0,0,1,1,4
EFNT,0,0,0,1,1,4
FNTV,0,0,0,1,1,4
NTVA,0,0,0,1,1,4
TVAD,0,0,0,1,1,4
VADN,0,0,0,1,1,4
ADNL,0,0,0,1,1,4
DNLV,0,0,0,1,1,4
NLVT,0,0,0,1,1,4
LVTF,0,0,0,1,1,4
VTFG,0,0,0,1,1,4
TFGD,0,0,0,1,1,4
FGDS,0,0,0,1,1,4
GDSF,0,0,0,1,1,4
DSFL,0,0,0,1,1,4
SFLQ,0,0,0,1,1,4
FLQV,0,0,0,1,1,4
LQVI,0,0,0,1,1,4
QVIL,0,0,0,1,1,4
VILD,0,0,0,1,1,4
ILDH,0,0,0,1,1,4
LDHI,0,0,0,1,1,4
SDEL,0,0,0,1,1,4
DELS,0,0,0,1,1,4
ELSR,0,0,0,1,1,4
LSRA,0,0,0,1,1,4
SRAW,0,0,0,1,1,4
RAWE,0,0,0,1,1,4
AWEV,0,0,0,1,1,4
WEVA,0,0,0,1,1,4
EVAY,0,0,0,1,1,4
VAYD,0,0,0,1,1,4
AYDE,0,0,0,2,2,4
YDEL,0,0,0,2,2,4
AAIK,0,0,0,2,2,4
SDIF,0,0,0,1,1,4
IFNK,0,0,0,1,1,4
FNKN,0,0,0,1,1,4
NKNM,0,0,0,1,1,4
KNMR,0,0,0,1,1,4
NMRA,0,0,0,1,1,4
MRAH,0,0,0,1,1,4
RAHA,0,0,0,1,1,4
HALE,0,0,0,1,1,4
DIKK,0,0,0,1,1,4
KKLG,0,0,0,2,2,4
KLGS,0,0,0,1,1,4
LGSS,0,0,0,1,1,4
GSSW,0,0,0,1,1,4
SSWI,0,0,0,1,1,4
SWII,0,0,0,1,1,4
WIIN,0,0,0,1,1,4
IINW,0,0,0,1,1,4
INWF,0,0,0,1,1,4
NWFF,0,0,0,1,1,4
WFFG,0,0,0,1,1,4
SDSE,0,0,0,1,1,4
DSEI,0,0,0,1,1,4
SEIS,0,0,0,1,1,4
EIST,0,0,0,1,1,4
ISTI,0,0,0,1,1,4
TILS,0,0,0,1,1,4
ILSD,0,0,0,1,1,4
SDVV,0,0,0,1,1,4
DVVT,0,0,0,1,1,4
VVTN,0,0,0,1,1,4
VTNE,0,0,0,1,1,4
TNER,0,0,0,1,1,4
SDWY,0,0,0,1,1,4
DWYL,0,0,0,1,1,4
WYLK,0,0,0,1,1,4
YLKG,0,0,0,1,1,4
LKGR,0,0,0,1,1,4
KGRL,0,0,0,1,1,4
GRLT,0,0,0,1,1,4
RLTS,0,0,0,1,1,4
TSLE,0,0,0,1,1,4
SLES,0,0,0,2,2,4
LESQ,0,0,0,1,1,4
ESQF,0,0,0,1,1,4
SQFI,0,0,0,1,1,4
QFIN,0,0,0,1,1,4
FINA,0,0,0,1,1,4
INAL,0,0,0,1,1,4
NALG,0,0,0,1,1,4
ALGI,0,0,0,1,1,4
LGIL,0,0,0,1,1,4
SEAA,0,0,0,1,1,4
EAAK,0,0,0,1,1,4
KAYM,0,0,0,1,1,4
AYMK,0,0,0,1,1,4
YMKG,0,0,0,1,1,4
MKGL,0,0,0,1,1,4
KGLE,0,0,0,1,1,4
GLEY,0,0,0,1,1,4
LEYQ,0,0,0,1,1,4
EYQM,0,0,0,1,1,4
YQMS,0,0,0,1,1,4
QMSG,0,0,0,1,1,4
MSGN,0,0,0,1,1,4
SGNE,0,0,0,1,1,4
GNEQ,0,0,0,1,1,4
NEQW,0,0,0,1,1,4
EQWS,0,0,0,1,1,4
QWSK,0,0,0,1,1,4
WSKT,0,0,0,1,1,4
SEEE,0,0,0,1,1,4
EEEE,0,0,0,1,1,4
EEEN,0,0,0,1,1,4
EENN,0,0,0,1,1,4
ENNV,0,0,0,1,1,4
NNVI,0,0,0,1,1,4
NVIE,0,0,0,1,1,4
VIEQ,0,0,0,1,1,4
AKEE,0,0,0,1,1,4
KEEI,0,0,0,1,1,4
EIKE,0,0,0,1,1,4
IKEA,0,0,0,1,1,4
EAIK,0,0,0,1,1,4
AIKK,0,0,0,1,1,4
IKKA,0,0,0,2,2,4
KKAD,0,0,0,1,1,4
KADE,0,0,0,1,1,4
ADET,0,0,0,1,1,4
SEEL,0,0,0,1,1,4
ELNS,0,0,0,1,1,4
LNSA,0,0,0,1,1,4
NSAW,0,0,0,2,2,4
SAWT,0,0,0,1,1,4
AWTI,0,0,0,1,1,4
WTIA,0,0,0,1,1,4
TIAY,0,0,0,1,1,4
IAYD,0,0,0,1,1,4
ELAI,0,0,0,1,1,4
LAIV,0,0,0,1,1,4
AIVI,0,0,0,1,1,4
IVIK,0,0,0,1,1,4
IKKE,0,0,0,1,1,4
KEMD,0,0,0,1,1,4
EMDD,0,0,0,1,1,4
MDDA,0,0,0,1,1,4
SEER,0,0,0,1,1,4
ERIR,0,0,0,1,1,4
RIRS,0,0,0,1,1,4
IRSG,0,0,0,1,1,4
RSGV,0,0,0,1,1,4
SGVK,0,0,0,1,1,4
GVKR,0,0,0,1,1,4
VKRL,0,0,0,1,1,4
KRLS,0,0,0,1,1,4
RLSK,0,0,0,1,1,4
LSKS,0,0,0,1,1,4
SKSR,0,0,0,1,1,4
SEEV,0,0,0,1,1,4
EEVL,0,0,0,1,1,4
VLAM,0,0,0,1,1,4
LAMV,0,0,0,1,1,4
AMVS,0,0,0,1,1,4
MVSR,0,0,0,1,1,4
VSRK,0,0,0,1,1,4
SRKM,0,0,0,1,1,4
SEEY,0,0,0,1,1,4
EEYI,0,0,0,1,1,4
EYIQ,0,0,0,1,1,4
YIQL,0,0,0,2,2,4
IQLL,0,0,0,2,2,4
SERE,0,0,0,1,1,4
REAV,0,0,0,1,1,4
VEII,0,0,0,1,1,4
EIIK,0,0,0,1,1,4
IKKN,0,0,0,1,1,4
SESA,0,0,0,1,1,4
SAVS,0,0,0,2,2,4
AVSH,0,0,0,1,1,4
VSHQ,0,0,0,1,1,4
SHQL,0,0,0,1,1,4
HQLR,0,0,0,1,1,4
RSLR,0,0,0,1,1,4
SLRN,0,0,0,1,1,4
SESK,0,0,0,1,1,4
ESKL,0,0,0,1,1,4
SKLI,0,0,0,1,1,4
KLIE,0,0,0,2,2,4
LIEQ,0,0,0,1,1,4
EQAF,0,0,0,1,1,4
QAFR,0,0,0,1,1,4
SFAD,0,0,0,1,1,4
FADF,0,0,0,1,1,4
ADFK,0,0,0,1,1,4
DFKA,0,0,0,1,1,4
FKAQ,0,0,0,1,1,4
KAQF,0,0,0,1,1,4
AQFT,0,0,0,1,1,4
QFTD,0,0,0,1,1,4
FTDA,0,0,0,1,1,4
TDAA,0,0,0,1,1,4
DAAI,0,0,0,1,1,4
AIKN,0,0,0,1,1,4
SFDR,0,0,0,1,1,4
FDRV,0,0,0,1,1,4
DRVM,0,0,0,1,1,4
RVMN,0,0,0,1,1,4
VMNA,0,0,0,1,1,4
MNAI,0,0,0,1,1,4
NAIE,0,0,0,1,1,4
IEEN,0,0,0,1,1,4
SFSR,0,0,0,1,1,4
FSRI,0,0,0,1,1,4
SRII,0,0,0,2,2,4
RIIS,0,0,0,2,2,4
IISE,0,0,0,1,1,4
SELG,0,0,0,1,1,4
ELGT,0,0,0,1,1,4
LGTR,0,0,0,1,1,4
GTRD,0,0,0,1,1,4
SGAR,0,0,0,1,1,4
GARR,0,0,0,1,1,4
ARRV,0,0,0,1,1,4
RRVR,0,0,0,1,1,4
RVRI,0,0,0,1,1,4
RIAQ,0,0,0,1,1,4
IAQT,0,0,0,1,1,4
QTLT,0,0,0,2,2,4
TLTE,0,0,0,1,1,4
LTEN,0,0,0,1,1,4
SGDE,0,0,0,1,1,4
GDEL,0,0,0,1,1,4
DELY,0,0,0,1,1,4
ELYE,0,0,0,1,1,4
LYEL,0,0,0,1,1,4
YELL,0,0,0,1,1,4
LQHI,0,0,0,1,1,4
QHIL,0,0,0,1,1,4
HILK,0,0,0,1,1,4
LKQR,0,0,0,1,1,4
KQRD,0,0,0,1,1,4
QRDH,0,0,0,1,1,4
RDHH,0,0,0,1,1,4
DHHH,0,0,0,1,1,4
HHHH,0,0,0,2,2,4
SGPA,0,0,0,1,1,4
GPAY,0,0,0,1,1,4
PAYV,0,0,0,1,1,4
AYVF,0,0,0,1,1,4
YVFY,0,0,0,2,2,4
VFYL,0,0,0,2,2,4
FYLL,0,0,0,1,1,4
YLLD,0,0,0,2,2,4
LLDA,0,0,0,1,1,4
DALQ,0,0,0,1,1,4
ALQN,0,0,0,1,1,4
QNAA,0,0,0,1,1,4
AAIR,0,0,0,1,1,4
AIRQ,0,0,0,1,1,4
SGRF,0,0,0,1,1,4
GRFW,0,0,0,1,1,4
RFWK,0,0,0,1,1,4
FWKL,0,0,0,1,1,4
WKLY,0,0,0,1,1,4
KLYI,0,0,0,1,1,4
YIEA,0,0,0,1,1,4
IEAE,0,0,0,1,1,4
AEIK,0,0,0,1,1,4
EIKA,0,0,0,1,1,4
SGTI,0,0,0,1,1,4
GTIK,0,0,0,1,1,4
KAAH,0,0,0,1,1,4
AAHE,0,0,0,1,1,4
AHEV,0,0,0,1,1,4
HEVL,0,0,0,1,1,4
EVLM,0,0,0,1,1,4
VLME,0,0,0,1,1,4
LMEM,0,0,0,1,1,4
MEMG,0,0,0,1,1,4
SHAQ,0,0,0,1,1,4
HAQD,0,0,0,1,1,4
AQDI,0,0,0,1,1,4
QDIY,0,0,0,1,1,4
DIYK,0,0,0,1,1,4
IYKE,0,0,0,1,1,4
YKEA,0,0,0,1,1,4
KEAF,0,0,0,1,1,4
EAFN,0,0,0,1,1,4
AFNS,0,0,0,1,1,4
FNSA,0,0,0,1,1,4
SAWD,0,0,0,1,1,4
AWDQ,0,0,0,1,1,4
WDQY,0,0,0,1,1,4
SIDE,0,0,0,1,1,4
IDEK,0,0,0,1,1,4
DEKY,0,0,0,1,1,4
EKYE,0,0,0,2,2,4
KYEA,0,0,0,1,1,4
YEAE,0,0,0,1,1,4
EAEV,0,0,0,1,1,4
KKSE,0,0,0,1,1,4
KSEI,0,0,0,1,1,4
SEID,0,0,0,1,1,4
EIDH,0,0,0,1,1,4
IDHH,0,0,0,1,1,4
DHHK,0,0,0,1,1,4
IERL,0,0,0,2,2,4
LLEM,0,0,0,1,1,4
LEME,0,0,0,1,1,4
EMES,0,0,0,1,1,4
MESL,0,0,0,1,1,4
SIPH,0,0,0,1,1,4
IPHL,0,0,0,1,1,4
PHLA,0,0,0,1,1,4
LANL,0,0,0,1,1,4
ANLL,0,0,0,1,1,4
NLLI,0,0,0,1,1,4
LIER,0,0,0,3,3,4
IERS,0,0,0,1,1,4
ERSQ,0,0,0,1,1,4
SISR,0,0,0,2,2,4
ISRY,0,0,0,1,1,4
SRYK,0,0,0,1,1,4
RYKT,0,0,0,1,1,4
YKTI,0,0,0,1,1,4
KTIE,0,0,0,1,1,4
TIEW,0,0,0,1,1,4
IEWL,0,0,0,1,1,4
EWLN,0,0,0,1,1,4
WLNY,0,0,0,1,1,4
NYIA,0,0,0,1,1,4
YIAT,0,0,0,1,1,4
IATE,0,0,0,1,1,4
ATEL,0,0,0,1,1,4
SKDA,0,0,0,1,1,4
KDAL,0,0,0,1,1,4
DALM,0,0,0,1,1,4
ALML,0,0,0,1,1,4
LMLE,0,0,0,1,1,4
LEAF,0,0,0,1,1,4
EAFE,0,0,0,1,1,4
AFEQ,0,0,0,1,1,4
FEQL,0,0,0,1,1,4
QLLG,0,0,0,1,1,4
LGKR,0,0,0,1,1,4
KRRE,0,0,0,1,1,4
RREL,0,0,0,1,1,4
RELL,0,0,0,2,2,4
LLGE,0,0,0,1,1,4
SKDL,0,0,0,1,1,4
DLAQ,0,0,0,1,1,4
QTSY,0,0,0,1,1,4
TSYF,0,0,0,1,1,4
SYFM,0,0,0,1,1,4
YFMA,0,0,0,1,1,4
FMAT,0,0,0,1,1,4
MATN,0,0,0,1,1,4
TNSL,0,0,0,1,1,4
NSLH,0,0,0,1,1,4
SLHL,0,0,0,1,1,4
LHLT,0,0,0,1,1,4
SKED,0,0,0,2,2,4
EDID,0,0,0,1,1,4
DIDT,0,0,0,1,1,4
IDTA,0,0,0,1,1,4
DTAM,0,0,0,1,1,4
TAMK,0,0,0,1,1,4
AMKL,0,0,0,1,1,4
MKLG,0,0,0,1,1,4
LGAG,0,0,0,1,1,4
KEDV,0,0,0,1,1,4
EDVE,0,0,0,1,1,4
DVER,0,0,0,1,1,4
VERV,0,0,0,1,1,4
RVKL,0,0,0,1,1,4
VKLR,0,0,0,1,1,4
KLRI,0,0,0,1,1,4
LRIN,0,0,0,1,1,4
RINL,0,0,0,1,1,4
NLAR,0,0,0,1,1,4
LARN,0,0,0,1,1,4
ARNW,0,0,0,1,1,4
RNWV,0,0,0,1,1,4
NWVK,0,0,0,1,1,4
WVKK,0,0,0,1,1,4
VKKY,0,0,0,1,1,4
SKEE,0,0,0,1,1,4
KEEQ,0,0,0,1,1,4
EEQR,0,0,0,1,1,4
EQRD,0,0,0,1,1,4
QRDY,0,0,0,1,1,4
RDYV,0,0,0,1,1,4
DYVF,0,0,0,1,1,4
FYLA,0,0,0,1,1,4
YLAV,0,0,0,1,1,4
LAVG,0,0,0,2,2,4
AVGN,0,0,0,2,2,4
VGNY,0,0,0,1,1,4
GNYR,0,0,0,1,1,4
NYRL,0,0,0,1,1,4
SKIQ,0,0,0,1,1,4
IQKE,0,0,0,1,1,4
QKEL,0,0,0,1,1,4
KELV,0,0,0,1,1,4
ELVA,0,0,0,1,1,4
LVAI,0,0,0,1,1,4
VAIM,0,0,0,1,1,4
AIMN,0,0,0,1,1,4
SKPI,0,0,0,1,1,4
KPIQ,0,0,0,1,1,4
PIQN,0,0,0,1,1,4
IQNV,0,0,0,1,1,4
QNVE,0,0,0,1,1,4
NVES,0,0,0,1,1,4
VESG,0,0,0,1,1,4
ESGF,0,0,0,1,1,4
SGFI,0,0,0,1,1,4
GFIF,0,0,0,1,1,4
FIFA,0,0,0,1,1,4
IFAL,0,0,0,1,1,4
FALV,0,0,0,1,1,4
ALVS,0,0,0,1,1,4
SKYL,0,0,0,1,1,4
KYLK,0,0,0,1,1,4
SLLS,0,0,0,1,1,4
SKYR,0,0,0,1,1,4
KYRL,0,0,0,1,1,4
YRLT,0,0,0,1,1,4
RLTV,0,0,0,1,1,4
LTVV,0,0,0,1,1,4
TVVV,0,0,0,1,1,4
VVVA,0,0,0,2,2,4
VVAK,0,0,0,1,1,4
VAKR,0,0,0,1,1,4
AKRA,0,0,0,1,1,4
KRAQ,0,0,0,1,1,4
RAQQ,0,0,0,1,1,4
AQQL,0,0,0,1,1,4
LLRH,0,0,0,1,1,4
SLAE,0,0,0,1,1,4
EALG,0,0,0,2,2,4
LFVS,0,0,0,1,1,4
FVSE,0,0,0,1,1,4
VSEG,0,0,0,1,1,4
SEGS,0,0,0,1,1,4
EQQF,0,0,0,1,1,4
QQFS,0,0,0,1,1,4
QFSI,0,0,0,1,1,4
FSIR,0,0,0,1,1,4
SIRS,0,0,0,1,1,4
IRSF,0,0,0,1,1,4
RSFA,0,0,0,1,1,4
SFAT,0,0,0,1,1,4
FATQ,0,0,0,1,1,4
ATQV,0,0,0,1,1,4
TQVQ,0,0,0,1,1,4
QVQN,0,0,0,1,1,4
VQNM,0,0,0,1,1,4
ESLI,0,0,0,1,1,4
SLID,0,0,0,1,1,4
LIDM,0,0,0,1,1,4
IDMI,0,0,0,1,1,4
DMIT,0,0,0,1,1,4
MITS,0,0,0,1,1,4
ITSI,0,0,0,1,1,4
SLKD,0,0,0,2,2,4
LKDQ,0,0,0,1,1,4
KDQL,0,0,0,1,1,4
QLAL,0,0,0,1,1,4
LAIG,0,0,0,1,1,4
IGKL,0,0,0,1,1,4
GKLG,0,0,0,1,1,4
SLLP,0,0,0,1,1,4
LLPT,0,0,0,1,1,4
LPTL,0,0,0,1,1,4
PTLS,0,0,0,1,1,4
TLSA,0,0,0,1,1,4
LSAI,0,0,0,1,1,4
IAEL,0,0,0,1,1,4
PEMF,0,0,0,1,1,4
EMFD,0,0,0,1,1,4
MFDK,0,0,0,1,1,4
FDKM,0,0,0,1,1,4
DKMR,0,0,0,1,1,4
KMRP,0,0,0,1,1,4
MRPY,0,0,0,1,1,4
RPYY,0,0,0,1,1,4
PYYE,0,0,0,1,1,4
YYEE,0,0,0,1,1,4
YEES,0,0,0,1,1,4
ESKK,0,0,0,1,1,4
KRVK,0,0,0,1,1,4
SMDH,0,0,0,1,1,4
MDHR,0,0,0,1,1,4
DHRI,0,0,0,1,1,4
HRIE,0,0,0,1,1,4
RIER,0,0,0,1,1,4
ERLE,0,0,0,2,2,4
RLEY,0,0,0,1,1,4
LEYY,0,0,0,1,1,4
EYYI,0,0,0,1,1,4
YYIQ,0,0,0,1,1,4
QLLV,0,0,0,2,2,4
LLVK,0,0,0,1,1,4
SNEQ,0,0,0,1,1,4
NEQR,0,0,0,1,1,4
EQRQ,0,0,0,1,1,4
QRQD,0,0,0,1,1,4
RQDI,0,0,0,1,1,4
QDIA,0,0,0,2,2,4
DIAF,0,0,0,2,2,4
IAFA,0,0,0,1,1,4
AFAY,0,0,0,1,1,4
FAYQ,0,0,0,1,1,4
AYQR,0,0,0,1,1,4
YQRR,0,0,0,1,1,4
QRRT,0,0,0,1,1,4
RRTK,0,0,0,1,1,4
SNEV,0,0,0,1,1,4
NEVM,0,0,0,1,1,4
EVMR,0,0,0,1,1,4
VMRI,0,0,0,1,1,4
MRIL,0,0,0,1,1,4
ILIS,0,0,0,1,1,4
LISR,0,0,0,1,1,4
ISRS,0,0,0,1,1,4
SRSL,0,0,0,1,1,4
RSLL,0,0,0,1,1,4
LLQE,0,0,0,2,2,4
SNTE,0,0,0,1,1,4
NTEL,0,0,0,1,1,4
ELQA,0,0,0,1,1,4
LQAV,0,0,0,1,1,4
QAVD,0,0,0,2,2,4
AVDG,0,0,0,1,1,4
VDGR,0,0,0,1,1,4
DGRF,0,0,0,1,1,4
GRFK,0,0,0,1,1,4
RFKR,0,0,0,1,1,4
FKRA,0,0,0,1,1,4
VASM,0,0,0,1,1,4
ASME,0,0,0,1,1,4
SMEA,0,0,0,1,1,4
MEAA,0,0,0,1,1,4
EAAR,0,0,0,1,1,4
AARA,0,0,0,2,2,4
LTNN,0,0,0,1,1,4
SPAE,0,0,0,1,1,4
PAEV,0,0,0,1,1,4
AEVR,0,0,0,1,1,4
EVRD,0,0,0,1,1,4
VRDL,0,0,0,1,1,4
RDLD,0,0,0,1,1,4
DLDF,0,0,0,1,1,4
LDFA,0,0,0,1,1,4
FAND,0,0,0,1,1,4
ANDA,0,0,0,1,1,4
NDAS,0,0,0,1,1,4
DASK,0,0,0,1,1,4
ASKV,0,0,0,1,1,4
SKVL,0,0,0,1,1,4
VLGS,0,0,0,1,1,4
GSIA,0,0,0,1,1,4
SIAG,0,0,0,1,1,4
IAGK,0,0,0,1,1,4
AGKL,0,0,0,1,1,4
KLEK,0,0,0,1,1,4
SPAQ,0,0,0,1,1,4
PAQA,0,0,0,1,1,4
AQAE,0,0,0,1,1,4
LGVW,0,0,0,1,1,4
GVWR,0,0,0,1,1,4
VWRR,0,0,0,1,1,4
WRRY,0,0,0,1,1,4
RRYR,0,0,0,1,1,4
RYRA,0,0,0,1,1,4
YRAY,0,0,0,1,1,4
RAYF,0,0,0,1,1,4
AYFD,0,0,0,1,1,4
SPAV,0,0,0,2,2,4
PAVI,0,0,0,1,1,4
VIDY,0,0,0,1,1,4
IDYV,0,0,0,1,1,4
DYVN,0,0,0,1,1,4
YVNR,0,0,0,1,1,4
NRLE,0,0,0,1,1,4
LEEI,0,0,0,1,1,4
EEIR,0,0,0,1,1,4
EIRD,0,0,0,1,1,4
IRDN,0,0,0,1,1,4
RDNV,0,0,0,1,1,4
PAVQ,0,0,0,1,1,4
AVQM,0,0,0,1,1,4
VQMK,0,0,0,1,1,4
QMKI,0,0,0,1,1,4
MKIK,0,0,0,1,1,4
KELY,0,0,0,1,1,4
ELYR,0,0,0,1,1,4
LYRR,0,0,0,1,1,4
YRRR,0,0,0,1,1,4
SPEE,0,0,0,2,2,4
PEEA,0,0,0,1,1,4
EAAA,0,0,0,1,1,4
LVDG,0,0,0,1,1,4
VDGL,0,0,0,1,1,4
DGLR,0,0,0,1,1,4
PEEK,0,0,0,1,1,4
EKEE,0,0,0,1,1,4
KEEW,0,0,0,1,1,4
EEWM,0,0,0,1,1,4
EWMK,0,0,0,1,1,4
WMKS,0,0,0,1,1,4
MKSI,0,0,0,1,1,4
KSIK,0,0,0,1,1,4
SIKA,0,0,0,1,1,4
IKAS,0,0,0,1,1,4
ASIS,0,0,0,2,2,4
SPEH,0,0,0,1,1,4
PEHR,0,0,0,1,1,4
EHRQ,0,0,0,1,1,4
HRQE,0,0,0,1,1,4
QELI,0,0,0,1,1,4
SPEI,0,0,0,1,1,4
PEIA,0,0,0,1,1,4
IASG,0,0,0,1,1,4
ASGL,0,0,0,1,1,4
SGLK,0,0,0,1,1,4
GLKK,0,0,0,1,1,4
KLIR,0,0,0,1,1,4
SPEQ,0,0,0,1,1,4
PEQM,0,0,0,1,1,4
EQMQ,0,0,0,1,1,4
QMQV,0,0,0,1,1,4
QVLL,0,0,0,1,1,4
LLDQ,0,0,0,1,1,4
LDQA,0,0,0,1,1,4
DQAG,0,0,0,1,1,4
SPEV,0,0,0,1,1,4
PEVV,0,0,0,2,2,4
EVVV,0,0,0,1,1,4
VVAR,0,0,0,1,1,4
ARGE,0,0,0,1,1,4
GEQE,0,0,0,1,1,4
SPKE,0,0,0,2,2,4
PKEA,0,0,0,1,1,4
KEAY,0,0,0,1,1,4
EAYA,0,0,0,1,1,4
AYAY,0,0,0,1,1,4
YAYL,0,0,0,1,1,4
AYLE,0,0,0,1,1,4
YLEK,0,0,0,1,1,4
EKLR,0,0,0,1,1,4
KLRS,0,0,0,1,1,4
LRSI,0,0,0,1,1,4
RSII,0,0,0,1,1,4
SIIQ,0,0,0,1,1,4
IIQY,0,0,0,1,1,4
IQYT,0,0,0,1,1,4
QYTG,0,0,0,1,1,4
PKES,0,0,0,1,1,4
KESE,0,0,0,1,1,4
ESEV,0,0,0,1,1,4
SEVL,0,0,0,1,1,4
RLFA,0,0,0,1,1,4
FAEG,0,0,0,1,1,4
SPKS,0,0,0,1,1,4
PKST,0,0,0,1,1,4
KSTY,0,0,0,1,1,4
STYS,0,0,0,1,1,4
TYSY,0,0,0,1,1,4
YSYW,0,0,0,1,1,4
SYWA,0,0,0,1,1,4
YWAS,0,0,0,1,1,4
WASV,0,0,0,1,1,4
ASVL,0,0,0,1,1,4
SVLN,0,0,0,1,1,4
SPSK,0,0,0,1,1,4
PSKS,0,0,0,1,1,4
SKSL,0,0,0,1,1,4
SLQM,0,0,0,1,1,4
LQMI,0,0,0,1,1,4
QMIL,0,0,0,1,1,4
MILR,0,0,0,1,1,4
ILRR,0,0,0,1,1,4
LGDF,0,0,0,1,1,4
GDFE,0,0,0,1,1,4
DFEN,0,0,0,1,1,4
FENM,0,0,0,1,1,4
ENML,0,0,0,1,1,4
MLAD,0,0,0,1,1,4
SPVV,0,0,0,1,1,4
PVVI,0,0,0,1,1,4
VVIK,0,0,0,1,1,4
IKKR,0,0,0,1,1,4
KKRI,0,0,0,1,1,4
RIEG,0,0,0,1,1,4
IEGL,0,0,0,1,1,4
EGLI,0,0,0,1,1,4
SQES,0,0,0,1,1,4
QESI,0,0,0,1,1,4
SINQ,0,0,0,1,1,4
INQL,0,0,0,1,1,4
NQLV,0,0,0,1,1,4
QLVY,0,0,0,1,1,4
LVYM,0,0,0,1,1,4
VYMG,0,0,0,1,1,4
SQRQ,0,0,0,1,1,4
QRQR,0,0,0,1,1,4
RQRD,0,0,0,1,1,4
QRDE,0,0,0,1,1,4
DELN,0,0,0,1,1,4
ELNR,0,0,0,1,1,4
LNRA,0,0,0,1,1,4
NRAI,0,0,0,1,1,4
AIAD,0,0,0,2,2,4
IADY,0,0,0,1,1,4
ADYL,0,0,0,1,1,4
DYLR,0,0,0,1,1,4
YLRS,0,0,0,1,1,4
LRSN,0,0,0,1,1,4
SRAI,0,0,0,1,1,4
RAIT,0,0,0,1,1,4
AITQ,0,0,0,1,1,4
ITQY,0,0,0,1,1,4
TQYI,0,0,0,1,1,4
QYIA,0,0,0,1,1,4
YIAH,0,0,0,1,1,4
SRAK,0,0,0,1,1,4
RAKA,0,0,0,1,1,4
ASFD,0,0,0,1,1,4
SFDT,0,0,0,1,1,4
FDTR,0,0,0,1,1,4
DTRV,0,0,0,1,1,4
TRVA,0,0,0,1,1,4
RVAA,0,0,0,1,1,4
AELA,0,0,0,1,1,4
LALN,0,0,0,1,1,4
ALNR,0,0,0,1,1,4
SRDL,0,0,0,1,1,4
RDLQ,0,0,0,1,1,4
QEKY,0,0,0,1,1,4
KYER,0,0,0,1,1,4
YERH,0,0,0,1,1,4
ERHM,0,0,0,1,1,4
RHME,0,0,0,1,1,4
HMEK,0,0,0,1,1,4
EKLI,0,0,0,1,1,4
LIEL,0,0,0,1,1,4
IELA,0,0,0,1,1,4
ELAN,0,0,0,1,1,4
LANK,0,0,0,1,1,4
ANKE,0,0,0,1,1,4
NKEV,0,0,0,1,1,4
KEVE,0,0,0,1,1,4
EVER,0,0,0,1,1,4
VERT,0,0,0,1,1,4
SRKA,0,0,0,1,1,4
RKAL,0,0,0,1,1,4
KALT,0,0,0,1,1,4
TEGN,0,0,0,1,1,4
EGNI,0,0,0,1,1,4
GNIM,0,0,0,1,1,4
IMAV,0,0,0,1,1,4
MAVQ,0,0,0,1,1,4
VQAM,0,0,0,1,1,4
QAMA,0,0,0,1,1,4
AMAY,0,0,0,1,1,4
MAYF,0,0,0,1,1,4
AYFK,0,0,0,1,1,4
YFKE,0,0,0,1,1,4
FKEL,0,0,0,1,1,4
KELI,0,0,0,1,1,4
ELIQ,0,0,0,2,2,4
LIQK,0,0,0,1,1,4
IQKR,0,0,0,1,1,4
QKRK,0,0,0,1,1,4
RKRH,0,0,0,1,1,4
SRPL,0,0,0,1,1,4
RPLH,0,0,0,1,1,4
PLHI,0,0,0,1,1,4
LHIS,0,0,0,1,1,4
HIST,0,0,0,1,1,4
ISTF,0,0,0,1,1,4
STFI,0,0,0,1,1,4
TFIN,0,0,0,1,1,4
FINE,0,0,0,1,1,4
NELD,0,0,0,1,1,4
ELDS,0,0,0,2,2,4
LDSG,0,0,0,1,1,4
DSGF,0,0,0,1,1,4
SGFR,0,0,0,1,1,4
GFRL,0,0,0,1,1,4
FRLL,0,0,0,1,1,4
SRWG,0,0,0,1,1,4
RWGV,0,0,0,1,1,4
WGVL,0,0,0,1,1,4
GVLI,0,0,0,1,1,4
VLIL,0,0,0,1,1,4
LILV,0,0,0,1,1,4
ILVA,0,0,0,1,1,4
LVAL,0,0,0,1,1,4
SSAV,0,0,0,1,1,4
AVSR,0,0,0,1,1,4
VSRI,0,0,0,1,1,4
IISK,0,0,0,1,1,4
SKLK,0,0,0,1,1,4
KLKQ,0,0,0,1,1,4
SQNW,0,0,0,1,1,4
QNWQ,0,0,0,1,1,4
NWQR,0,0,0,1,1,4
WQRF,0,0,0,1,1,4
QRFY,0,0,0,1,1,4
RFYQ,0,0,0,1,1,4
FYQL,0,0,0,1,1,4
YQLT,0,0,0,1,1,4
QLTK,0,0,0,1,1,4
TKLL,0,0,0,1,1,4
LLDS,0,0,0,2,2,4
LDSM,0,0,0,1,1,4
DSMH,0,0,0,1,1,4
SMHE,0,0,0,1,1,4
MHEV,0,0,0,1,1,4
HEVV,0,0,0,1,1,4
EVVE,0,0,0,1,1,4
VVEN,0,0,0,1,1,4
VENL,0,0,0,1,1,4
ENLL,0,0,0,1,1,4
SSRE,0,0,0,1,1,4
SREW,0,0,0,1,1,4
REWF,0,0,0,1,1,4
EWFS,0,0,0,1,1,4
WFST,0,0,0,1,1,4
YRLF,0,0,0,1,1,4
RLFI,0,0,0,1,1,4
LFIG,0,0,0,1,1,4
STAT,0,0,0,1,1,4
TATF,0,0,0,1,1,4
ATFY,0,0,0,1,1,4
TFYD,0,0,0,1,1,4
FYDA,0,0,0,1,1,4
YDAK,0,0,0,2,2,4
DAKK,0,0,0,1,1,4
KFLI,0,0,0,1,1,4
STEV,0,0,0,1,1,4
TEVV,0,0,0,1,1,4
EVVA,0,0,0,1,1,4
VVAL,0,0,0,1,1,4
VALS,0,0,0,1,1,4
ALSR,0,0,0,1,1,4
LSRL,0,0,0,1,1,4
SRLQ,0,0,0,1,1,4
LQGS,0,0,0,1,1,4
QGSL,0,0,0,1,1,4
GSLQ,0,0,0,1,1,4
LQDM,0,0,0,1,1,4
QDML,0,0,0,1,1,4
DMLW,0,0,0,1,1,4
MLWQ,0,0,0,1,1,4
LWQL,0,0,0,1,1,4
WQLD,0,0,0,1,1,4
QLDL,0,0,0,1,1,4
LDLS,0,0,0,1,1,4
STLV,0,0,0,2,2,4
TLVQ,0,0,0,1,1,4
LVQT,0,0,0,1,1,4
VQTP,0,0,0,1,1,4
QTPA,0,0,0,1,1,4
TPAL,0,0,0,1,1,4
PALR,0,0,0,1,1,4
ALRA,0,0,0,1,1,4
RAVG,0,0,0,1,1,4
VGNI,0,0,0,1,1,4
GNIV,0,0,0,1,1,4
TLVS,0,0,0,1,1,4
LVSV,0,0,0,1,1,4
VSVA,0,0,0,1,1,4
SVAV,0,0,0,1,1,4
VAVA,0,0,0,1,1,4
AVAL,0,0,0,1,1,4
LAAY,0,0,0,2,2,4
AAYK,0,0,0,1,1,4
AYKT,0,0,0,1,1,4
YKTG,0,0,0,1,1,4
SVAD,0,0,0,1,1,4
VADH,0,0,0,1,1,4
ADHS,0,0,0,1,1,4
DHSY,0,0,0,1,1,4
HSYR,0,0,0,1,1,4
SYRV,0,0,0,1,1,4
YRVA,0,0,0,1,1,4
RVAF,0,0,0,1,1,4
VAFI,0,0,0,1,1,4
AFIT,0,0,0,1,1,4
FITL,0,0,0,1,1,4
ITLL,0,0,0,1,1,4
TLLL,0,0,0,1,1,4
LLAE,0,0,0,1,1,4
SVEG,0,0,0,1,1,4
EGLQ,0,0,0,1,1,4
GLQE,0,0,0,1,1,4
LQEF,0,0,0,2,2,4
QEFV,0,0,0,1,1,4
EFVK,0,0,0,1,1,4
FVKN,0,0,0,1,1,4
VKNL,0,0,0,1,1,4
KNLV,0,0,0,1,1,4
LVGY,0,0,0,1,1,4
VGYY,0,0,0,1,1,4
GYYI,0,0,0,1,1,4
SVEK,0,0,0,1,1,4
VEKK,0,0,0,1,1,4
EKKV,0,0,0,1,1,4
KKVP,0,0,0,1,1,4
KVPL,0,0,0,1,1,4
VPLL,0,0,0,1,1,4
PLLH,0,0,0,1,1,4
LLHN,0,0,0,1,1,4
NFHS,0,0,0,1,1,4
FHSF,0,0,0,1,1,4
HSFL,0,0,0,1,1,4
SVEV,0,0,0,1,1,4
VEVA,0,0,0,1,1,4
EVAE,0,0,0,1,1,4
VAEL,0,0,0,2,2,4
AELW,0,0,0,1,1,4
ELWS,0,0,0,1,1,4
LWST,0,0,0,1,1,4
WSTF,0,0,0,1,1,4
STFM,0,0,0,1,1,4
TFMQ,0,0,0,1,1,4
MQKW,0,0,0,1,1,4
QKWI,0,0,0,1,1,4
WIAY,0,0,0,1,1,4
IAYT,0,0,0,1,1,4
AYTA,0,0,0,1,1,4
YTAA,0,0,0,1,1,4
TAAV,0,0,0,1,1,4
VIDA,0,0,0,1,1,4
IDAE,0,0,0,1,1,4
DAER,0,0,0,1,1,4
AERD,0,0,0,1,1,4
ERDR,0,0,0,1,1,4
SVLE,0,0,0,2,2,4
VLEN,0,0,0,1,1,4
LENH,0,0,0,1,1,4
ENHH,0,0,0,1,1,4
NHHL,0,0,0,1,1,4
HHLA,0,0,0,1,1,4
HLAV,0,0,0,1,1,4
AVGF,0,0,0,1,1,4
VGFK,0,0,0,1,1,4
GFKL,0,0,0,1,1,4
VNSE,0,0,0,1,1,4
NSEI,0,0,0,1,1,4
SEIY,0,0,0,1,1,4
IYQR,0,0,0,1,1,4
YQRV,0,0,0,1,1,4
QRVM,0,0,0,1,1,4
RVME,0,0,0,1,1,4
VMES,0,0,0,1,1,4
MESF,0,0,0,1,1,4
ESFK,0,0,0,1,1,4
SFKK,0,0,0,1,1,4
FKKE,0,0,0,1,1,4
KKEG,0,0,0,1,1,4
SVPY,0,0,0,1,1,4
VPYF,0,0,0,1,1,4
PYFI,0,0,0,1,1,4
YFIE,0,0,0,1,1,4
FIEN,0,0,0,1,1,4
IENL,0,0,0,1,1,4
ENLK,0,0,0,1,1,4
NLKQ,0,0,0,1,1,4
QHIE,0,0,0,1,1,4
HIEM,0,0,0,1,1,4
IEMN,0,0,0,1,1,4
SVRK,0,0,0,1,1,4
RKVF,0,0,0,1,1,4
KVFH,0,0,0,1,1,4
VFHL,0,0,0,1,1,4
FHLV,0,0,0,1,1,4
HLVR,0,0,0,1,1,4
VRIK,0,0,0,1,1,4
RIKQ,0,0,0,1,1,4
IKQV,0,0,0,1,1,4
QVAW,0,0,0,1,1,4
VAWA,0,0,0,1,1,4
AWAN,0,0,0,1,1,4
WANE,0,0,0,1,1,4
ANEG,0,0,0,1,1,4
SVSR,0,0,0,1,1,4
SRAA,0,0,0,1,1,4
RAAI,0,0,0,1,1,4
AAIT,0,0,0,1,1,4
AITA,0,0,0,2,2,4
ITAA,0,0,0,1,1,4
TAAY,0,0,0,1,1,4
SVSS,0,0,0,1,1,4
SSIK,0,0,0,1,1,4
KQAV,0,0,0,1,1,4
AVDF,0,0,0,1,1,4
FLSN,0,0,0,1,1,4
LSNE,0,0,0,1,1,4
SVTE,0,0,0,1,1,4
VTEL,0,0,0,1,1,4
TELI,0,0,0,1,1,4
ELIT,0,0,0,1,1,4
LITK,0,0,0,1,1,4
ITKA,0,0,0,1,1,4
TKAV,0,0,0,1,1,4
KAVS,0,0,0,1,1,4
AVSA,0,0,0,1,1,4
SVTK,0,0,0,1,1,4
VTKI,0,0,0,1,1,4
TKIL,0,0,0,1,1,4
KILQ,0,0,0,1,1,4
ILQR,0,0,0,1,1,4
LQRF,0,0,0,1,1,4
QRFE,0,0,0,1,1,4
RFED,0,0,0,1,1,4
FEDA,0,0,0,2,2,4
EDAG,0,0,0,1,1,4
DAGG,0,0,0,1,1,4
SVWA,0,0,0,1,1,4
VWAS,0,0,0,1,1,4
WASI,0,0,0,1,1,4
SISS,0,0,0,1,1,4
ISSY,0,0,0,1,1,4
SYLD,0,0,0,1,1,4
LDEL,0,0,0,1,1,4
DELT,0,0,0,1,1,4
ELTE,0,0,0,1,1,4
TEGL,0,0,0,1,1,4
SWQS,0,0,0,1,1,4
WQSL,0,0,0,1,1,4
QSLK,0,0,0,1,1,4
KDRY,0,0,0,1,1,4
DRYL,0,0,0,1,1,4
RYLK,0,0,0,1,1,4
YLKH,0,0,0,1,1,4
SYKD,0,0,0,1,1,4
YKDL,0,0,0,1,1,4
KDLF,0,0,0,1,1,4
FLEL,0,0,0,1,1,4
LELY,0,0,0,1,1,4
YGKI,0,0,0,1,1,4
GKIK,0,0,0,1,1,4
KIKD,0,0,0,1,1,4
TAAQ,0,0,0,1,1,4
AAQE,0,0,0,1,1,4
AQEL,0,0,0,2,2,4
QELM,0,0,0,1,1,4
ELMI,0,0,0,1,1,4
LMIQ,0,0,0,1,1,4
MIQQ,0,0,0,1,1,4
IQQL,0,0,0,1,1,4
QQLV,0,0,0,1,1,4
QLVA,0,0,0,1,1,4
TAEQ,0,0,0,1,1,4
AEQR,0,0,0,1,1,4
EQRR,0,0,0,1,1,4
QRRE,0,0,0,1,1,4
RREM,0,0,0,1,1,4
REML,0,0,0,1,1,4
EMLE,0,0,0,1,1,4
EAKR,0,0,0,1,1,4
AKRK,0,0,0,1,1,4
KRKQ,0,0,0,1,1,4
RKQI,0,0,0,1,1,4
KQII,0,0,0,1,1,4
QIIN,0,0,0,1,1,4
IINF,0,0,0,1,1,4
INFI,0,0,0,1,1,4
NFIS,0,0,0,1,1,4
FISR,0,0,0,1,1,4
ISRN,0,0,0,1,1,4
ESFY,0,0,0,1,1,4
SFYN,0,0,0,1,1,4
FYNQ,0,0,0,1,1,4
YNQG,0,0,0,1,1,4
NQGI,0,0,0,1,1,4
QGIR,0,0,0,1,1,4
GIRL,0,0,0,1,1,4
IRLS,0,0,0,1,1,4
RLSF,0,0,0,1,1,4
LSFE,0,0,0,1,1,4
SFEQ,0,0,0,1,1,4
FEQW,0,0,0,1,1,4
EQWG,0,0,0,1,1,4
TAHE,0,0,0,1,1,4
AHEA,0,0,0,1,1,4
HEAV,0,0,0,1,1,4
AVLD,0,0,0,1,1,4
VLDF,0,0,0,1,1,4
LDFL,0,0,0,1,1,4
DFLT,0,0,0,1,1,4
FLTG,0,0,0,1,1,4
LTGR,0,0,0,1,1,4
TGRV,0,0,0,1,1,4
GRVE,0,0,0,1,1,4
RVEV,0,0,0,1,1,4
VEVF,0,0,0,1,1,4
EVFT,0,0,0,1,1,4
TAKQ,0,0,0,1,1,4
AKQI,0,0,0,2,2,4
KQIQ,0,0,0,2,2,4
QIQA,0,0,0,1,1,4
QAAY,0,0,0,1,1,4
AAYL,0,0,0,1,1,4
YLLV,0,0,0,1,1,4
LLVE,0,0,0,1,1,4
VENE,0,0,0,1,1,4
ENEL,0,0,0,1,1,4
NELM,0,0,0,1,1,4
TAPE,0,0,0,1,1,4
APEM,0,0,0,1,1,4
PEMT,0,0,0,1,1,4
EMTA,0,0,0,1,1,4
MTAL,0,0,0,1,1,4
TALV,0,0,0,1,1,4
ALVG,0,0,0,1,1,4
VGGM,0,0,0,1,1,4
GGMR,0,0,0,1,1,4
GMRV,0,0,0,1,1,4
MRVL,0,0,0,1,1,4
TDAE,0,0,0,1,1,4
DAEA,0,0,0,1,1,4
AEAK,0,0,0,1,1,4
EAKQ,0,0,0,1,1,4
AQWI,0,0,0,1,1,4
QWIL,0,0,0,1,1,4
WILS,0,0,0,1,1,4
TDKQ,0,0,0,1,1,4
DKQF,0,0,0,1,1,4
KQFE,0,0,0,1,1,4
QFEN,0,0,0,1,1,4
FENR,0,0,0,1,1,4
ENRL,0,0,0,1,1,4
NRLN,0,0,0,1,1,4
RLND,0,0,0,1,1,4
LNDN,0,0,0,1,1,4
NDNL,0,0,0,1,1,4
DNLE,0,0,0,1,1,4
NLEE,0,0,0,1,1,4
EELI,0,0,0,1,1,4
TDLE,0,0,0,1,1,4
DLEI,0,0,0,1,1,4
LEIL,0,0,0,1,1,4
ILAL,0,0,0,1,1,4
ALLI,0,0,0,1,1,4
LLIA,0,0,0,1,1,4
LIAA,0,0,0,1,1,4
AALS,0,0,0,1,1,4
DQQK,0,0,0,1,1,4
QQKV,0,0,0,1,1,4
QKVS,0,0,0,2,2,4
KVSE,0,0,0,1,1,4
VSEI,0,0,0,1,1,4
SEIF,0,0,0,1,1,4
EIFQ,0,0,0,1,1,4
FQSS,0,0,0,1,1,4
QSSK,0,0,0,1,1,4
SKEK,0,0,0,1,1,4
EKLQ,0,0,0,1,1,4
KLQG,0,0,0,1,1,4
LQGD,0,0,0,1,1,4
QGDA,0,0,0,1,1,4
GDAK,0,0,0,1,1,4
DAKV,0,0,0,1,1,4
KVVS,0,0,0,1,1,4
VVSD,0,0,0,1,1,4
VSDA,0,0,0,2,2,4
SDAF,0,0,0,1,1,4
DAFK,0,0,0,2,2,4
TEAK,0,0,0,1,1,4
AKKE,0,0,0,1,1,4
LLRK,0,0,0,1,1,4
LRKL,0,0,0,1,1,4
RKLN,0,0,0,1,1,4
NILE,0,0,0,1,1,4
ILEV,0,0,0,1,1,4
LEVF,0,0,0,1,1,4
TEEE,0,0,0,1,1,4
EEML,0,0,0,1,1,4
EMLQ,0,0,0,1,1,4
LQAA,0,0,0,1,1,4
QAAH,0,0,0,1,1,4
AAHI,0,0,0,1,1,4
AHIT,0,0,0,1,1,4
HITA,0,0,0,1,1,4
ITAK,0,0,0,1,1,4
TAKL,0,0,0,1,1,4
KLAQ,0,0,0,1,1,4
AQAA,0,0,0,1,1,4
QAAE,0,0,0,1,1,4
TEKG,0,0,0,1,1,4
EKGK,0,0,0,1,1,4
KGKE,0,0,0,1,1,4
GKEI,0,0,0,1,1,4
KEIF,0,0,0,1,1,4
EIFG,0,0,0,1,1,4
IFGE,0,0,0,1,1,4
FGEI,0,0,0,1,1,4
EILS,0,0,0,1,1,4
ILSN,0,0,0,1,1,4
LSNF,0,0,0,1,1,4
SNFE,0,0,0,1,1,4
NFES,0,0,0,1,1,4
FESL,0,0,0,1,1,4
ESLL,0,0,0,1,1,4
LKSV,0,0,0,1,1,4
VLEK,0,0,0,1,1,4
TEQD,0,0,0,1,1,4
EQDI,0,0,0,1,1,4
QDII,0,0,0,1,1,4
IIDL,0,0,0,1,1,4
IDLK,0,0,0,1,1,4
DLKF,0,0,0,1,1,4
LKFA,0,0,0,1,1,4
KFAI,0,0,0,1,1,4
FAIA,0,0,0,1,1,4
TEQN,0,0,0,1,1,4
EQNF,0,0,0,1,1,4
QNFQ,0,0,0,1,1,4
NFQL,0,0,0,1,1,4
FQLA,0,0,0,1,1,4
QLAK,0,0,0,1,1,4
QIQS,0,0,0,1,1,4
IQSQ,0,0,0,1,1,4
QSQW,0,0,0,1,1,4
SQWK,0,0,0,1,1,4
QWKE,0,0,0,1,1,4
WKEF,0,0,0,1,1,4
KEFG,0,0,0,1,1,4
TERE,0,0,0,1,1,4
REQA,0,0,0,1,1,4
EQAL,0,0,0,1,1,4
QALA,0,0,0,1,1,4
AYAE,0,0,0,1,1,4
YAEK,0,0,0,1,1,4
EKLT,0,0,0,1,1,4
KLTR,0,0,0,1,1,4
TESM,0,0,0,1,1,4
ESMK,0,0,0,1,1,4
SMKT,0,0,0,1,1,4
KTVR,0,0,0,1,1,4
TVRI,0,0,0,1,1,4
VRIR,0,0,0,1,1,4
RIRE,0,0,0,1,1,4
IREK,0,0,0,1,1,4
EKIK,0,0,0,1,1,4
KIKK,0,0,0,1,1,4
IKKF,0,0,0,1,1,4
TETQ,0,0,0,1,1,4
ETQI,0,0,0,1,1,4
TQIR,0,0,0,1,1,4
QIRE,0,0,0,1,1,4
LLFD,0,0,0,1,1,4
LFDL,0,0,0,1,1,4
FDLE,0,0,0,1,1,4
DLEL,0,0,0,1,1,4
LELA,0,0,0,1,1,4
ELAY,0,0,0,2,2,4
LAYK,0,0,0,1,1,4
YKSF,0,0,0,1,1,4
SFYA,0,0,0,1,1,4
FYAL,0,0,0,1,1,4
YALL,0,0,0,1,1,4
TEVY,0,0,0,1,1,4
EVYQ,0,0,0,1,1,4
VYQI,0,0,0,1,1,4
YQIL,0,0,0,1,1,4
QILN,0,0,0,1,1,4
ILNR,0,0,0,1,1,4
LNRV,0,0,0,1,1,4
NRVS,0,0,0,1,1,4
TFPD,0,0,0,1,1,4
FPDK,0,0,0,1,1,4
PDKA,0,0,0,1,1,4
DKAL,0,0,0,2,2,4
ALKG,0,0,0,1,1,4
LKGK,0,0,0,1,1,4
KGKK,0,0,0,1,1,4
GKKS,0,0,0,1,1,4
KKSI,0,0,0,1,1,4
KSIE,0,0,0,1,1,4
SIEN,0,0,0,1,1,4
ENIV,0,0,0,1,1,4
NIVV,0,0,0,1,1,4
TFPE,0,0,0,1,1,4
FPEW,0,0,0,1,1,4
PEWH,0,0,0,1,1,4
EWHR,0,0,0,1,1,4
WHRL,0,0,0,2,2,4
HRLY,0,0,0,1,1,4
RLYT,0,0,0,1,1,4
LYTV,0,0,0,1,1,4
YTVQ,0,0,0,1,1,4
TVQF,0,0,0,1,1,4
VQFE,0,0,0,1,1,4
QFED,0,0,0,1,1,4
EDAL,0,0,0,2,2,4
DALR,0,0,0,2,2,4
LRRH,0,0,0,1,1,4
TFPN,0,0,0,1,1,4
FPNW,0,0,0,1,1,4
PNWH,0,0,0,1,1,4
NWHR,0,0,0,1,1,4
HRLL,0,0,0,1,1,4
RLLT,0,0,0,1,1,4
LLTK,0,0,0,2,2,4
LTKQ,0,0,0,1,1,4
TKQM,0,0,0,1,1,4
QMED,0,0,0,1,1,4
MEDA,0,0,0,1,1,4
DALV,0,0,0,2,2,4
LVAK,0,0,0,1,1,4
TFSQ,0,0,0,1,1,4
FSQV,0,0,0,1,1,4
SQVL,0,0,0,1,1,4
VLDD,0,0,0,1,1,4
LDDL,0,0,0,1,1,4
DDLS,0,0,0,1,1,4
LSAR,0,0,0,2,2,4
SARF,0,0,0,1,1,4
ARFI,0,0,0,1,1,4
TGAL,0,0,0,1,1,4
GALR,0,0,0,1,1,4
LRTQ,0,0,0,1,1,4
RTQY,0,0,0,1,1,4
TQYD,0,0,0,1,1,4
QYDV,0,0,0,1,1,4
YDVS,0,0,0,1,1,4
DVSL,0,0,0,1,1,4
SLMT,0,0,0,1,1,4
LMTV,0,0,0,1,1,4
MTVK,0,0,0,1,1,4
TVKS,0,0,0,1,1,4
THAE,0,0,0,1,1,4
HAEM,0,0,0,1,1,4
AEML,0,0,0,1,1,4
EMLH,0,0,0,1,1,4
MLHA,0,0,0,1,1,4
LHAL,0,0,0,1,1,4
HALK,0,0,0,1,1,4
ALKE,0,0,0,1,1,4
LKER,0,0,0,1,1,4
KERY,0,0,0,1,1,4
THNK,0,0,0,1,1,4
HNKL,0,0,0,1,1,4
NKLL,0,0,0,1,1,4
KNVA,0,0,0,1,1,4
NVAF,0,0,0,1,1,4
VAFM,0,0,0,1,1,4
AFMK,0,0,0,1,1,4
FMKS,0,0,0,1,1,4
MKSY,0,0,0,1,1,4
SYIL,0,0,0,1,1,4
YILE,0,0,0,1,1,4
EKVK,0,0,0,1,1,4
KVKE,0,0,0,1,1,4
VKEH,0,0,0,1,1,4
KEHQ,0,0,0,1,1,4
EHQE,0,0,0,1,1,4
HQES,0,0,0,1,1,4
TIEE,0,0,0,1,1,4
IEEF,0,0,0,1,1,4
EEFH,0,0,0,1,1,4
EFHS,0,0,0,1,1,4
FHSK,0,0,0,1,1,4
HSKL,0,0,0,1,1,4
SKLQ,0,0,0,1,1,4
LQEA,0,0,0,1,1,4
QEAT,0,0,0,1,1,4
EATN,0,0,0,1,1,4
TIQS,0,0,0,1,1,4
IQSR,0,0,0,1,1,4
QSRF,0,0,0,1,1,4
SRFN,0,0,0,1,1,4
RFNY,0,0,0,1,1,4
FNYA,0,0,0,1,1,4
NYAW,0,0,0,1,1,4
YAWG,0,0,0,1,1,4
AWGL,0,0,0,1,1,4
WGLI,0,0,0,1,1,4
LIKS,0,0,0,1,1,4
TISL,0,0,0,1,1,4
ISLG,0,0,0,1,1,4
SLGV,0,0,0,1,1,4
LGVS,0,0,0,1,1,4
GVSI,0,0,0,1,1,4
SIAH,0,0,0,1,1,4
IAHV,0,0,0,1,1,4
AHVM,0,0,0,1,1,4
HVME,0,0,0,1,1,4
VMEA,0,0,0,1,1,4
MEAV,0,0,0,1,1,4
ITEM,0,0,0,1,1,4
TEMV,0,0,0,1,1,4
EMVF,0,0,0,1,1,4
MVFL,0,0,0,1,1,4
VFLA,0,0,0,1,1,4
LAEV,0,0,0,1,1,4
EVYK,0,0,0,1,1,4
VYKS,0,0,0,1,1,4
YKSG,0,0,0,1,1,4
KSGG,0,0,0,1,1,4
TIVE,0,0,0,1,1,4
IVEL,0,0,0,1,1,4
VELV,0,0,0,1,1,4
ELVV,0,0,0,1,1,4
LVVR,0,0,0,1,1,4
VVRV,0,0,0,1,1,4
VRVW,0,0,0,1,1,4
WRWF,0,0,0,1,1,4
RWFL,0,0,0,1,1,4
WFLV,0,0,0,1,1,4
FLVI,0,0,0,1,1,4
LVIW,0,0,0,1,1,4
VIWV,0,0,0,1,1,4
IWVL,0,0,0,1,1,4
WVLW,0,0,0,1,1,4
TKDE,0,0,0,2,2,4
KDEF,0,0,0,1,1,4
DEFM,0,0,0,1,1,4
EFMS,0,0,0,1,1,4
FMSG,0,0,0,1,1,4
MSGE,0,0,0,1,1,4
SGEP,0,0,0,1,1,4
GEPI,0,0,0,1,1,4
EPIF,0,0,0,1,1,4
PIFT,0,0,0,1,1,4
IFTK,0,0,0,1,1,4
FTKY,0,0,0,1,1,4
TKYF,0,0,0,1,1,4
KYFQ,0,0,0,1,1,4
YFQN,0,0,0,1,1,4
FQNL,0,0,0,1,1,4
QNLV,0,0,0,1,1,4
KDEQ,0,0,0,1,1,4
DEQV,0,0,0,1,1,4
QVEG,0,0,0,1,1,4
EGLL,0,0,0,1,1,4
GLLA,0,0,0,1,1,4
TKGE,0,0,0,1,1,4
KGER,0,0,0,1,1,4
REMI,0,0,0,1,1,4
EMIV,0,0,0,1,1,4
MIVV,0,0,0,1,1,4
IVVA,0,0,0,1,1,4
VATS,0,0,0,1,1,4
ATSA,0,0,0,1,1,4
SAAN,0,0,0,1,1,4
TKIW,0,0,0,1,1,4
KIWL,0,0,0,1,1,4
IWLN,0,0,0,1,1,4
WLNA,0,0,0,1,1,4
LNAA,0,0,0,1,1,4
NAAR,0,0,0,1,1,4
AARR,0,0,0,1,1,4
ARRT,0,0,0,1,1,4
RRTG,0,0,0,1,1,4
RTGK,0,0,0,1,1,4
TGKV,0,0,0,1,1,4
GKVP,0,0,0,1,1,4
KVPA,0,0,0,1,1,4
VPAR,0,0,0,1,1,4
PARI,0,0,0,1,1,4
ARIR,0,0,0,1,1,4
RIRK,0,0,0,1,1,4
IRKL,0,0,0,1,1,4
LDQM,0,0,0,1,1,4
DQMR,0,0,0,1,1,4
QMRS,0,0,0,1,1,4
MRSR,0,0,0,1,1,4
LAYD,0,0,0,1,1,4
AYDG,0,0,0,1,1,4
TLED,0,0,0,1,1,4
LEDY,0,0,0,1,1,4
EDYV,0,0,0,1,1,4
DYVR,0,0,0,1,1,4
YVRY,0,0,0,1,1,4
VRYV,0,0,0,1,1,4
RYVT,0,0,0,1,1,4
YVTL,0,0,0,1,1,4
VTLD,0,0,0,1,1,4
TLDM,0,0,0,1,1,4
TLIR,0,0,0,1,1,4
IREW,0,0,0,1,1,4
REWG,0,0,0,1,1,4
EWGD,0,0,0,1,1,4
WGDA,0,0,0,1,1,4
GDAV,0,0,0,1,1,4
DAVF,0,0,0,1,1,4
VFDI,0,0,0,1,1,4
FDIF,0,0,0,1,1,4
TMEG,0,0,0,1,1,4
MEGK,0,0,0,1,1,4
EGKF,0,0,0,1,1,4
KFKA,0,0,0,1,1,4
FKAV,0,0,0,1,1,4
VAED,0,0,0,1,1,4
AQRY,0,0,0,1,1,4
QRYM,0,0,0,1,1,4
RYMT,0,0,0,1,1,4
TMVQ,0,0,0,1,1,4
MVQA,0,0,0,1,1,4
QAIT,0,0,0,1,1,4
AITD,0,0,0,1,1,4
ITDA,0,0,0,1,1,4
TDAL,0,0,0,1,1,4
ALRI,0,0,0,1,1,4
LRIE,0,0,0,1,1,4
RIEL,0,0,0,1,1,4
IELK,0,0,0,1,1,4
ELKN,0,0,0,1,1,4
LKND,0,0,0,1,1,4
TNDE,0,0,0,1,1,4
NDEI,0,0,0,1,1,4
EIFS,0,0,0,1,1,4
IFSI,0,0,0,1,1,4
FSIL,0,0,0,1,1,4
SILK,0,0,0,1,1,4
TPAK,0,0,0,1,1,4
PAKA,0,0,0,1,1,4
LKSA,0,0,0,1,1,4
KSAI,0,0,0,1,1,4
SAIH,0,0,0,1,1,4
AIHV,0,0,0,1,1,4
IHVA,0,0,0,1,1,4
HVAY,0,0,0,1,1,4
VAYI,0,0,0,1,1,4
AYIL,0,0,0,1,1,4
YILK,0,0,0,1,1,4
TPDQ,0,0,0,1,1,4
PDQQ,0,0,0,1,1,4
DQQT,0,0,0,1,1,4
QQTL,0,0,0,1,1,4
QTLL,0,0,0,1,1,4
TLLH,0,0,0,1,1,4
LLHF,0,0,0,1,1,4
LHFI,0,0,0,1,1,4
HFIM,0,0,0,1,1,4
FIMD,0,0,0,1,1,4
IMDS,0,0,0,1,1,4
MDSY,0,0,0,1,1,4
DSYN,0,0,0,1,1,4
TPEE,0,0,0,2,2,4
KKHY,0,0,0,1,1,4
KHYE,0,0,0,1,1,4
HYEI,0,0,0,1,1,4
EILV,0,0,0,1,1,4
ILVE,0,0,0,1,1,4
LVED,0,0,0,1,1,4
VEDI,0,0,0,1,1,4
EDIK,0,0,0,1,1,4
IKYI,0,0,0,1,1,4
KYIE,0,0,0,1,1,4
YIES,0,0,0,1,1,4
IESG,0,0,0,1,1,4
PEEY,0,0,0,1,1,4
EEYQ,0,0,0,1,1,4
EYQT,0,0,0,1,1,4
YQTY,0,0,0,1,1,4
QTYV,0,0,0,1,1,4
TYVA,0,0,0,1,1,4
YVAQ,0,0,0,1,1,4
VAQV,0,0,0,1,1,4
AQVD,0,0,0,1,1,4
QVDK,0,0,0,1,1,4
TPEK,0,0,0,2,2,4
PEKM,0,0,0,1,1,4
EKMG,0,0,0,1,1,4
KMGE,0,0,0,1,1,4
MGEM,0,0,0,1,1,4
GEMA,0,0,0,1,1,4
EMAQ,0,0,0,1,1,4
MAQK,0,0,0,1,1,4
AQKF,0,0,0,1,1,4
QKFR,0,0,0,1,1,4
KFRE,0,0,0,1,1,4
PEKR,0,0,0,1,1,4
EKRV,0,0,0,1,1,4
KRVD,0,0,0,1,1,4
RVDR,0,0,0,1,1,4
VDRI,0,0,0,1,1,4
DRIF,0,0,0,1,1,4
RIFA,0,0,0,1,1,4
IFAM,0,0,0,1,1,4
FAMM,0,0,0,1,1,4
AMMD,0,0,0,1,1,4
TPER,0,0,0,1,1,4
PERL,0,0,0,1,1,4
RLEK,0,0,0,1,1,4
EKLV,0,0,0,1,1,4
LVKE,0,0,0,1,1,4
VKEV,0,0,0,1,1,4
TPET,0,0,0,1,1,4
PETI,0,0,0,1,1,4
TITH,0,0,0,1,1,4
ITHY,0,0,0,1,1,4
THYL,0,0,0,1,1,4
HYLE,0,0,0,1,1,4
YLET,0,0,0,1,1,4
LETV,0,0,0,1,1,4
ETVN,0,0,0,1,1,4
TVNH,0,0,0,1,1,4
VNHA,0,0,0,1,1,4
NHAM,0,0,0,1,1,4
TPEV,0,0,0,1,1,4
VVKE,0,0,0,1,1,4
VKER,0,0,0,1,1,4
RLLS,0,0,0,1,1,4
TPLG,0,0,0,1,1,4
PLGI,0,0,0,1,1,4
LGIG,0,0,0,1,1,4
GIGI,0,0,0,1,1,4
IGIT,0,0,0,1,1,4
GITD,0,0,0,1,1,4
ITDY,0,0,0,1,1,4
TDYY,0,0,0,1,1,4
DYYI,0,0,0,1,1,4
YYIR,0,0,0,1,1,4
TPQD,0,0,0,1,1,4
PQDI,0,0,0,1,1,4
DIAD,0,0,0,1,1,4
IADR,0,0,0,1,1,4
ADRE,0,0,0,1,1,4
DRER,0,0,0,1,1,4
ERIF,0,0,0,1,1,4
RIFK,0,0,0,1,1,4
IFKR,0,0,0,1,1,4
FKRF,0,0,0,1,1,4
KRFD,0,0,0,1,1,4
TPSD,0,0,0,1,1,4
PSDI,0,0,0,1,1,4
DIKE,0,0,0,1,1,4
KELR,0,0,0,1,1,4
ELRD,0,0,0,1,1,4
LRDA,0,0,0,1,1,4
RDAM,0,0,0,1,1,4
DAMA,0,0,0,1,1,4
AMAK,0,0,0,1,1,4
MAKV,0,0,0,1,1,4
AKVQ,0,0,0,1,1,4
KVQA,0,0,0,1,1,4
VQAD,0,0,0,1,1,4
TPVY,0,0,0,1,1,4
PVYR,0,0,0,1,1,4
VYRT,0,0,0,1,1,4
YRTA,0,0,0,1,1,4
RTAI,0,0,0,1,1,4
TAIR,0,0,0,1,1,4
AIRY,0,0,0,1,1,4
IRYY,0,0,0,1,1,4
RYYL,0,0,0,1,1,4
YYLQ,0,0,0,1,1,4
YLQM,0,0,0,1,1,4
QMLF,0,0,0,1,1,4
TPWS,0,0,0,1,1,4
PWSK,0,0,0,1,1,4
WSKG,0,0,0,1,1,4
SKGF,0,0,0,1,1,4
GFLA,0,0,0,1,1,4
FLAS,0,0,0,1,1,4
LASS,0,0,0,1,1,4
ASSY,0,0,0,1,1,4
SSYA,0,0,0,1,1,4
SYAS,0,0,0,1,1,4
YASR,0,0,0,1,1,4
TPYD,0,0,0,1,1,4
PYDA,0,0,0,1,1,4
DAKG,0,0,0,1,1,4
AKGL,0,0,0,1,1,4
KGLL,0,0,0,1,1,4
ISAI,0,0,0,1,1,4
AIRD,0,0,0,1,1,4
TQAQ,0,0,0,1,1,4
QAQE,0,0,0,1,1,4
AQET,0,0,0,1,1,4
QETQ,0,0,0,1,1,4
ETQG,0,0,0,1,1,4
TQGQ,0,0,0,1,1,4
QGQA,0,0,0,1,1,4
GQAA,0,0,0,1,1,4
QAAA,0,0,0,1,1,4
ARAA,0,0,0,1,1,4
AAAD,0,0,0,1,1,4
AADL,0,0,0,1,1,4
ADLA,0,0,0,1,1,4
LAAG,0,0,0,1,1,4
TQDL,0,0,0,1,1,4
QDLR,0,0,0,1,1,4
DLRS,0,0,0,1,1,4
LRSH,0,0,0,1,1,4
RSHL,0,0,0,1,1,4
SHLV,0,0,0,1,1,4
HLVH,0,0,0,1,1,4
HKLV,0,0,0,1,1,4
KLVQ,0,0,0,1,1,4
QAIF,0,0,0,1,1,4
TQGL,0,0,0,1,1,4
QGLL,0,0,0,1,1,4
GLLS,0,0,0,1,1,4
LLSE,0,0,0,1,1,4
LSEI,0,0,0,1,1,4
ILRK,0,0,0,1,1,4
TQGM,0,0,0,1,1,4
QGMQ,0,0,0,1,1,4
GMQN,0,0,0,1,1,4
MQNA,0,0,0,1,1,4
QNAM,0,0,0,1,1,4
NAMG,0,0,0,1,1,4
AMGE,0,0,0,1,1,4
MGER,0,0,0,1,1,4
ERFA,0,0,0,1,1,4
RFAQ,0,0,0,1,1,4
FAQY,0,0,0,1,1,4
AQYA,0,0,0,1,1,4
YALS,0,0,0,1,1,4
ALSS,0,0,0,1,1,4
LSSE,0,0,0,1,1,4
SSEK,0,0,0,1,1,4
SEKL,0,0,0,1,1,4
EKLY,0,0,0,1,1,4
TQSD,0,0,0,1,1,4
QSDV,0,0,0,1,1,4
SDVY,0,0,0,1,1,4
DVYA,0,0,0,1,1,4
VYAM,0,0,0,1,1,4
YAMV,0,0,0,1,1,4
AMVG,0,0,0,1,1,4
MVGY,0,0,0,1,1,4
VGYI,0,0,0,1,1,4
GYIH,0,0,0,1,1,4
YIHE,0,0,0,1,1,4
HELW,0,0,0,1,1,4
TREL,0,0,0,1,1,4
RELA,0,0,0,1,1,4
LAYM,0,0,0,1,1,4
AYMI,0,0,0,1,1,4
YMIK,0,0,0,1,1,4
MIKK,0,0,0,1,1,4
TRTQ,0,0,0,1,1,4
RTQR,0,0,0,1,1,4
TQRR,0,0,0,1,1,4
RRIA,0,0,0,1,1,4
RIAV,0,0,0,1,1,4
IAVV,0,0,0,1,1,4
AVVE,0,0,0,1,1,4
VVEF,0,0,0,1,1,4
VEFI,0,0,0,1,1,4
EFIF,0,0,0,1,1,4
FIFS,0,0,0,1,1,4
IFSL,0,0,0,1,1,4
FSLL,0,0,0,1,1,4
TSAQ,0,0,0,2,2,4
SAQT,0,0,0,1,1,4
AQTK,0,0,0,1,1,4
QTKV,0,0,0,1,1,4
TKVV,0,0,0,1,1,4
KVVV,0,0,0,1,1,4
VVVD,0,0,0,1,1,4
VVDA,0,0,0,1,1,4
SFDE,0,0,0,1,1,4
FDEY,0,0,0,1,1,4
DEYV,0,0,0,1,1,4
EYVA,0,0,0,1,1,4
AELD,0,0,0,1,1,4
LDSK,0,0,0,1,1,4
TSHL,0,0,0,1,1,4
SHLM,0,0,0,1,1,4
HLMG,0,0,0,1,1,4
LMGM,0,0,0,1,1,4
MGMF,0,0,0,1,1,4
GMFY,0,0,0,1,1,4
MFYR,0,0,0,1,1,4
FYRT,0,0,0,1,1,4
YRTI,0,0,0,1,1,4
RTIR,0,0,0,1,1,4
TIRM,0,0,0,1,1,4
IRMM,0,0,0,1,1,4
RMME,0,0,0,1,1,4
MMEN,0,0,0,1,1,4
TTDE,0,0,0,1,1,4
TDEI,0,0,0,1,1,4
DEIN,0,0,0,1,1,4
EINA,0,0,0,1,1,4
INAM,0,0,0,1,1,4
NAMD,0,0,0,1,1,4
AMDK,0,0,0,1,1,4
MDKA,0,0,0,1,1,4
KALI,0,0,0,1,1,4
ALIL,0,0,0,1,1,4
LILY,0,0,0,1,1,4
ILYT,0,0,0,1,1,4
TTGN,0,0,0,1,1,4
GNFE,0,0,0,1,1,4
NFEK,0,0,0,1,1,4
KLFV,0,0,0,1,1,4
LFVA,0,0,0,1,1,4
FVAL,0,0,0,1,1,4
VALV,0,0,0,1,1,4
ALVE,0,0,0,1,1,4
LVEY,0,0,0,1,1,4
VEYM,0,0,0,1,1,4
EYMR,0,0,0,1,1,4
YMRA,0,0,0,1,1,4
MRAS,0,0,0,1,1,4
TVEE,0,0,0,1,1,4
VEEV,0,0,0,1,1,4
EEVN,0,0,0,1,1,4
EVNA,0,0,0,1,1,4
VNAL,0,0,0,1,1,4
LKNE,0,0,0,1,1,4
KNEI,0,0,0,1,1,4
NEIL,0,0,0,1,1,4
EILK,0,0,0,1,1,4
LKAH,0,0,0,1,1,4
KAHA,0,0,0,1,1,4
TVFG,0,0,0,1,1,4
VFGT,0,0,0,1,1,4
FGTA,0,0,0,1,1,4
GTAL,0,0,0,1,1,4
TALN,0,0,0,1,1,4
ALNY,0,0,0,1,1,4
LNYV,0,0,0,1,1,4
NYVS,0,0,0,1,1,4
YVSL,0,0,0,1,1,4
VSLR,0,0,0,1,1,4
SLRI,0,0,0,1,1,4
TVLA,0,0,0,1,1,4
ALFL,0,0,0,1,1,4
LAGS,0,0,0,1,1,4
TYYA,0,0,0,1,1,4
YYAK,0,0,0,1,1,4
YAKD,0,0,0,1,1,4
AKDI,0,0,0,1,1,4
KDIA,0,0,0,1,1,4
IAFQ,0,0,0,1,1,4
AFQF,0,0,0,1,1,4
FQFW,0,0,0,1,1,4
QFWK,0,0,0,1,1,4
FWKM,0,0,0,1,1,4
VADI,0,0,0,1,1,4
ADIA,0,0,0,1,1,4
IAKL,0,0,0,1,1,4
KLKV,0,0,0,1,1,4
LKVN,0,0,0,1,1,4
KVNI,0,0,0,1,1,4
NIIK,0,0,0,1,1,4
IIKN,0,0,0,1,1,4
NVRI,0,0,0,1,1,4
VRII,0,0,0,1,1,4
VADP,0,0,0,1,1,4
ADPV,0,0,0,1,1,4
DPVA,0,0,0,1,1,4
PVAA,0,0,0,1,1,4
VAAF,0,0,0,1,1,4
AAFK,0,0,0,1,1,4
AFKW,0,0,0,1,1,4
FKWR,0,0,0,1,1,4
KWRA,0,0,0,1,1,4
WRAQ,0,0,0,1,1,4
VDDN,0,0,0,1,1,4
DDNL,0,0,0,1,1,4
NLYP,0,0,0,1,1,4
LYPQ,0,0,0,1,1,4
YPQL,0,0,0,1,1,4
PQLE,0,0,0,1,1,4
ERAS,0,0,0,1,1,4
RASR,0,0,0,1,1,4
KIFE,0,0,0,1,1,4
IFEF,0,0,0,1,1,4
FEFL,0,0,0,1,1,4
EFLE,0,0,0,1,1,4
VEAI,0,0,0,1,1,4
LKGN,0,0,0,1,1,4
VFWP,0,0,0,1,1,4
FWPT,0,0,0,1,1,4
WPTM,0,0,0,1,1,4
PTML,0,0,0,1,1,4
TMLK,0,0,0,1,1,4
MLKA,0,0,0,1,1,4
VGVL,0,0,0,1,1,4
LQLL,0,0,0,1,1,4
VGYE,0,0,0,1,1,4
GYET,0,0,0,1,1,4
YETA,0,0,0,1,1,4
ETAA,0,0,0,1,1,4
KLAR,0,0,0,1,1,4
AREA,0,0,0,1,1,4
VHVL,0,0,0,1,1,4
HVLA,0,0,0,1,1,4
ADAF,0,0,0,1,1,4
FKRY,0,0,0,1,1,4
KRYL,0,0,0,1,1,4
RYLL,0,0,0,1,1,4
VIDP,0,0,0,1,1,4
IDPL,0,0,0,1,1,4
DPLH,0,0,0,1,1,4
PLHT,0,0,0,1,1,4
LHTH,0,0,0,1,1,4
HTHL,0,0,0,1,1,4
THLT,0,0,0,1,1,4
HLTR,0,0,0,1,1,4
TRLV,0,0,0,1,1,4
RLVA,0,0,0,1,1,4
VAAY,0,0,0,1,1,4
AAYT,0,0,0,1,1,4
AYTG,0,0,0,1,1,4
VKYA,0,0,0,1,1,4
KYAV,0,0,0,1,1,4
YAVF,0,0,0,1,1,4
VFEA,0,0,0,1,1,4
EAAL,0,0,0,1,1,4
AALT,0,0,0,1,1,4
LTKA,0,0,0,1,1,4
TKAI,0,0,0,1,1,4
KAIT,0,0,0,1,1,4
ITAM,0,0,0,1,1,4
TAMS,0,0,0,1,1,4
AMSE,0,0,0,1,1,4
MSEV,0,0,0,1,1,4
SEVQ,0,0,0,1,1,4
KVSQ,0,0,0,1,1,4
VLSF,0,0,0,1,1,4
LSFK,0,0,0,1,1,4
SFKT,0,0,0,1,1,4
FKTG,0,0,0,1,1,4
KTGI,0,0,0,1,1,4
TGII,0,0,0,1,1,4
GIIS,0,0,0,1,1,4
IISL,0,0,0,1,1,4
VMEL,0,0,0,1,1,4
LTKT,0,0,0,1,1,4
TKTL,0,0,0,1,1,4
KTLG,0,0,0,1,1,4
TLGW,0,0,0,1,1,4
LGWD,0,0,0,1,1,4
GWDI,0,0,0,1,1,4
WDIQ,0,0,0,1,1,4
DIQE,0,0,0,1,1,4
ELNK,0,0,0,1,1,4
LNKL,0,0,0,1,1,4
NKLT,0,0,0,1,1,4
VMGQ,0,0,0,1,1,4
MGQN,0,0,0,1,1,4
GQNL,0,0,0,1,1,4
QNLI,0,0,0,1,1,4
NLIL,0,0,0,1,1,4
LILN,0,0,0,1,1,4
ILNM,0,0,0,1,1,4
LNMN,0,0,0,1,1,4
NMND,0,0,0,1,1,4
VMPS,0,0,0,1,1,4
MPSL,0,0,0,1,1,4
PSLL,0,0,0,1,1,4
LQAF,0,0,0,1,1,4
QAFD,0,0,0,1,1,4
AFDL,0,0,0,1,1,4
FDLT,0,0,0,1,1,4
DLTA,0,0,0,1,1,4
VMQW,0,0,0,1,1,4
MQWV,0,0,0,1,1,4
QWVI,0,0,0,1,1,4
WVIR,0,0,0,1,1,4
VIRI,0,0,0,1,1,4
IRIL,0,0,0,1,1,4
RILG,0,0,0,1,1,4
ILGG,0,0,0,1,1,4
LGGG,0,0,0,1,1,4
GGGL,0,0,0,1,1,4
GGLQ,0,0,0,1,1,4
GLQK,0,0,0,1,1,4
LQKA,0,0,0,1,1,4
QKAL,0,0,0,1,1,4
NFLV,0,0,0,1,1,4
FLVA,0,0,0,1,1,4
VADA,0,0,0,1,1,4
KQHR,0,0,0,1,1,4
QHRH,0,0,0,1,1,4
HRHR,0,0,0,1,1,4
RHRR,0,0,0,1,1,4
HRRD,0,0,0,1,1,4
RRDD,0,0,0,1,1,4
RDDV,0,0,0,1,1,4
DDVI,0,0,0,1,1,4
DVIV,0,0,0,1,1,4
VIVM,0,0,0,1,1,4
IVML,0,0,0,1,1,4
VMLS,0,0,0,1,1,4
MLSA,0,0,0,1,1,4
VNQF,0,0,0,1,1,4
NQFL,0,0,0,1,1,4
FLDY,0,0,0,1,1,4
LDYL,0,0,0,1,1,4
DYLQ,0,0,0,1,1,4
YLQE,0,0,0,1,1,4
QEFL,0,0,0,1,1,4
EFLG,0,0,0,2,2,4
FLGV,0,0,0,1,1,4
LGVM,0,0,0,1,1,4
GVMN,0,0,0,1,1,4
VMNT,0,0,0,1,1,4
VPMQ,0,0,0,1,1,4
PMQR,0,0,0,1,1,4
MQRV,0,0,0,1,1,4
QRVL,0,0,0,1,1,4
RVLK,0,0,0,1,1,4
VLKY,0,0,0,1,1,4
LKYH,0,0,0,1,1,4
KYHL,0,0,0,1,1,4
YHLL,0,0,0,1,1,4
LLLQ,0,0,0,1,1,4
LQEL,0,0,0,1,1,4
QELV,0,0,0,1,1,4
ELVK,0,0,0,1,1,4
QEVN,0,0,0,1,1,4
VNRF,0,0,0,1,1,4
NRFI,0,0,0,1,1,4
RFIK,0,0,0,1,1,4
FIKA,0,0,0,1,1,4
FEEM,0,0,0,1,1,4
EEMK,0,0,0,1,1,4
EMKA,0,0,0,1,1,4
MKAL,0,0,0,1,1,4
KALM,0,0,0,1,1,4
ALMK,0,0,0,1,1,4
LMKS,0,0,0,1,1,4
MKSL,0,0,0,1,1,4
SDAR,0,0,0,1,1,4
DARS,0,0,0,1,1,4
ARSA,0,0,0,1,1,4
SAIT,0,0,0,1,1,4
AITS,0,0,0,1,1,4
SAQE,0,0,0,1,1,4
VWHY,0,0,0,1,1,4
WHYA,0,0,0,1,1,4
HYAL,0,0,0,1,1,4
YALW,0,0,0,1,1,4
ALWS,0,0,0,1,1,4
LWSL,0,0,0,1,1,4
WSLI,0,0,0,1,1,4
SLIQ,0,0,0,1,1,4
IQQS,0,0,0,1,1,4
QQSE,0,0,0,1,1,4
EILF,0,0,0,1,1,4
ILFA,0,0,0,1,1,4
LFAQ,0,0,0,1,1,4
VYGP,0,0,0,1,1,4
YGPF,0,0,0,1,1,4
GPFW,0,0,0,1,1,4
PFWK,0,0,0,1,1,4
FWKN,0,0,0,1,1,4
WKNW,0,0,0,1,1,4
KNWQ,0,0,0,1,1,4
NWQA,0,0,0,1,1,4
WATL,0,0,0,1,1,4
ATLL,0,0,0,1,1,4
TLLA,0,0,0,1,1,4
AQWA,0,0,0,1,1,4
QWAD,0,0,0,1,1,4
WADR,0,0,0,1,1,4
ADRA,0,0,0,1,1,4
DRAL,0,0,0,1,1,4
WDDI,0,0,0,1,1,4
DDIR,0,0,0,1,1,4
DIRN,0,0,0,1,1,4
IRND,0,0,0,1,1,4
RNDL,0,0,0,1,1,4
NDLF,0,0,0,2,2,4
DLFR,0,0,0,1,1,4
LFRI,0,0,0,1,1,4
FRIQ,0,0,0,1,1,4
RIQN,0,0,0,1,1,4
IQND,0,0,0,1,1,4
QNDL,0,0,0,1,1,4
DLFV,0,0,0,1,1,4
FVLG,0,0,0,1,1,4
LGED,0,0,0,1,1,4
GEDV,0,0,0,1,1,4
EDVS,0,0,0,1,1,4
DVST,0,0,0,1,1,4
YAKG,0,0,0,1,1,4
AKGA,0,0,0,1,1,4
KGAL,0,0,0,1,1,4
GALQ,0,0,0,1,1,4
ALQY,0,0,0,1,1,4
LQYL,0,0,0,1,1,4
QYLV,0,0,0,1,1,4
YLVP,0,0,0,1,1,4
LVPI,0,0,0,1,1,4
VPIL,0,0,0,1,1,4
PILT,0,0,0,1,1,4
ILTQ,0,0,0,1,1,4
LTQT,0,0,0,1,1,4
TQTL,0,0,0,1,1,4
YDDI,0,0,0,1,1,4
DDII,0,0,0,1,1,4
IEAA,0,0,0,1,1,4
AAGE,0,0,0,1,1,4
AGEL,0,0,0,1,1,4
GELG,0,0,0,1,1,4
YDLL,0,0,0,1,1,4
DLLK,0,0,0,1,1,4
LKDL,0,0,0,1,1,4
KDLE,0,0,0,1,1,4
DLEE,0,0,0,1,1,4
LEEG,0,0,0,1,1,4
EGIQ,0,0,0,1,1,4
GIQT,0,0,0,1,1,4
QTLM,0,0,0,1,1,4
TLMG,0,0,0,1,1,4
LMGR,0,0,0,1,1,4
MGRL,0,0,0,1,1,4
YEDK,0,0,0,1,1,4
EDKA,0,0,0,1,1,4
DKAV,0,0,0,1,1,4
KAVE,0,0,0,1,1,4
AVEL,0,0,0,1,1,4
VELY,0,0,0,1,1,4
LYSR,0,0,0,1,1,4
YSRT,0,0,0,1,1,4
SRTA,0,0,0,1,1,4
RTAR,0,0,0,1,1,4
TLEF,0,0,0,1,1,4
LEFL,0,0,0,1,1,4
FLGD,0,0,0,1,1,4
LGDA,0,0,0,1,1,4
GDAL,0,0,0,1,1,4
ALVN,0,0,0,1,1,4
LVNF,0,0,0,1,1,4
VNFF,0,0,0,1,1,4
NFFI,0,0,0,1,1,4
FFIV,0,0,0,1,1,4
FIVD,0,0,0,1,1,4
IVDL,0,0,0,1,1,4
VDLL,0,0,0,1,1,4
DLLV,0,0,0,1,1,4
LVQY,0,0,0,1,1,4
VQYS,0,0,0,1,1,4
YFSK,0,0,0,1,1,4
FSKG,0,0,0,1,1,4
SKGI,0,0,0,1,1,4
KGIP,0,0,0,1,1,4
GIPN,0,0,0,1,1,4
IPNV,0,0,0,1,1,4
PNVL,0,0,0,1,1,4
VLRR,0,0,0,1,1,4
YGSI,0,0,0,1,1,4
GSIG,0,0,0,1,1,4
IGLT,0,0,0,1,1,4
GLTN,0,0,0,1,1,4
TNFG,0,0,0,1,1,4
NFGY,0,0,0,1,1,4
FGYL,0,0,0,1,1,4
YLDK,0,0,0,2,2,4
LDKE,0,0,0,2,2,4
YKEP,0,0,0,1,1,4
KEPL,0,0,0,1,1,4
EPLK,0,0,0,1,1,4
LKAV,0,0,0,1,1,4
KAVV,0,0,0,1,1,4
VVKK,0,0,0,1,1,4
VKKL,0,0,0,1,1,4
KLLE,0,0,0,1,1,4
LEKE,0,0,0,1,1,4
YKKF,0,0,0,1,1,4
KKFR,0,0,0,1,1,4
KFRQ,0,0,0,1,1,4
FRQL,0,0,0,1,1,4
RQLI,0,0,0,1,1,4
QLIQ,0,0,0,1,1,4
LIQV,0,0,0,1,1,4
IQVN,0,0,0,1,1,4
YLAD,0,0,0,1,1,4
FLAP,0,0,0,1,1,4
LAPQ,0,0,0,1,1,4
APQI,0,0,0,1,1,4
PQIH,0,0,0,1,1,4
IHGA,0,0,0,1,1,4
HGAI,0,0,0,1,1,4
GAIN,0,0,0,1,1,4
AINR,0,0,0,1,1,4
INRF,0,0,0,1,1,4
NRFQ,0,0,0,1,1,4
DKEV,0,0,0,1,1,4
KEVK,0,0,0,1,1,4
EVKL,0,0,0,1,1,4
IKKM,0,0,0,1,1,4
KKMG,0,0,0,1,1,4
KMGN,0,0,0,1,1,4
MGNH,0,0,0,1,1,4
GNHL,0,0,0,1,1,4
NHLT,0,0,0,1,1,4
HLTN,0,0,0,1,1,4
LTNL,0,0,0,1,1,4
TNLR,0,0,0,1,1,4
NLRR,0,0,0,1,1,4
RRVA,0,0,0,1,1,4
YLSE,0,0,0,1,1,4
LSES,0,0,0,1,1,4
SESV,0,0,0,1,1,4
ESVE,0,0,0,1,1,4
SVET,0,0,0,1,1,4
VETI,0,0,0,1,1,4
ETIK,0,0,0,1,1,4
TIKK,0,0,0,1,1,4
KLGD,0,0,0,1,1,4
LGDH,0,0,0,1,1,4
GDHI,0,0,0,1,1,4
DHIT,0,0,0,1,1,4
HITS,0,0,0,1,1,4
ITSL,0,0,0,1,1,4
TSLK,0,0,0,1,1,4
KKLW,0,0,0,1,1,4
YPIV,0,0,0,1,1,4
PIVD,0,0,0,1,1,4
IVDA,0,0,0,1,1,4
VDAA,0,0,0,1,1,4
DAAM,0,0,0,1,1,4
AAMR,0,0,0,1,1,4
AMRQ,0,0,0,1,1,4
MRQL,0,0,0,1,1,4
RQLT,0,0,0,1,1,4
QLTE,0,0,0,1,1,4
LTET,0,0,0,1,1,4
TETG,0,0,0,1,1,4
YQNI,0,0,0,1,1,4
QNIV,0,0,0,1,1,4
VKAV,0,0,0,1,1,4
KAVQ,0,0,0,1,1,4
AVQY,0,0,0,1,1,4
VQYA,0,0,0,1,1,4
QYAA,0,0,0,1,1,4
YAAR,0,0,0,1,1,4
AARK,0,0,0,1,1,4
ARKL,0,0,0,1,1,4
RKLQ,0,0,0,1,1,4
YQQQ,0,0,0,1,1,4
QQQK,0,0,0,1,1,4
QQKK,0,0,0,1,1,4
QKKY,0,0,0,1,1,4
KYLG,0,0,0,1,1,4
YLGR,0,0,0,1,1,4
LGRM,0,0,0,1,1,4
GRMT,0,0,0,1,1,4
RMTE,0,0,0,1,1,4
AIGKF,0,1,0,0,1,5
IGKFL,4,6,1,0,11,5
GKFLH,3,6,0,0,9,5
KFLHS,0,6,1,0,7,5
FLHSA,0,7,1,0,8,5
LHSAK,0,6,1,0,7,5
HSAKK,0,6,1,0,7,5
SAKKF,0,6,1,0,7,5
AKKFG,0,2,1,0,3,5
KKFGK,0,2,1,0,3,5
KFGKA,0,2,1,0,3,5
FGKAF,0,2,1,0,3,5
GKAFV,0,2,1,0,3,5
KAFVG,0,2,0,0,2,5
AFVGE,0,2,0,0,2,5
FVGEI,0,2,0,0,2,5
VGEIM,0,2,0,0,2,5
GEIMN,0,2,0,0,2,5
EIMNS,0,4,0,0,4,5
FAKAL,0,2,0,0,2,5
AKALA,0,1,0,0,1,5
KALAK,0,1,1,0,2,5
ALAKL,0,2,1,0,3,5
LAKLA,3,13,17,0,33,5
AKLAK,2,9,17,0,28,5
KLAKK,3,23,29,0,55,5
LAKKL,2,17,16,1,36,5
AKKLL,1,3,3,1,8,5
AKALK,1,5,3,1,10,5
KALKA,0,4,1,0,5,5
ALKAL,0,11,5,0,16,5
LKALL,0,1,1,0,2,5
KALLK,0,1,1,0,2,5
ALLKA,0,1,2,0,3,5
LLKAL,0,1,2,0,3,5
LKALK,0,7,6,0,13,5
FAKFL,0,1,0,0,1,5
AKFLA,0,1,0,0,1,5
KFLAK,0,1,0,0,1,5
FLAKF,0,1,0,0,1,5
LAKFL,0,2,0,0,2,5
AKFLK,0,2,0,0,2,5
KFLKK,1,2,1,1,5,5
FLKKA,1,2,1,0,4,5
LKKAL,0,12,10,0,22,5
FAKII,0,0,1,0,1,5
AKIIA,0,0,1,0,1,5
KIIAK,0,0,1,0,1,5
IIAKI,0,0,1,0,1,5
IAKIA,0,0,2,0,2,5
AKIAK,0,0,2,0,2,5
KIAKI,0,0,1,0,1,5
KIAKK,0,0,1,0,1,5
IAKKI,0,0,1,0,1,5
AKKIL,0,0,2,0,2,5
FAKKF,0,3,0,0,3,5
AKKFA,1,4,2,0,7,5
KKFAK,1,7,0,0,8,5
KFAKK,0,4,0,1,5,5
AKKFK,0,1,0,0,1,5
KKFKK,0,1,0,0,1,5
KFKKF,0,1,0,0,1,5
FKKFA,0,3,0,0,3,5
KFAKF,0,1,0,0,1,5
FAKFA,0,1,0,0,1,5
AKFAF,0,1,0,0,1,5
KFAFA,0,1,0,0,1,5
FAFAF,0,1,0,0,1,5
FAKKL,0,9,13,0,22,5
AKKLA,2,14,17,0,33,5
KKLAK,2,23,23,0,48,5
KLAKA,0,1,3,0,4,5
LAKAA,0,0,1,0,1,5
AKAAL,0,0,1,0,1,5
LAKAL,1,4,4,0,9,5
KLAKL,2,10,10,0,22,5
AKLAL,1,4,3,0,8,5
LAKLL,0,0,3,0,3,5
AKKLK,0,6,5,0,11,5
KKLKK,0,10,7,1,18,5
KLKKL,0,7,5,0,12,5
LKKLA,1,10,6,0,17,5
LAKKW,0,1,0,0,1,5
AKKWK,0,1,0,0,1,5
KKWKL,0,1,0,0,1,5
KLALA,0,2,2,0,4,5
LALAL,0,2,1,0,3,5
ALALK,0,7,5,0,12,5
LALKA,0,6,5,0,11,5
LKALA,0,1,0,0,1,5
KALAL,0,1,2,0,3,5
AKKLI,0,1,0,0,1,5
KKLIG,0,1,0,0,1,5
KLIGA,0,1,0,0,1,5
LIGAV,0,1,0,0,1,5
IGAVL,1,4,0,0,5,5
GAVLK,1,4,0,0,5,5
AVLKV,1,4,0,0,5,5
LALAK,0,0,1,0,1,5
LAKKA,0,4,7,0,11,5
AKKAL,0,3,5,0,8,5
KKALA,0,0,3,0,3,5
KKLLA,0,1,1,0,2,5
KLLAL,0,1,0,0,1,5
KLALK,0,1,2,0,3,5
LALKL,0,1,2,0,3,5
ALKLA,0,1,2,0,3,5
LKLAK,0,1,1,0,2,5
KLLAK,2,6,13,0,21,5
LLAKA,1,3,3,0,7,5
KALKL,0,0,2,0,2,5
FAKLA,0,0,2,0,2,5
FAKLF,0,0,2,0,2,5
AKLFA,0,0,1,0,1,5
KLFAK,1,0,1,0,2,5
LFAKL,0,0,1,0,1,5
LAKKF,5,0,2,0,7,5
KKFAL,0,1,2,0,3,5
FAKLL,2,5,13,0,20,5
AKLLA,2,6,12,0,20,5
KALKK,1,14,12,0,27,5
ALKKA,0,6,7,0,13,5
ALKKF,0,2,0,0,2,5
LKKFA,0,1,0,0,1,5
LKKFL,0,1,0,0,1,5
ALKKL,1,7,5,0,13,5
LKKLL,1,1,0,0,2,5
ALKLK,0,0,1,0,1,5
LKLKL,0,0,1,0,1,5
LLAKF,0,1,0,0,1,5
LLAKL,1,2,10,0,13,5
LAKAK,0,0,1,0,1,5
AKAKL,0,1,1,0,2,5
AKKAA,0,0,1,0,1,5
LAKKG,0,0,1,0,1,5
AKKGL,0,0,1,0,1,5
LAKKI,0,0,1,0,1,5
LAKKS,0,0,1,0,1,5
AKKSL,0,0,1,0,1,5
LAKKV,0,1,1,0,2,5
AKKVL,0,1,1,0,2,5
LAKLK,0,0,1,0,1,5
AKLKL,0,0,1,0,1,5
AKLLF,0,0,1,0,1,5
KLLFK,0,0,1,0,1,5
LLFKA,0,0,1,0,1,5
LFKAL,0,2,1,0,3,5
FKALK,0,0,1,0,1,5
AKLLK,0,0,1,0,1,5
KLLKL,0,0,1,0,1,5
LLKLA,0,0,1,0,1,5
LKLAA,0,0,1,0,1,5
KLAAK,1,1,1,0,3,5
LAAKK,0,0,1,0,1,5
AAKKL,0,0,1,0,1,5
FAKLW,0,1,1,0,2,5
AKLWA,0,1,1,0,2,5
KLWAK,0,1,1,0,2,5
LWAKL,0,1,1,0,2,5
WAKLA,0,1,1,0,2,5
AKLAF,0,1,0,0,1,5
KLAFG,0,1,0,0,1,5
LAFGK,0,1,0,0,1,5
AFGKG,0,1,0,0,1,5
FGKGI,0,1,0,0,1,5
GKGIG,0,1,0,0,1,5
KGIGK,0,1,0,0,1,5
GIGKV,0,1,0,0,1,5
IGKVG,0,1,0,0,1,5
GKVGK,0,1,0,0,1,5
KVGKK,0,1,0,0,1,5
VGKKL,0,1,0,0,1,5
GKKLL,0,1,0,0,1,5
FALAA,0,1,0,0,1,5
ALAAK,0,1,0,0,1,5
LAAKA,0,1,0,1,2,5
AAKAL,0,1,0,0,1,5
FALAK,0,1,0,0,1,5
AKKAK,0,1,0,0,1,5
KKAKA,0,1,0,0,1,5
KAKAK,0,1,0,0,1,5
KAKLK,0,1,0,0,1,5
AKLKK,0,1,0,0,1,5
KLKKA,0,4,2,0,6,5
KKALK,0,6,5,0,11,5
FALAL,0,5,4,0,9,5
LKKLK,0,4,2,1,7,5
KKLLK,0,1,0,0,1,5
KLLKK,1,2,0,1,4,5
LLKKL,1,2,0,2,5,5
LALKK,0,1,0,0,1,5
FALKA,0,1,0,0,1,5
FALLK,0,0,2,0,2,5
ALLKK,0,0,1,0,1,5
LLKKA,0,0,1,0,1,5
FAVGL,0,0,1,0,1,5
AVGLR,0,0,1,0,1,5
VGLRA,0,0,1,0,1,5
GLRAI,0,0,1,0,1,5
LRAIK,0,0,1,0,1,5
RAIKR,0,0,1,0,1,5
AIKRA,0,0,1,0,1,5
IKRAL,0,0,1,0,1,5
KRALK,0,0,1,0,1,5
RALKK,0,0,1,0,1,5
LKKLR,0,0,1,0,1,5
KKLRR,0,0,1,0,1,5
KLRRG,0,0,1,0,1,5
LRRGV,0,0,1,0,1,5
RRGVR,0,0,1,0,1,5
RGVRK,0,0,1,0,1,5
GVRKV,0,0,1,0,1,5
VRKVA,0,0,1,0,1,5
RKVAK,0,0,1,0,1,5
KVAKD,0,0,1,0,1,5
VAKDL,0,0,1,0,1,5
FKLAF,0,0,1,0,1,5
KLAFK,0,0,1,0,1,5
LAFKL,0,0,1,0,1,5
AFKLA,0,0,1,0,1,5
FKLAK,1,0,1,0,2,5
AKKAF,0,0,1,0,1,5
KKAFL,0,0,1,0,1,5
FKRLA,0,1,0,0,1,5
KRLAK,0,1,0,0,1,5
RLAKI,0,2,0,0,2,5
LAKIK,0,2,0,0,2,5
AKIKV,0,1,0,0,1,5
KIKVL,0,1,0,0,1,5
IKVLR,0,1,0,1,2,5
KVLRL,0,1,0,0,1,5
VLRLA,0,1,0,1,2,5
LRLAK,0,1,0,0,1,5
AKIKR,0,1,0,0,1,5
FKVKF,0,0,2,0,2,5
KVKFK,0,0,2,0,2,5
VKFKV,0,0,1,0,1,5
KFKVK,0,0,1,0,1,5
FKVKV,0,0,1,0,1,5
KVKVK,0,0,1,0,1,5
FLGAL,0,3,0,0,3,5
LGALF,0,3,0,0,3,5
GALFH,0,1,0,0,1,5
ALFHA,0,1,0,0,1,5
LFHAL,0,1,0,0,1,5
FHALS,0,1,0,0,1,5
HALSK,0,1,0,0,1,5
ALSKL,0,2,0,0,2,5
LSKLL,0,2,0,0,2,5
GALFK,0,2,0,0,2,5
ALFKA,0,2,0,0,2,5
FKALS,0,2,0,0,2,5
KALSH,0,1,0,0,1,5
ALSHL,0,1,0,0,1,5
LSHLL,0,1,0,0,1,5
KALSK,0,1,0,0,1,5
FLGMI,2,0,0,0,2,5
LGMIP,2,0,0,0,2,5
GMIPG,1,0,0,0,1,5
MIPGL,1,0,0,0,1,5
IPGLI,1,0,0,0,1,5
PGLIG,1,0,0,0,1,5
GLIGG,1,0,0,0,1,5
LIGGL,1,0,0,0,1,5
IGGLI,1,0,0,0,1,5
GGLIS,1,0,0,0,1,5
GLISA,1,0,0,0,1,5
LISAF,1,0,0,0,1,5
ISAFK,1,0,1,0,2,5
GMIPK,1,0,0,0,1,5
MIPKL,1,0,0,0,1,5
IPKLI,1,0,0,0,1,5
PKLIK,1,0,0,0,1,5
KLIKK,1,0,0,1,2,5
LIKKL,1,0,0,0,1,5
IKKLI,1,0,0,0,1,5
KKLIK,1,0,0,0,1,5
KLIKA,1,0,0,0,1,5
LIKAF,1,0,0,0,1,5
IKAFK,2,0,0,0,2,5
FLGWL,0,2,0,0,2,5
LGWLF,0,2,0,1,3,5
GWLFK,0,2,0,0,2,5
WLFKW,0,4,0,0,4,5
LFKWA,0,4,0,0,4,5
FKWAK,0,2,0,0,2,5
KWAKK,0,2,0,0,2,5
FKWAW,0,2,0,0,2,5
KWAWK,0,2,0,0,2,5
FLKLL,1,2,0,0,3,5
LKLLA,0,1,0,0,1,5
KLLAG,0,1,0,0,1,5
LLAGL,0,1,0,0,1,5
LAGLL,0,1,0,0,1,5
AGLLK,0,1,0,0,1,5
GLLKN,0,1,0,0,1,5
LLKNF,0,1,0,0,1,5
LKNFA,0,1,0,0,1,5
LKLLK,1,1,0,0,2,5
KKLAA,1,1,0,0,2,5
LAAKF,1,0,0,0,1,5
AAKFL,1,0,0,0,1,5
AKFLP,1,0,0,0,1,5
KFLPT,1,0,0,0,1,5
FLPTI,1,0,0,0,1,5
LPTII,1,0,0,0,1,5
PTIIC,1,0,0,0,1,5
TIICK,1,0,0,0,1,5
IICKI,1,0,0,0,1,5
ICKIS,1,0,0,0,1,5
CKISY,1,0,0,0,1,5
KISYK,1,0,0,0,1,5
ISYKC,1,0,0,0,1,5
LAAKL,0,1,0,0,1,5
AAKLF,0,1,0,0,1,5
FLKWL,0,1,0,0,1,5
LKWLF,0,1,0,0,1,5
KWLFK,0,1,0,0,1,5
FLSLI,1,0,1,0,2,5
LSLIP,1,0,1,0,2,5
SLIPK,1,0,0,0,1,5
LIPKL,1,0,0,0,1,5
IPKLV,1,0,0,0,1,5
PKLVK,1,0,0,0,1,5
KLVKK,1,0,0,1,2,5
LVKKI,1,0,0,0,1,5
VKKII,1,0,0,0,1,5
KKIIK,1,0,0,0,1,5
KIIKA,1,0,0,0,1,5
IIKAF,1,0,0,0,1,5
SLIPS,0,0,1,0,1,5
LIPSL,0,0,1,0,1,5
IPSLV,0,0,1,0,1,5
PSLVG,0,0,1,0,1,5
SLVGG,0,0,1,0,1,5
LVGGS,0,0,1,0,1,5
VGGSI,0,0,1,0,1,5
GGSIS,0,0,1,0,1,5
GSISA,0,0,1,0,1,5
SISAF,0,0,1,0,1,5
FLWWL,0,1,0,0,1,5
LWWLF,0,1,0,0,1,5
WWLFK,0,1,0,0,1,5
GIGAV,1,2,0,0,3,5
VLKVL,1,3,0,0,4,5
LKVLT,0,2,0,0,2,5
KVLTT,0,2,0,0,2,5
VLTTG,0,2,0,0,2,5
LTTGL,0,1,0,0,1,5
TTGLP,0,1,0,0,1,5
TGLPA,0,1,0,0,1,5
GLPAL,0,1,0,0,1,5
LPALI,0,1,0,0,1,5
PALIS,0,1,0,0,1,5
ALISW,0,1,0,0,1,5
LISWI,0,1,0,0,1,5
ISWIK,0,1,0,0,1,5
SWIKR,0,1,0,0,1,5
WIKRK,0,1,0,0,1,5
IKRKR,0,1,0,0,1,5
KRKRQ,0,1,0,0,1,5
RKRQQ,0,1,0,0,1,5
GIGKF,5,5,1,0,11,5
KFLHA,0,1,0,0,1,5
FLHAA,0,1,0,0,1,5
LHAAK,0,1,0,0,1,5
HAAKK,0,1,0,0,1,5
AAKKF,0,1,0,0,1,5
KFAKA,1,2,0,0,3,5
FAKAF,1,2,0,0,3,5
AKAFV,1,2,0,0,3,5
KAFVA,0,2,0,0,2,5
AFVAE,0,2,0,0,2,5
FVAEI,0,2,0,0,2,5
VAEIM,0,2,0,0,2,5
AEIMN,0,2,0,0,2,5
GKFLK,1,0,1,0,2,5
LKKAK,1,0,1,0,2,5
KKAKK,1,0,1,0,2,5
KAKKF,1,0,1,0,2,5
KAFVK,1,0,1,0,2,5
AFVKI,1,0,1,0,2,5
FVKII,1,0,0,0,1,5
VKIIN,1,0,0,0,1,5
KIINN,1,0,0,0,1,5
FVKIL,0,0,1,0,1,5
VKILK,0,0,1,0,1,5
KILKK,0,0,1,0,1,5
GLFAV,2,4,0,0,6,5
LFAVI,2,4,0,0,6,5
FAVIK,2,4,0,0,6,5
AVIKK,2,5,0,0,7,5
VIKKV,2,10,0,0,12,5
IKKVA,2,10,0,0,12,5
KKVAA,0,3,0,0,3,5
KVAAV,0,3,0,0,3,5
VAAVI,0,3,0,0,3,5
AAVIK,0,1,0,0,1,5
VIKKL,1,5,0,0,6,5
AAVIR,0,1,0,0,1,5
AVIRR,0,1,0,0,1,5
VIRRL,0,1,0,0,1,5
KKVAK,1,1,0,0,2,5
KVAKV,1,1,0,0,2,5
VAKVI,1,1,0,0,2,5
AKVIK,1,1,0,0,2,5
KVIKK,1,3,0,1,5,5
KKVAS,1,6,0,0,7,5
KVASV,1,7,0,0,8,5
VASVI,1,8,0,0,9,5
ASVIG,1,3,0,0,4,5
SVIGG,1,3,0,0,4,5
VIGGL,1,4,0,0,5,5
ASVIK,0,5,0,0,5,5
SVIKG,0,2,0,0,2,5
VIKGL,0,2,0,0,2,5
SVIKK,0,3,0,0,3,5
GLFDI,0,6,0,0,6,5
LFDIA,0,1,0,0,1,5
FDIAK,0,1,0,0,1,5
DIAKK,0,1,0,0,1,5
IAKKV,0,1,0,0,1,5
AKKVI,0,1,0,0,1,5
KKVIG,0,1,0,0,1,5
KVIGV,0,1,0,0,1,5
VIGVI,0,1,0,0,1,5
IGVIG,0,1,0,0,1,5
GVIGS,0,1,0,0,1,5
VIGSL,0,1,0,0,1,5
LFDII,0,1,0,0,1,5
FDIIK,0,1,0,0,1,5
DIIKK,0,1,0,0,1,5
IIKKI,0,1,0,0,1,5
IKKIA,0,1,0,0,1,5
KKIAE,0,1,0,0,1,5
KIAES,0,1,0,0,1,5
IAESF,0,1,0,0,1,5
LFDIV,0,4,0,0,4,5
FDIVK,0,4,0,0,4,5
DIVKK,0,4,0,0,4,5
IVKKI,0,3,0,0,3,5
VKKIA,0,3,0,1,4,5
KKIAG,0,3,0,0,3,5
KIAGH,0,3,0,0,3,5
IAGHI,0,3,0,0,3,5
AGHIA,0,2,0,0,2,5
GHIAG,0,1,0,0,1,5
HIAGS,0,1,0,0,1,5
IAGSI,0,1,0,0,1,5
GHIAS,0,1,0,0,1,5
HIASS,0,1,0,0,1,5
IASSI,0,1,0,0,1,5
AGHIV,0,1,0,0,1,5
GHIVS,0,1,0,0,1,5
HIVSS,0,1,0,0,1,5
IVSSI,0,1,0,0,1,5
IVKKV,0,1,0,0,1,5
VKKVV,0,1,0,1,2,5
KKVVG,0,1,0,0,1,5
KVVGA,0,1,0,0,1,5
VVGAF,0,1,0,0,1,5
VGAFG,0,1,0,0,1,5
GAFGS,0,1,0,0,1,5
AFGSL,0,1,0,0,1,5
GLFDV,0,6,0,1,7,5
LFDVI,0,6,0,1,7,5
FDVIA,0,1,0,0,1,5
DVIAK,0,1,0,0,1,5
VIAKV,0,1,0,0,1,5
IAKVA,0,1,0,0,1,5
AKVAS,0,1,0,0,1,5
FDVIK,0,5,0,0,5,5
DVIKA,0,1,0,0,1,5
VIKAV,0,1,0,0,1,5
IKAVA,0,1,0,0,1,5
KAVAS,0,1,0,0,1,5
AVASV,0,1,0,0,1,5
DVIKK,0,4,0,0,4,5
AAVIG,0,1,0,0,1,5
AVIGG,0,1,0,0,1,5
GLFKV,0,2,0,0,2,5
LFKVI,0,2,0,0,2,5
FKVIK,0,2,0,0,2,5
ILPWK,0,0,1,0,1,5
LPWKW,0,0,1,0,1,5
PWKWP,0,0,1,0,1,5
WKWPW,0,0,1,0,1,5
KWPWW,0,0,1,0,1,5
WPWWP,0,0,1,0,1,5
PWWPW,0,0,1,0,1,5
WWPWR,0,0,1,0,1,5
WPWRR,0,0,1,0,1,5
KKKFP,4,1,0,0,5,5
KKFPW,4,1,0,0,5,5
KFPWW,4,1,0,0,5,5
FPWWW,4,1,0,0,5,5
PWWWP,4,1,0,0,5,5
WWWPF,4,1,0,0,5,5
WWPFK,4,1,0,0,5,5
WPFKK,4,1,0,0,5,5
PFKKK,4,1,0,0,5,5
FKKKC,2,0,0,0,2,5
KKKCK,1,0,0,0,1,5
KKCKK,1,0,0,0,1,5
KCKKK,1,0,0,0,1,5
CKKKF,1,0,0,0,1,5
FKKKK,2,0,0,0,2,5
KKKKK,2,0,0,0,2,5
KKKKF,1,0,0,0,1,5
KKVVF,0,0,1,0,1,5
KVVFK,0,0,1,0,1,5
VVFKV,0,0,1,0,1,5
VFKVK,0,0,1,0,1,5
LKLAL,0,0,1,0,1,5
ALKAA,0,0,1,0,1,5
LKAAK,0,0,1,0,1,5
KAAKL,0,0,1,0,1,5
AAKLA,0,0,1,1,2,5
KTKLF,0,2,0,0,2,5
TKLFK,0,2,0,0,2,5
KLFKK,4,10,1,0,15,5
LFKKF,0,2,0,0,2,5
KWKKF,1,0,0,0,1,5
WKKFL,1,0,0,0,1,5
KKFLK,1,0,0,0,1,5
KFLKI,1,0,0,0,1,5
FLKIG,1,0,0,0,1,5
LKIGI,1,0,0,0,1,5
KIGIG,6,4,0,0,10,5
IGIGK,4,2,0,0,6,5
KFLHL,3,0,0,0,3,5
FLHLA,4,0,0,0,4,5
LHLAK,4,0,0,0,4,5
HLAKK,4,0,0,0,4,5
KWKLA,0,0,1,0,1,5
WKLAK,0,0,1,0,1,5
ALALL,0,0,1,0,1,5
KWKLF,5,8,1,0,14,5
WKLFA,1,0,0,0,1,5
LFAKI,1,0,0,0,1,5
FAKIG,1,0,0,0,1,5
AKIGI,1,0,0,0,1,5
WKLFK,4,8,1,0,13,5
LFKKA,0,1,0,0,1,5
FKKAL,0,1,0,0,1,5
LFKKI,4,6,1,0,11,5
FKKIG,4,5,0,0,9,5
KKIGA,0,1,0,0,1,5
KIGAV,0,1,0,0,1,5
KKIGI,4,4,0,0,8,5
IGIGA,2,2,0,0,4,5
GIGAF,1,1,0,0,2,5
IGAFL,1,1,0,0,2,5
GAFLH,1,1,0,0,2,5
AFLHL,1,0,0,0,1,5
AFLHS,0,1,0,0,1,5
LKVLK,1,0,0,0,1,5
KVLKK,1,0,0,0,1,5
VLKKG,1,0,0,0,1,5
IGKFK,1,0,0,0,1,5
GKFKL,1,0,0,0,1,5
KFKLA,1,0,0,0,1,5
LHSAT,0,1,0,0,1,5
HSATT,0,1,0,0,1,5
SATTF,0,1,0,0,1,5
FKKIK,0,0,1,0,1,5
KKIKF,0,0,1,0,1,5
KIKFL,0,0,1,0,1,5
IKFLH,0,0,1,0,1,5
FKKIP,0,1,0,0,1,5
KKIPK,0,1,0,0,1,5
KIPKF,0,1,0,0,1,5
IPKFL,0,1,0,0,1,5
PKFLH,0,1,0,0,1,5
LFKKK,0,1,0,0,1,5
FKKKT,0,1,0,0,1,5
KKKTK,0,1,0,0,1,5
KKTKL,0,1,0,0,1,5
KWKSF,5,3,0,0,8,5
WKSFA,0,1,0,0,1,5
KSFAK,0,1,0,0,1,5
SFAKT,0,1,0,0,1,5
FAKTF,0,1,0,0,1,5
AKTFK,0,1,0,0,1,5
KTFKS,5,3,0,0,8,5
TFKSA,2,3,0,0,5,5
FKSAK,2,3,0,0,5,5
KSAKK,2,3,0,0,5,5
SAKKT,2,3,0,0,5,5
AKKTV,2,3,0,0,5,5
KKTVL,5,1,0,0,6,5
KTVLH,5,1,0,0,6,5
TVLHT,5,1,0,0,6,5
VLHTA,2,1,0,0,3,5
LHTAL,2,1,0,0,3,5
HTALK,2,2,0,0,4,5
TALKA,2,2,0,0,4,5
ALKAI,2,2,0,0,4,5
LKAIS,4,2,0,0,6,5
KAISS,4,3,0,0,7,5
WKSFL,5,2,0,0,7,5
KSFLK,5,2,0,0,7,5
SFLKT,5,2,0,0,7,5
FLKTF,5,2,0,0,7,5
LKTFK,5,2,0,0,7,5
KKTVA,0,2,0,0,2,5
KTVAH,0,2,0,0,2,5
TVAHT,0,2,0,0,2,5
VAHTA,0,2,0,0,2,5
AHTAA,0,1,0,0,1,5
HTAAK,0,1,0,0,1,5
TAAKA,0,1,0,0,1,5
AAKAI,0,1,0,0,1,5
AKAIS,0,1,0,0,1,5
AHTAL,0,1,0,0,1,5
VLHTL,3,0,0,0,3,5
LHTLL,3,0,0,0,3,5
HTLLK,3,0,0,0,3,5
TLLKA,2,0,0,0,2,5
LLKAI,2,0,0,0,2,5
TFKSL,3,0,0,0,3,5
FKSLK,3,0,0,0,3,5
KSLKK,3,0,0,0,3,5
SLKKT,3,0,0,0,3,5
LKKTV,3,0,0,0,3,5
TLLKL,1,0,0,0,1,5
LLKLI,1,0,0,0,1,5
LKLIS,1,0,0,0,1,5
KLISS,1,0,0,0,1,5
KYKKA,0,0,1,0,1,5
YKKAL,0,0,1,0,1,5
LGGIV,0,1,0,0,1,5
GGIVS,0,1,0,0,1,5
GIVSA,0,1,0,0,1,5
IVSAV,0,1,0,0,1,5
VSAVK,0,1,0,0,1,5
SAVKK,0,1,0,0,1,5
AVKKI,0,1,0,0,1,5
VKKIV,0,1,0,0,1,5
KKIVD,0,1,0,0,1,5
KIVDF,0,1,0,0,1,5
IVDFL,0,1,0,0,1,5
VDFLG,0,1,0,0,1,5
LPKWK,0,1,0,0,1,5
PKWKV,0,1,1,0,2,5
KWKVF,0,1,1,0,2,5
WKVFK,0,1,1,0,2,5
KVFKK,0,1,1,0,2,5
VFKKI,0,1,1,0,2,5
FKKIE,0,1,1,0,2,5
KKIEK,0,1,1,0,2,5
KIEKV,0,1,1,0,2,5
IEKVG,0,1,1,0,2,5
EKVGR,0,1,1,0,2,5
KVGRN,0,1,1,0,2,5
VGRNI,0,1,1,0,2,5
GRNIR,0,1,1,0,2,5
RNIRN,0,1,1,0,2,5
NIRNG,0,1,1,0,2,5
IRNGI,0,1,1,0,2,5
RNGIV,0,1,1,0,2,5
NGIVK,0,1,1,0,2,5
GIVKA,0,1,1,0,2,5
IVKAG,0,1,1,0,2,5
VKAGP,0,1,1,0,2,5
KAGPA,0,1,1,0,2,5
AGPAI,0,1,1,0,2,5
GPAIA,0,1,1,0,2,5
PAIAV,0,1,1,0,2,5
AIAVL,0,1,1,0,2,5
IAVLG,0,1,1,0,2,5
AVLGE,0,1,1,0,2,5
VLGEA,0,1,1,0,2,5
LGEAK,0,1,1,0,2,5
GEAKA,0,1,1,0,2,5
EAKAL,0,1,1,0,2,5
AKALG,0,1,1,0,2,5
MPKWK,0,0,1,0,1,5
RAGLQ,1,0,0,0,1,5
AGLQF,1,0,0,0,1,5
GLQFP,1,0,0,0,1,5
LQFPV,1,0,0,0,1,5
QFPVG,1,0,0,0,1,5
FPVGR,1,0,0,0,1,5
PVGRL,1,0,0,0,1,5
VGRLL,1,0,0,0,1,5
GRLLR,1,0,0,0,1,5
RLLRR,2,0,0,0,2,5
LLRRL,2,0,0,0,2,5
LRRLL,2,0,0,0,2,5
RRLLR,2,0,0,0,2,5
VAKKL,1,0,0,0,1,5
VAKLL,0,1,1,1,3,5
VALAL,0,0,1,0,1,5
WALAL,0,0,1,0,1,5
AADIF,0,0,0,1,1,5
ADIFS,0,0,0,1,1,5
DIFSK,0,0,0,1,1,5
IFSKF,0,0,0,1,1,5
FSKFK,0,0,0,1,1,5
SKFKK,0,0,0,1,1,5
KFKKD,0,0,0,1,1,5
FKKDM,0,0,0,1,1,5
KKDME,0,0,0,1,1,5
KDMEV,0,0,0,1,1,5
DMEVK,0,0,0,1,1,5
MEVKF,0,0,0,1,1,5
EVKFA,0,0,0,1,1,5
AAQKD,0,0,0,1,1,5
AQKDN,0,0,0,1,1,5
QKDNV,0,0,0,1,1,5
KDNVK,0,0,0,1,1,5
DNVKS,0,0,0,1,1,5
NVKSS,0,0,0,1,1,5
VKSSW,0,0,0,1,1,5
KSSWA,0,0,0,1,1,5
SSWAK,0,0,0,1,1,5
SWAKA,0,0,0,1,1,5
WAKAS,0,0,0,1,1,5
AKASA,0,0,0,1,1,5
AASQR,0,0,0,1,1,5
ASQRK,0,0,0,1,1,5
SQRKL,0,0,0,1,1,5
QRKLI,0,0,0,1,1,5
RKLIA,0,0,0,1,1,5
KLIAE,0,0,0,1,1,5
LIAEK,0,0,0,1,1,5
IAEKF,0,0,0,1,1,5
AEKFA,0,0,0,1,1,5
EKFAQ,0,0,0,1,1,5
KFAQA,0,0,0,1,1,5
FAQAL,0,0,0,1,1,5
AQALM,0,0,0,1,1,5
QALMS,0,0,0,1,1,5
ALMSS,0,0,0,1,1,5
LMSSL,0,0,0,1,1,5
AAYAT,0,0,0,1,1,5
AYATL,0,0,0,1,1,5
YATLY,0,0,0,1,1,5
ATLYE,0,0,0,1,1,5
TLYEA,0,0,0,1,1,5
LYEAL,0,0,0,1,1,5
YEALV,0,0,0,1,1,5
EALVL,0,0,0,1,1,5
ALVLV,0,0,0,1,1,5
LVLVA,0,0,0,1,1,5
VLVAT,0,0,0,1,1,5
LVATL,0,0,0,1,1,5
VATLA,0,0,0,2,2,5
ATLAA,0,0,0,1,1,5
TLAAP,0,0,0,1,1,5
AEAHE,0,0,0,1,1,5
EAHES,0,0,0,1,1,5
AHESI,0,0,0,1,1,5
HESIR,0,0,0,1,1,5
ESIRL,0,0,0,1,1,5
SIRLV,0,0,0,1,1,5
IRLVF,0,0,0,1,1,5
RLVFH,0,0,0,1,1,5
LVFHD,0,0,0,1,1,5
VFHDS,0,0,0,1,1,5
AEGER,0,0,0,1,1,5
EGERE,0,0,0,1,1,5
GEREA,0,0,0,1,1,5
EREAR,0,0,0,1,1,5
REARV,0,0,0,1,1,5
EARVF,0,0,0,1,1,5
ARVFT,0,0,0,1,1,5
RVFTL,0,0,0,1,1,5
VFTLW,0,0,0,1,1,5
FTLWL,0,0,0,1,1,5
TLWLN,0,0,0,1,1,5
LWLNS,0,0,0,1,1,5
WLNSL,0,0,0,1,1,5
AEGVA,0,0,0,1,1,5
EGVAT,0,0,0,1,1,5
GVATA,0,0,0,1,1,5
VATAD,0,0,0,1,1,5
ATADP,0,0,0,1,1,5
TADPL,0,0,0,1,1,5
ADPLM,0,0,0,1,1,5
DPLMR,0,0,0,1,1,5
PLMRL,0,0,0,1,1,5
LMRLA,0,0,0,1,1,5
MRLAK,0,0,0,1,1,5
RLAKQ,0,0,0,1,1,5
LAKQL,0,0,0,1,1,5
AKQLK,0,0,0,1,1,5
AEHAK,0,0,0,1,1,5
EHAKV,0,0,0,1,1,5
HAKVL,0,0,0,1,1,5
AKVLM,0,0,0,1,1,5
KVLMD,0,0,0,1,1,5
VLMDS,0,0,0,1,1,5
LMDSL,0,0,0,1,1,5
MDSLT,0,0,0,1,1,5
DSLTG,0,0,0,1,1,5
SLTGV,0,0,0,1,1,5
LTGVW,0,0,0,1,1,5
TGVWD,0,0,0,1,1,5
GVWDN,0,0,0,1,1,5
VWDNF,0,0,0,1,1,5
WDNFL,0,0,0,1,1,5
DNFLT,0,0,0,1,1,5
AEHLA,0,0,0,1,1,5
EHLAK,0,0,0,1,1,5
HLAKA,0,0,0,1,1,5
LAKAE,0,0,0,1,1,5
AKAEL,0,0,0,1,1,5
KAELT,0,0,0,1,1,5
AELTT,0,0,0,1,1,5
ELTTV,0,0,0,1,1,5
LTTVF,0,0,0,1,1,5
TTVFS,0,0,0,1,1,5
TVFST,0,0,0,1,1,5
VFSTL,0,0,0,1,1,5
FSTLY,0,0,0,2,2,5
STLYQ,0,0,0,1,1,5
TLYQK,0,0,0,1,1,5
LYQKF,0,0,0,1,1,5
AEKAK,0,0,0,1,1,5
EKAKY,0,0,0,1,1,5
KAKYD,0,0,0,1,1,5
AKYDE,0,0,0,1,1,5
KYDEI,0,0,0,1,1,5
YDEIF,0,0,0,1,1,5
DEIFL,0,0,0,1,1,5
EIFLK,0,0,0,1,1,5
IFLKT,0,0,0,1,1,5
AFFTI,0,0,0,1,1,5
FFTIA,0,0,0,1,1,5
FTIAA,0,0,0,1,1,5
TIAAV,0,0,0,1,1,5
IAAVA,0,0,0,1,1,5
AAVAR,0,0,0,1,1,5
AVARV,0,0,0,1,1,5
VARVL,0,0,0,1,1,5
ARVLD,0,0,0,1,1,5
AFRHS,0,0,0,1,1,5
FRHSV,0,0,0,1,1,5
RHSVK,0,0,0,1,1,5
HSVKE,0,0,0,1,1,5
SVKEE,0,0,0,1,1,5
VKEEL,0,0,0,1,1,5
KEELN,0,0,0,1,1,5
EELNY,0,0,0,1,1,5
ELNYI,0,0,0,1,1,5
LNYIR,0,0,0,1,1,5
NYIRR,0,0,0,1,1,5
YIRRR,0,0,0,1,1,5
IRRRL,0,0,0,1,1,5
RRRLE,0,0,0,1,1,5
RRLER,0,0,0,1,1,5
RLERF,0,0,0,1,1,5
LERFP,0,0,0,1,1,5
ERFPN,0,0,0,1,1,5
RFPNR,0,0,0,1,1,5
FPNRL,0,0,0,1,1,5
AGDVL,0,0,0,1,1,5
GDVLH,0,0,0,1,1,5
DVLHN,0,0,0,1,1,5
VLHNV,0,0,0,1,1,5
LHNVL,0,0,0,1,1,5
HNVLQ,0,0,0,1,1,5
NVLQM,0,0,0,1,1,5
VLQML,0,0,0,1,1,5
LQMLI,0,0,0,1,1,5
QMLII,0,0,0,1,1,5
MLIIE,0,0,0,1,1,5
LIIES,0,0,0,1,1,5
IIESH,0,0,0,1,1,5
IESHS,0,0,0,1,1,5
AGEMV,0,0,0,1,1,5
GEMVR,0,0,0,1,1,5
EMVRQ,0,0,0,1,1,5
MVRQA,0,0,0,1,1,5
VRQAR,0,0,0,1,1,5
RQARI,0,0,0,1,1,5
QARIL,0,0,0,1,1,5
ARILA,0,0,0,1,1,5
RILAQ,0,0,0,1,1,5
ILAQA,0,0,0,1,1,5
LAQAT,0,0,0,1,1,5
AQATS,0,0,0,1,1,5
QATSD,0,0,0,1,1,5
ATSDL,0,0,0,1,1,5
TSDLV,0,0,0,1,1,5
SDLVN,0,0,0,1,1,5
DLVNA,0,0,0,1,1,5
LVNAI,0,0,0,1,1,5
VNAIK,0,0,0,1,1,5
NAIKA,0,0,0,1,1,5
AIKAD,0,0,0,1,1,5
IKADA,0,0,0,1,1,5
AGNLD,0,0,0,1,1,5
GNLDI,0,0,0,1,1,5
NLDIM,0,0,0,1,1,5
LDIMT,0,0,0,1,1,5
DIMTS,0,0,0,1,1,5
IMTSA,0,0,0,1,1,5
MTSAA,0,0,0,1,1,5
TSAAL,0,0,0,1,1,5
SAALA,0,0,0,2,2,5
AALAT,0,0,0,1,1,5
ALATA,0,0,0,1,1,5
LATAE,0,0,0,1,1,5
ATAER,0,0,0,1,1,5
TAERM,0,0,0,1,1,5
AERMA,0,0,0,1,1,5
ERMAQ,0,0,0,1,1,5
RMAQS,0,0,0,1,1,5
MAQSM,0,0,0,1,1,5
AQSML,0,0,0,1,1,5
QSMLN,0,0,0,1,1,5
AHAIG,0,0,0,1,1,5
HAIGV,0,0,0,1,1,5
AIGVL,0,0,0,1,1,5
IGVLL,0,0,0,1,1,5
GVLLD,0,0,0,1,1,5
VLLDN,0,0,0,1,1,5
LLDNL,0,0,0,1,1,5
AIEKE,0,0,0,2,2,5
IEKEI,0,0,0,1,1,5
EKEIL,0,0,0,1,1,5
KEILI,0,0,0,1,1,5
EILIE,0,0,0,1,1,5
ILIEA,0,0,0,1,1,5
LIEAI,0,0,0,1,1,5
IEAIS,0,0,0,1,1,5
EAISS,0,0,0,1,1,5
AKQEK,0,0,0,1,1,5
KQEKI,0,0,0,1,1,5
QEKII,0,0,0,1,1,5
EKIII,0,0,0,1,1,5
KIIIQ,0,0,0,1,1,5
IIIQV,0,0,0,1,1,5
IIQVA,0,0,0,1,1,5
IQVAL,0,0,0,1,1,5
QVALN,0,0,0,1,1,5
VALND,0,0,0,1,1,5
ALNDI,0,0,0,1,1,5
LNDIT,0,0,0,1,1,5
NDITH,0,0,0,1,1,5
DITHV,0,0,0,1,1,5
ITHVV,0,0,0,1,1,5
THVVE,0,0,0,1,1,5
HVVEL,0,0,0,1,1,5
VVELL,0,0,0,1,1,5
AKVVR,0,0,0,1,1,5
KVVRT,0,0,0,1,1,5
VVRTA,0,0,0,1,1,5
VRTAL,0,0,0,1,1,5
RTALE,0,0,0,1,1,5
TALED,0,0,0,1,1,5
ALEDA,0,0,0,1,1,5
LEDAA,0,0,0,1,1,5
EDAAS,0,0,0,1,1,5
DAASV,0,0,0,1,1,5
AASVA,0,0,0,1,1,5
ASVAG,0,0,0,1,1,5
SVAGL,0,0,0,1,1,5
VAGLL,0,0,0,1,1,5
AGLLI,0,0,0,1,1,5
GLLIT,0,0,0,1,1,5
ALAVA,0,0,0,1,1,5
LAVAA,0,0,0,1,1,5
AVAAK,0,0,0,1,1,5
VAAKP,0,0,0,1,1,5
AAKPF,0,0,0,1,1,5
AKPFL,0,0,0,1,1,5
ALGKV,0,0,0,1,1,5
LGKVI,0,0,0,1,1,5
GKVIK,0,0,0,1,1,5
VIKKW,0,0,0,1,1,5
IKKWG,0,0,0,1,1,5
KKWGT,0,0,0,1,1,5
KWGTT,0,0,0,1,1,5
WGTTV,0,0,0,1,1,5
GTTVA,0,0,0,1,1,5
TTVAK,0,0,0,1,1,5
TVAKL,0,0,0,1,1,5
VAKLA,0,0,0,1,1,5
ALYGL,0,0,0,1,1,5
LYGLL,0,0,0,1,1,5
YGLLK,0,0,0,1,1,5
GLLKE,0,0,0,1,1,5
LLKEE,0,0,0,1,1,5
LKEEM,0,0,0,1,1,5
KEEMG,0,0,0,1,1,5
EEMGE,0,0,0,1,1,5
EMGEI,0,0,0,1,1,5
MGEIL,0,0,0,1,1,5
GEILA,0,0,0,1,1,5
EILAK,0,0,0,1,1,5
AMFEQ,0,0,0,1,1,5
MFEQM,0,0,0,1,1,5
FEQMR,0,0,0,1,1,5
EQMRA,0,0,0,1,1,5
QMRAN,0,0,0,1,1,5
MRANV,0,0,0,1,1,5
RANVG,0,0,0,1,1,5
ANVGK,0,0,0,1,1,5
NVGKL,0,0,0,1,1,5
VGKLL,0,0,0,1,1,5
GKLLK,0,0,0,1,1,5
KLLKG,0,0,0,1,1,5
APDAE,0,0,0,1,1,5
PDAEG,0,0,0,1,1,5
DAEGR,0,0,0,1,1,5
AEGRA,0,0,0,1,1,5
EGRAI,0,0,0,1,1,5
GRAIQ,0,0,0,1,1,5
RAIQA,0,0,0,1,1,5
AIQAV,0,0,0,1,1,5
IQAVY,0,0,0,1,1,5
QAVYW,0,0,0,1,1,5
AVYWA,0,0,0,1,1,5
VYWAN,0,0,0,1,1,5
YWANK,0,0,0,1,1,5
WANKW,0,0,0,1,1,5
ANKWA,0,0,0,1,1,5
NKWAK,0,0,0,1,1,5
KWAKE,0,0,0,1,1,5
WAKEQ,0,0,0,1,1,5
AKEQG,0,0,0,1,1,5
APDLL,0,0,0,1,1,5
PDLLI,0,0,0,1,1,5
DLLIS,0,0,0,1,1,5
LLISL,0,0,0,1,1,5
LISLA,0,0,0,1,1,5
ISLAT,0,0,0,1,1,5
SLATV,0,0,0,1,1,5
LATVL,0,0,0,1,1,5
ATVLY,0,0,0,1,1,5
TVLYH,0,0,0,1,1,5
VLYHL,0,0,0,1,1,5
LYHLQ,0,0,0,1,1,5
YHLQQ,0,0,0,1,1,5
APEDV,0,0,0,1,1,5
PEDVR,0,0,0,1,1,5
EDVRK,0,0,0,1,1,5
DVRKS,0,0,0,1,1,5
VRKSS,0,0,0,1,1,5
RKSSK,0,0,0,1,1,5
KSSKE,0,0,0,1,1,5
SSKEV,0,0,0,1,1,5
SKEVL,0,0,0,1,1,5
APLLN,0,0,0,1,1,5
PLLNF,0,0,0,1,1,5
LLNFV,0,0,0,1,1,5
LNFVR,0,0,0,1,1,5
NFVRD,0,0,0,1,1,5
FVRDF,0,0,0,1,1,5
VRDFV,0,0,0,1,1,5
RDFVR,0,0,0,1,1,5
DFVRE,0,0,0,1,1,5
FVRED,0,0,0,1,1,5
VREDA,0,0,0,1,1,5
REDAK,0,0,0,1,1,5
EDAKY,0,0,0,1,1,5
DAKYL,0,0,0,1,1,5
AKYLY,0,0,0,1,1,5
KYLYS,0,0,0,1,1,5
YLYSS,0,0,0,1,1,5
LYSSL,0,0,0,1,1,5
YSSLV,0,0,0,1,1,5
AQTSR,0,0,0,1,1,5
QTSRW,0,0,0,1,1,5
TSRWA,0,0,0,1,1,5
SRWAA,0,0,0,1,1,5
RWAAM,0,0,0,1,1,5
WAAMQ,0,0,0,1,1,5
AAMQI,0,0,0,1,1,5
AMQIG,0,0,0,1,1,5
MQIGM,0,0,0,1,1,5
QIGMS,0,0,0,1,1,5
IGMSF,0,0,0,1,1,5
GMSFI,0,0,0,1,1,5
MSFIS,0,0,0,1,1,5
SFISA,0,0,0,1,1,5
FISAY,0,0,0,1,1,5
ARDEA,0,0,0,1,1,5
RDEAE,0,0,0,1,1,5
DEAEM,0,0,0,1,1,5
EAEME,0,0,0,1,1,5
AEMEY,0,0,0,1,1,5
EMEYL,0,0,0,1,1,5
MEYLK,0,0,0,1,1,5
EYLKI,0,0,0,1,1,5
YLKIA,0,0,0,1,1,5
LKIAQ,0,0,0,1,1,5
ASLPE,0,0,0,1,1,5
SLPEA,0,0,0,1,1,5
LPEAI,0,0,0,1,1,5
PEAIE,0,0,0,1,1,5
EAIEA,0,0,0,3,3,5
AIEAL,0,0,0,2,2,5
IEALT,0,0,0,1,1,5
EALTK,0,0,0,2,2,5
ALTKG,0,0,0,1,1,5
ATLKN,0,0,0,1,1,5
TLKNL,0,0,0,1,1,5
LKNLG,0,0,0,1,1,5
KNLGS,0,0,0,1,1,5
NLGSV,0,0,0,1,1,5
LGSVH,0,0,0,1,1,5
GSVHV,0,0,0,1,1,5
SVHVS,0,0,0,1,1,5
VHVSK,0,0,0,1,1,5
HVSKG,0,0,0,1,1,5
AVDTL,0,0,0,1,1,5
VDTLV,0,0,0,1,1,5
DTLVL,0,0,0,1,1,5
TLVLA,0,0,0,1,1,5
LVLAL,0,0,0,1,1,5
VLALA,0,0,0,1,1,5
LALAE,0,0,0,2,2,5
ALAEA,0,0,0,1,1,5
LAEAT,0,0,0,1,1,5
DAAAL,0,0,0,1,1,5
AAALF,0,0,0,1,1,5
AALFR,0,0,0,1,1,5
ALFRL,0,0,0,1,1,5
LFRLH,0,0,0,1,1,5
FRLHK,0,0,0,2,2,5
RLHKF,0,0,0,1,1,5
LHKFL,0,0,0,1,1,5
HKFLT,0,0,0,1,1,5
KFLTK,0,0,0,2,2,5
FLTKW,0,0,0,1,1,5
DAAGL,0,0,0,1,1,5
AAGLA,0,0,0,1,1,5
AGLAS,0,0,0,1,1,5
GLASR,0,0,0,1,1,5
LASRH,0,0,0,1,1,5
ASRHK,0,0,0,1,1,5
SRHKG,0,0,0,1,1,5
DAENR,0,0,0,1,1,5
AENRD,0,0,0,1,1,5
ENRDL,0,0,0,1,1,5
NRDLF,0,0,0,1,1,5
RDLFL,0,0,0,1,1,5
DLFLA,0,0,0,2,2,5
LFLAL,0,0,0,1,1,5
FLALL,0,0,0,1,1,5
LALLS,0,0,0,1,1,5
ALLSV,0,0,0,1,1,5
DAHAW,0,0,0,1,1,5
AHAWM,0,0,0,1,1,5
HAWMI,0,0,0,1,1,5
AWMIG,0,0,0,1,1,5
WMIGQ,0,0,0,1,1,5
MIGQL,0,0,0,1,1,5
IGQLK,0,0,0,1,1,5
GQLKG,0,0,0,1,1,5
QLKGL,0,0,0,1,1,5
DALEI,0,0,0,1,1,5
ALEIF,0,0,0,1,1,5
LEIFK,0,0,0,1,1,5
EIFKT,0,0,0,1,1,5
IFKTL,0,0,0,1,1,5
FKTLF,0,0,0,1,1,5
KTLFS,0,0,0,1,1,5
TLFSL,0,0,0,1,1,5
LFSLV,0,0,0,1,1,5
FSLVM,0,0,0,1,1,5
SLVMR,0,0,0,1,1,5
LVMRF,0,0,0,1,1,5
VMRFS,0,0,0,1,1,5
MRFSS,0,0,0,1,1,5
RFSSY,0,0,0,1,1,5
FSSYL,0,0,0,1,1,5
DAMLR,0,0,0,1,1,5
AMLRT,0,0,0,1,1,5
MLRTS,0,0,0,1,1,5
LRTSM,0,0,0,1,1,5
RTSMV,0,0,0,1,1,5
TSMVA,0,0,0,1,1,5
SMVAT,0,0,0,1,1,5
MVATQ,0,0,0,1,1,5
VATQL,0,0,0,1,1,5
ATQLV,0,0,0,1,1,5
TQLVG,0,0,0,1,1,5
QLVGL,0,0,0,1,1,5
LVGLA,0,0,0,1,1,5
VGLAM,0,0,0,1,1,5
GLAMM,0,0,0,1,1,5
LAMMR,0,0,0,1,1,5
AMMRY,0,0,0,1,1,5
MMRYV,0,0,0,1,1,5
DARAK,0,0,0,1,1,5
ARAKK,0,0,0,1,1,5
RAKKL,0,0,0,1,1,5
KKLLD,0,0,0,1,1,5
KLLDK,0,0,0,1,1,5
LLDKW,0,0,0,1,1,5
LDKWA,0,0,0,1,1,5
DKWAK,0,0,0,1,1,5
KWAKW,0,0,0,1,1,5
WAKWI,0,0,0,1,1,5
AKWIN,0,0,0,1,1,5
KWING,0,0,0,1,1,5
DATAA,0,0,0,1,1,5
ATAAL,0,0,0,1,1,5
TAALA,0,0,0,2,2,5
AALAL,0,0,0,2,2,5
ALALT,0,0,0,1,1,5
LALTM,0,0,0,1,1,5
ALTMA,0,0,0,1,1,5
DATLI,0,0,0,1,1,5
ATLIS,0,0,0,1,1,5
TLISE,0,0,0,1,1,5
LISEL,0,0,0,1,1,5
ISELQ,0,0,0,1,1,5
SELQQ,0,0,0,1,1,5
ELQQM,0,0,0,1,1,5
DDADL,0,0,0,1,1,5
DADLE,0,0,0,1,1,5
ADLEK,0,0,0,1,1,5
DLEKF,0,0,0,1,1,5
LEKFV,0,0,0,1,1,5
EKFVI,0,0,0,1,1,5
KFVIE,0,0,0,1,1,5
FVIEY,0,0,0,1,1,5
DDETL,0,0,0,1,1,5
DETLG,0,0,0,1,1,5
ETLGV,0,0,0,1,1,5
TLGVL,0,0,0,1,1,5
LGVLM,0,0,0,1,1,5
GVLMW,0,0,0,1,1,5
VLMWI,0,0,0,1,1,5
LMWIL,0,0,0,1,1,5
MWILD,0,0,0,1,1,5
WILDR,0,0,0,1,1,5
ILDRS,0,0,0,1,1,5
LDRSI,0,0,0,1,1,5
DRSIH,0,0,0,1,1,5
DDETR,0,0,0,1,1,5
DETRE,0,0,0,1,1,5
ETREE,0,0,0,1,1,5
TREEL,0,0,0,1,1,5
REELE,0,0,0,1,1,5
EELEE,0,0,0,2,2,5
ELEEL,0,0,0,1,1,5
LEELL,0,0,0,1,1,5
EELLI,0,0,0,1,1,5
ELLIQ,0,0,0,1,1,5
LLIQA,0,0,0,1,1,5
DDRVQ,0,0,0,1,1,5
DRVQS,0,0,0,1,1,5
RVQSH,0,0,0,1,1,5
VQSHI,0,0,0,1,1,5
QSHIL,0,0,0,1,1,5
SHILH,0,0,0,1,1,5
HILHL,0,0,0,1,1,5
ILHLE,0,0,0,1,1,5
LHLEH,0,0,0,1,1,5
HLEHD,0,0,0,1,1,5
LEHDL,0,0,0,1,1,5
EHDLV,0,0,0,1,1,5
HDLVH,0,0,0,1,1,5
DLVHV,0,0,0,1,1,5
LVHVT,0,0,0,1,1,5
VHVTR,0,0,0,1,1,5
HVTRK,0,0,0,1,1,5
VTRKN,0,0,0,1,1,5
DDYLK,0,0,0,1,1,5
DYLKE,0,0,0,1,1,5
YLKEQ,0,0,0,1,1,5
LKEQV,0,0,0,1,1,5
KEQVL,0,0,0,1,1,5
EQVLH,0,0,0,1,1,5
QVLHM,0,0,0,1,1,5
VLHMK,0,0,0,1,1,5
LHMKQ,0,0,0,1,1,5
HMKQY,0,0,0,1,1,5
MKQYV,0,0,0,1,1,5
KQYVS,0,0,0,1,1,5
QYVSD,0,0,0,1,1,5
YVSDN,0,0,0,1,1,5
DEAAF,0,0,0,1,1,5
EAAFQ,0,0,0,1,1,5
AAFQK,0,0,0,1,1,5
AFQKL,0,0,0,1,1,5
FQKLM,0,0,0,1,1,5
QKLMS,0,0,0,1,1,5
KLMSN,0,0,0,1,1,5
LMSNL,0,0,0,1,1,5
MSNLD,0,0,0,1,1,5
DEAGL,0,0,0,1,1,5
EAGLM,0,0,0,1,1,5
AGLMR,0,0,0,1,1,5
GLMRE,0,0,0,1,1,5
LMREL,0,0,0,1,1,5
MRELR,0,0,0,1,1,5
RELRL,0,0,0,1,1,5
ELRLF,0,0,0,1,1,5
LRLFR,0,0,0,1,1,5
RLFRR,0,0,0,1,1,5
LFRRR,0,0,0,1,1,5
FRRRI,0,0,0,1,1,5
RRRIM,0,0,0,1,1,5
RRIMV,0,0,0,1,1,5
RIMVR,0,0,0,1,1,5
IMVRI,0,0,0,1,1,5
MVRIA,0,0,0,1,1,5
VRIAW,0,0,0,1,1,5
RIAWA,0,0,0,1,1,5
IAWAQ,0,0,0,1,1,5
AWAQT,0,0,0,1,1,5
WAQTL,0,0,0,1,1,5
DEETM,0,0,0,1,1,5
EETME,0,0,0,1,1,5
ETMER,0,0,0,1,1,5
TMERI,0,0,0,1,1,5
MERIM,0,0,0,1,1,5
ERIMR,0,0,0,1,1,5
RIMRE,0,0,0,1,1,5
IMREL,0,0,0,1,1,5
MRELK,0,0,0,1,1,5
RELKK,0,0,0,1,1,5
ELKKK,0,0,0,2,2,5
DEFTK,0,0,0,1,1,5
EFTKQ,0,0,0,1,1,5
FTKQH,0,0,0,1,1,5
TKQHI,0,0,0,1,1,5
KQHIV,0,0,0,1,1,5
QHIVG,0,0,0,1,1,5
HIVGK,0,0,0,1,1,5
DEKAF,0,0,0,1,1,5
EKAFK,0,0,0,1,1,5
KAFKN,0,0,0,1,1,5
AFKNT,0,0,0,1,1,5
FKNTY,0,0,0,1,1,5
KNTYR,0,0,0,1,1,5
NTYRQ,0,0,0,1,1,5
TYRQA,0,0,0,1,1,5
YRQAM,0,0,0,1,1,5
RQAMN,0,0,0,1,1,5
QAMND,0,0,0,1,1,5
DEKKI,0,0,0,1,1,5
EKKIL,0,0,0,1,1,5
KKILK,0,0,0,1,1,5
KILKD,0,0,0,1,1,5
ILKDF,0,0,0,1,1,5
LKDFL,0,0,0,1,1,5
KDFLI,0,0,0,1,1,5
DFLIQ,0,0,0,1,1,5
DEKSI,0,0,0,1,1,5
EKSII,0,0,0,1,1,5
KSIIT,0,0,0,1,1,5
SIITY,0,0,0,1,1,5
IITYV,0,0,0,1,1,5
ITYVS,0,0,0,1,1,5
TYVSS,0,0,0,1,1,5
YVSSL,0,0,0,1,1,5
VSSLY,0,0,0,1,1,5
SSLYD,0,0,0,1,1,5
SLYDA,0,0,0,1,1,5
LYDAM,0,0,0,1,1,5
DELLS,0,0,0,1,1,5
ELLSK,0,0,0,1,1,5
LLSKM,0,0,0,1,1,5
LSKMR,0,0,0,1,1,5
SKMRF,0,0,0,1,1,5
KMRFA,0,0,0,1,1,5
MRFAL,0,0,0,1,1,5
DEPQV,0,0,0,1,1,5
EPQVQ,0,0,0,1,1,5
PQVQA,0,0,0,1,1,5
QVQAK,0,0,0,1,1,5
VQAKI,0,0,0,1,1,5
QAKIM,0,0,0,1,1,5
AKIMA,0,0,0,1,1,5
KIMAY,0,0,0,1,1,5
IMAYL,0,0,0,1,1,5
MAYLQ,0,0,0,1,1,5
AYLQQ,0,0,0,1,1,5
YLQQE,0,0,0,1,1,5
LQQEQ,0,0,0,1,1,5
QQEQS,0,0,0,1,1,5
QEQSN,0,0,0,1,1,5
EQSNR,0,0,0,1,1,5
DEQYR,0,0,0,1,1,5
EQYRE,0,0,0,1,1,5
QYREG,0,0,0,1,1,5
YREGA,0,0,0,1,1,5
REGAV,0,0,0,1,1,5
EGAVR,0,0,0,1,1,5
GAVRT,0,0,0,1,1,5
AVRTV,0,0,0,1,1,5
VRTVA,0,0,0,1,1,5
RTVAS,0,0,0,1,1,5
TVASF,0,0,0,1,1,5
VASFR,0,0,0,1,1,5
ASFRE,0,0,0,1,1,5
SFRER,0,0,0,1,1,5
FRERL,0,0,0,2,2,5
RERLD,0,0,0,1,1,5
ERLDR,0,0,0,1,1,5
DERLL,0,0,0,1,1,5
ERLLQ,0,0,0,1,1,5
RLLQK,0,0,0,1,1,5
LLQKY,0,0,0,1,1,5
LQKYR,0,0,0,1,1,5
QKYRA,0,0,0,1,1,5
KYRAQ,0,0,0,1,1,5
YRAQV,0,0,0,1,1,5
RAQVF,0,0,0,1,1,5
AQVFE,0,0,0,1,1,5
QVFEW,0,0,0,1,1,5
VFEWG,0,0,0,1,1,5
DEVLL,0,0,0,1,1,5
EVLLA,0,0,0,1,1,5
VLLAL,0,0,0,1,1,5
LLALA,0,0,0,1,1,5
ALAEQ,0,0,0,1,1,5
LAEQL,0,0,0,1,1,5
AEQLG,0,0,0,1,1,5
EQLGT,0,0,0,1,1,5
DFAAL,0,0,0,1,1,5
FAALA,0,0,0,1,1,5
AALAQ,0,0,0,1,1,5
ALAQT,0,0,0,1,1,5
LAQTA,0,0,0,1,1,5
AQTAH,0,0,0,1,1,5
QTAHR,0,0,0,1,1,5
TAHRL,0,0,0,1,1,5
AHRLK,0,0,0,1,1,5
HRLKG,0,0,0,1,1,5
RLKGV,0,0,0,1,1,5
LKGVF,0,0,0,1,1,5
KGVFA,0,0,0,1,1,5
GVFAM,0,0,0,1,1,5
VFAML,0,0,0,1,1,5
FAMLN,0,0,0,1,1,5
DFLEE,0,0,0,1,1,5
FLEEQ,0,0,0,1,1,5
LEEQY,0,0,0,1,1,5
EEQYK,0,0,0,1,1,5
EQYKG,0,0,0,1,1,5
QYKGQ,0,0,0,1,1,5
YKGQR,0,0,0,1,1,5
KGQRD,0,0,0,1,1,5
GQRDL,0,0,0,1,1,5
QRDLA,0,0,0,1,1,5
RDLAG,0,0,0,1,1,5
DLAGK,0,0,0,1,1,5
LAGKA,0,0,0,1,1,5
AGKAS,0,0,0,1,1,5
GKAST,0,0,0,1,1,5
KASTL,0,0,0,1,1,5
ASTLK,0,0,0,1,1,5
STLKK,0,0,0,1,1,5
DFPAL,0,0,0,1,1,5
FPALI,0,0,0,1,1,5
PALIK,0,0,0,1,1,5
ALIKQ,0,0,0,1,1,5
LIKQA,0,0,0,1,1,5
IKQAS,0,0,0,1,1,5
KQASL,0,0,0,1,1,5
QASLD,0,0,0,1,1,5
ASLDA,0,0,0,1,1,5
SLDAL,0,0,0,1,1,5
LDALF,0,0,0,1,1,5
DALFK,0,0,0,1,1,5
DFSET,0,0,0,1,1,5
FSETI,0,0,0,1,1,5
SETIN,0,0,0,1,1,5
ETINA,0,0,0,1,1,5
TINAY,0,0,0,1,1,5
INAYF,0,0,0,1,1,5
NAYFV,0,0,0,1,1,5
AYFVA,0,0,0,1,1,5
YFVAK,0,0,0,1,1,5
FVAKL,0,0,0,1,1,5
DGALK,0,0,0,1,1,5
GALKR,0,0,0,1,1,5
ALKRA,0,0,0,1,1,5
LKRAE,0,0,0,3,3,5
KRAEE,0,0,0,2,2,5
RAEEL,0,0,0,1,1,5
AEELK,0,0,0,2,2,5
EELKT,0,0,0,1,1,5
ELKTQ,0,0,0,1,1,5
LKTQA,0,0,0,1,1,5
KTQAN,0,0,0,1,1,5
TQAND,0,0,0,1,1,5
QANDY,0,0,0,1,1,5
ANDYF,0,0,0,1,1,5
NDYFK,0,0,0,1,1,5
DGFSV,0,0,0,1,1,5
GFSVL,0,0,0,1,1,5
FSVLM,0,0,0,1,1,5
SVLMR,0,0,0,1,1,5
VLMRA,0,0,0,1,1,5
LMRAM,0,0,0,1,1,5
MRAMQ,0,0,0,1,1,5
RAMQQ,0,0,0,1,1,5
DGGGF,0,0,0,1,1,5
GGGFV,0,0,0,1,1,5
GGFVI,0,0,0,1,1,5
GFVIS,0,0,0,1,1,5
FVISK,0,0,0,1,1,5
VISKH,0,0,0,1,1,5
ISKHP,0,0,0,1,1,5
SKHPV,0,0,0,1,1,5
KHPVR,0,0,0,1,1,5
HPVRL,0,0,0,1,1,5
PVRLA,0,0,0,1,1,5
VRLAK,0,0,0,1,1,5
RLAKK,0,0,0,1,1,5
AKKLN,0,0,0,1,1,5
KKLNR,0,0,0,1,1,5
DHAVL,0,0,0,1,1,5
HAVLE,0,0,0,1,1,5
AVLEV,0,0,0,1,1,5
VLEVL,0,0,0,1,1,5
LEVLA,0,0,0,1,1,5
EVLAT,0,0,0,1,1,5
VLATP,0,0,0,1,1,5
LATPV,0,0,0,1,1,5
ATPVR,0,0,0,1,1,5
TPVRE,0,0,0,1,1,5
PVREA,0,0,0,2,2,5
VREAL,0,0,0,1,1,5
REALL,0,0,0,1,1,5
EALLA,0,0,0,1,1,5
ALLAR,0,0,0,1,1,5
LLARF,0,0,0,1,1,5
LARFG,0,0,0,1,1,5
DIFDF,0,0,0,1,1,5
IFDFM,0,0,0,1,1,5
FDFME,0,0,0,1,1,5
DFMER,0,0,0,1,1,5
FMERW,0,0,0,1,1,5
MERWI,0,0,0,1,1,5
ERWIE,0,0,0,1,1,5
RWIEK,0,0,0,1,1,5
WIEKK,0,0,0,1,1,5
IEKKL,0,0,0,1,1,5
EKKLE,0,0,0,1,1,5
KKLEY,0,0,0,1,1,5
KLEYS,0,0,0,1,1,5
LEYSA,0,0,0,1,1,5
EYSAS,0,0,0,1,1,5
YSASH,0,0,0,1,1,5
DIHAA,0,0,0,1,1,5
IHAAI,0,0,0,1,1,5
HAAIE,0,0,0,1,1,5
AAIEM,0,0,0,1,1,5
AIEML,0,0,0,1,1,5
IEMLL,0,0,0,1,1,5
EMLLG,0,0,0,1,1,5
DIIGT,0,0,0,1,1,5
IIGTE,0,0,0,1,1,5
IGTEI,0,0,0,1,1,5
GTEIT,0,0,0,1,1,5
TEITS,0,0,0,1,1,5
EITSA,0,0,0,1,1,5
ITSAL,0,0,0,2,2,5
TSALK,0,0,0,1,1,5
SALKN,0,0,0,1,1,5
ALKNV,0,0,0,1,1,5
LKNVY,0,0,0,1,1,5
KNVYS,0,0,0,1,1,5
NVYSI,0,0,0,1,1,5
VYSIA,0,0,0,1,1,5
YSIAI,0,0,0,1,1,5
SIAIA,0,0,0,1,1,5
IAIAW,0,0,0,1,1,5
AIAWI,0,0,0,1,1,5
IAWIR,0,0,0,1,1,5
AWIRG,0,0,0,1,1,5
WIRGY,0,0,0,1,1,5
IRGYE,0,0,0,1,1,5
RGYES,0,0,0,1,1,5
GYESR,0,0,0,1,1,5
YESRK,0,0,0,1,1,5
ESRKN,0,0,0,1,1,5
DILRE,0,0,0,1,1,5
ILREI,0,0,0,1,1,5
LREIG,0,0,0,1,1,5
REIGM,0,0,0,1,1,5
EIGMI,0,0,0,1,1,5
IGMIA,0,0,0,1,1,5
GMIAR,0,0,0,1,1,5
MIARA,0,0,0,1,1,5
IARAL,0,0,0,1,1,5
ARALD,0,0,0,1,1,5
RALDS,0,0,0,1,1,5
ALDSI,0,0,0,1,1,5
LDSIS,0,0,0,1,1,5
DSISN,0,0,0,1,1,5
SISNI,0,0,0,1,1,5
ISNIE,0,0,0,1,1,5
SNIEF,0,0,0,1,1,5
DIRAV,0,0,0,1,1,5
IRAVL,0,0,0,1,1,5
RAVLR,0,0,0,1,1,5
AVLRD,0,0,0,1,1,5
VLRDL,0,0,0,1,1,5
LRDLS,0,0,0,1,1,5
RDLSF,0,0,0,1,1,5
DLSFH,0,0,0,1,1,5
LSFHL,0,0,0,1,1,5
SFHLN,0,0,0,1,1,5
FHLNG,0,0,0,1,1,5
HLNGH,0,0,0,1,1,5
LNGHI,0,0,0,1,1,5
NGHIL,0,0,0,1,1,5
GHILH,0,0,0,1,1,5
HILHS,0,0,0,1,1,5
ILHSI,0,0,0,1,1,5
LHSIF,0,0,0,1,1,5
HSIFW,0,0,0,1,1,5
SIFWP,0,0,0,1,1,5
IFWPN,0,0,0,1,1,5
FWPNM,0,0,0,1,1,5
DIRTS,0,0,0,1,1,5
IRTSL,0,0,0,1,1,5
RTSLA,0,0,0,1,1,5
TSLAN,0,0,0,1,1,5
SLAND,0,0,0,1,1,5
LANDM,0,0,0,1,1,5
ANDMA,0,0,0,1,1,5
NDMAI,0,0,0,1,1,5
DMAIY,0,0,0,1,1,5
MAIYG,0,0,0,1,1,5
AIYGD,0,0,0,1,1,5
IYGDI,0,0,0,1,1,5
YGDII,0,0,0,1,1,5
GDIIE,0,0,0,1,1,5
DIIEA,0,0,0,2,2,5
IIEAT,0,0,0,1,1,5
IEATR,0,0,0,1,1,5
EATRE,0,0,0,1,1,5
ATREH,0,0,0,1,1,5
TREHT,0,0,0,1,1,5
REHTE,0,0,0,1,1,5
EHTEL,0,0,0,1,1,5
HTELA,0,0,0,1,1,5
TELAE,0,0,0,1,1,5
ELAEN,0,0,0,1,1,5
LAENL,0,0,0,1,1,5
DIYQQ,0,0,0,1,1,5
IYQQV,0,0,0,1,1,5
YQQVR,0,0,0,1,1,5
QQVRD,0,0,0,1,1,5
QVRDE,0,0,0,1,1,5
VRDEL,0,0,0,1,1,5
RDELK,0,0,0,1,1,5
DELKR,0,0,0,1,1,5
ELKRA,0,0,0,1,1,5
LKRAS,0,0,0,1,1,5
DKETM,0,0,0,1,1,5
KETMN,0,0,0,1,1,5
ETMNI,0,0,0,1,1,5
TMNIH,0,0,0,1,1,5
MNIHH,0,0,0,1,1,5
NIHHT,0,0,0,1,1,5
IHHTK,0,0,0,1,1,5
DLAAN,0,0,0,1,1,5
LAANN,0,0,0,1,1,5
AANNG,0,0,0,1,1,5
ANNGG,0,0,0,1,1,5
NNGGW,0,0,0,1,1,5
NGGWQ,0,0,0,1,1,5
GGWQW,0,0,0,1,1,5
GWQWS,0,0,0,1,1,5
DLARI,0,0,0,1,1,5
LARIE,0,0,0,1,1,5
ARIEQ,0,0,0,1,1,5
RIEQF,0,0,0,1,1,5
IEQFL,0,0,0,1,1,5
EQFLD,0,0,0,1,1,5
QFLDA,0,0,0,1,1,5
FLDAL,0,0,0,1,1,5
LDALW,0,0,0,1,1,5
DALWL,0,0,0,1,1,5
ALWLE,0,0,0,1,1,5
DLEAK,0,0,0,1,1,5
LEAKK,0,0,0,1,1,5
EAKKM,0,0,0,1,1,5
AKKMY,0,0,0,1,1,5
KKMYF,0,0,0,1,1,5
KMYFD,0,0,0,1,1,5
MYFDA,0,0,0,1,1,5
YFDAV,0,0,0,1,1,5
FDAVQ,0,0,0,1,1,5
DAVQA,0,0,0,1,1,5
AVQAI,0,0,0,1,1,5
VQAIE,0,0,0,1,1,5
QAIET,0,0,0,1,1,5
AIETH,0,0,0,1,1,5
IETHL,0,0,0,1,1,5
DLESD,0,0,0,1,1,5
LESDA,0,0,0,1,1,5
ESDAL,0,0,0,1,1,5
SDALG,0,0,0,1,1,5
DALGW,0,0,0,1,1,5
ALGWQ,0,0,0,1,1,5
LGWQY,0,0,0,1,1,5
GWQYI,0,0,0,1,1,5
WQYIT,0,0,0,1,1,5
QYITG,0,0,0,1,1,5
DLGRK,0,0,0,1,1,5
LGRKI,0,0,0,1,1,5
GRKIT,0,0,0,1,1,5
RKITS,0,0,0,1,1,5
KITSA,0,0,0,1,1,5
TSALR,0,0,0,1,1,5
SALRS,0,0,0,1,1,5
ALRSL,0,0,0,1,1,5
LRSLS,0,0,0,1,1,5
RSLSN,0,0,0,1,1,5
DLKQA,0,0,0,1,1,5
LKQAE,0,0,0,1,1,5
KQAES,0,0,0,1,1,5
QAESW,0,0,0,1,1,5
AESWL,0,0,0,1,1,5
ESWLH,0,0,0,1,1,5
SWLHK,0,0,0,1,1,5
WLHKQ,0,0,0,1,1,5
LHKQA,0,0,0,1,1,5
HKQAQ,0,0,0,1,1,5
KQAQK,0,0,0,1,1,5
QAQKE,0,0,0,1,1,5
AQKEG,0,0,0,1,1,5
QKEGW,0,0,0,1,1,5
KEGWS,0,0,0,1,1,5
EGWSK,0,0,0,1,1,5
GWSKA,0,0,0,1,1,5
WSKAA,0,0,0,1,1,5
SKAAR,0,0,0,1,1,5
KAARL,0,0,0,1,1,5
AARLH,0,0,0,1,1,5
DLKRA,0,0,0,1,1,5
KRAES,0,0,0,1,1,5
RAESM,0,0,0,1,1,5
AESML,0,0,0,1,1,5
ESMLQ,0,0,0,1,1,5
SMLQQ,0,0,0,1,1,5
MLQQA,0,0,0,1,1,5
DLKTM,0,0,0,1,1,5
LKTMT,0,0,0,1,1,5
KTMTE,0,0,0,1,1,5
TMTER,0,0,0,1,1,5
MTERL,0,0,0,1,1,5
TERLR,0,0,0,1,1,5
ERLRS,0,0,0,1,1,5
DLQLN,0,0,0,1,1,5
LQLNA,0,0,0,1,1,5
QLNAN,0,0,0,1,1,5
LNANA,0,0,0,1,1,5
NANAE,0,0,0,1,1,5
ANAER,0,0,0,1,1,5
NAERI,0,0,0,1,1,5
AERIN,0,0,0,1,1,5
ERINV,0,0,0,1,1,5
RINVY,0,0,0,1,1,5
INVYY,0,0,0,1,1,5
DLREL,0,0,0,1,1,5
LRELI,0,0,0,1,1,5
RELIA,0,0,0,1,1,5
ELIAR,0,0,0,1,1,5
LIARV,0,0,0,1,1,5
IARVR,0,0,0,1,1,5
ARVRA,0,0,0,1,1,5
RVRAL,0,0,0,1,1,5
VRALI,0,0,0,1,1,5
RALIR,0,0,0,1,1,5
ALIRR,0,0,0,1,1,5
LIRRK,0,0,0,1,1,5
IRRKS,0,0,0,1,1,5
DLSAS,0,0,0,1,1,5
LSASR,0,0,0,1,1,5
SASRS,0,0,0,1,1,5
ASRSA,0,0,0,1,1,5
SRSAI,0,0,0,1,1,5
RSAID,0,0,0,1,1,5
SAIDS,0,0,0,1,1,5
AIDSL,0,0,0,1,1,5
IDSLN,0,0,0,1,1,5
DSLNN,0,0,0,1,1,5
SLNNR,0,0,0,1,1,5
LNNRM,0,0,0,1,1,5
NNRML,0,0,0,1,1,5
NRMLS,0,0,0,1,1,5
RMLSQ,0,0,0,1,1,5
MLSQI,0,0,0,1,1,5
LSQIW,0,0,0,1,1,5
SQIWS,0,0,0,1,1,5
QIWSH,0,0,0,1,1,5
DLVDF,0,0,0,1,1,5
LVDFA,0,0,0,1,1,5
VDFAV,0,0,0,1,1,5
DFAVE,0,0,0,1,1,5
FAVEY,0,0,0,1,1,5
AVEYF,0,0,0,1,1,5
VEYFT,0,0,0,1,1,5
EYFTR,0,0,0,1,1,5
YFTRL,0,0,0,1,1,5
FTRLR,0,0,0,1,1,5
TRLRE,0,0,0,1,1,5
RLREA,0,0,0,1,1,5
LREAR,0,0,0,1,1,5
REARR,0,0,0,1,1,5
EARRG,0,0,0,1,1,5
ARRGL,0,0,0,1,1,5
RRGLE,0,0,0,1,1,5
RGLEH,0,0,0,1,1,5
GLEHH,0,0,0,1,1,5
LEHHH,0,0,0,1,1,5
DMASL,0,0,0,1,1,5
MASLQ,0,0,0,1,1,5
ASLQQ,0,0,0,1,1,5
SLQQQ,0,0,0,1,1,5
LQQQR,0,0,0,1,1,5
QQQRQ,0,0,0,1,1,5
QQRQE,0,0,0,1,1,5
DMNQV,0,0,0,1,1,5
MNQVL,0,0,0,1,1,5
NQVLD,0,0,0,1,1,5
QVLDA,0,0,0,1,1,5
VLDAY,0,0,0,1,1,5
LDAYE,0,0,0,1,1,5
DAYEN,0,0,0,1,1,5
DNAMA,0,0,0,1,1,5
NAMAN,0,0,0,1,1,5
AMANQ,0,0,0,1,1,5
MANQY,0,0,0,1,1,5
ANQYE,0,0,0,1,1,5
NQYET,0,0,0,1,1,5
QYETL,0,0,0,1,1,5
YETLA,0,0,0,1,1,5
ETLAN,0,0,0,1,1,5
TLANA,0,0,0,1,1,5
LANAR,0,0,0,1,1,5
ANARQ,0,0,0,1,1,5
NARQK,0,0,0,1,1,5
ARQKG,0,0,0,1,1,5
RQKGI,0,0,0,1,1,5
QKGIE,0,0,0,1,1,5
KGIEK,0,0,0,1,1,5
GIEKY,0,0,0,1,1,5
IEKYL,0,0,0,1,1,5
DNKTR,0,0,0,1,1,5
NKTRF,0,0,0,1,1,5
KTRFK,0,0,0,1,1,5
TRFKI,0,0,0,1,1,5
RFKII,0,0,0,1,1,5
FKIIK,0,0,0,1,1,5
KIIKE,0,0,0,1,1,5
IIKEK,0,0,0,1,1,5
IKEKL,0,0,0,1,1,5
KEKLK,0,0,0,1,1,5
EKLKE,0,0,0,1,1,5
KLKEF,0,0,0,1,1,5
DNTYL,0,0,0,1,1,5
NTYLN,0,0,0,1,1,5
TYLNT,0,0,0,1,1,5
YLNTA,0,0,0,1,1,5
LNTAE,0,0,0,1,1,5
NTAES,0,0,0,1,1,5
TAESL,0,0,0,1,1,5
AESLY,0,0,0,1,1,5
ESLYD,0,0,0,1,1,5
SLYDE,0,0,0,1,1,5
LYDEF,0,0,0,1,1,5
DNVVL,0,0,0,1,1,5
NVVLQ,0,0,0,1,1,5
VVLQL,0,0,0,1,1,5
VLQLQ,0,0,0,1,1,5
LQLQV,0,0,0,1,1,5
QLQVA,0,0,0,1,1,5
LQVAR,0,0,0,1,1,5
QVARF,0,0,0,1,1,5
VARFL,0,0,0,1,1,5
ARFLM,0,0,0,1,1,5
RFLMK,0,0,0,1,1,5
FLMKT,0,0,0,1,1,5
LMKTV,0,0,0,1,1,5
MKTVA,0,0,0,1,1,5
KTVAQ,0,0,0,1,1,5
DPARA,0,0,0,1,1,5
PARAL,0,0,0,2,2,5
ARALF,0,0,0,1,1,5
RALFA,0,0,0,1,1,5
ALFAA,0,0,0,1,1,5
LFAAM,0,0,0,1,1,5
FAAMS,0,0,0,1,1,5
AAMSQ,0,0,0,1,1,5
DPATV,0,0,0,1,1,5
PATVK,0,0,0,1,1,5
ATVKK,0,0,0,1,1,5
TVKKV,0,0,0,1,1,5
KKVVN,0,0,0,1,1,5
KVVNF,0,0,0,1,1,5
VVNFL,0,0,0,1,1,5
DPAWQ,0,0,0,1,1,5
PAWQG,0,0,0,1,1,5
AWQGF,0,0,0,1,1,5
WQGFR,0,0,0,1,1,5
QGFRE,0,0,0,1,1,5
GFREL,0,0,0,1,1,5
FRELI,0,0,0,1,1,5
RELIE,0,0,0,2,2,5
ELIEK,0,0,0,1,1,5
LIEKA,0,0,0,1,1,5
IEKAL,0,0,0,1,1,5
DPEKV,0,0,0,1,1,5
PEKVL,0,0,0,1,1,5
EKVLF,0,0,0,1,1,5
KVLFL,0,0,0,1,1,5
VLFLA,0,0,0,1,1,5
LFLAG,0,0,0,2,2,5
FLAGN,0,0,0,1,1,5
LAGNL,0,0,0,1,1,5
AGNLL,0,0,0,1,1,5
GNLLA,0,0,0,1,1,5
NLLAR,0,0,0,1,1,5
LLARL,0,0,0,1,1,5
LARLT,0,0,0,2,2,5
ARLTE,0,0,0,1,1,5
DPETL,0,0,0,1,1,5
PETLE,0,0,0,1,1,5
ETLEA,0,0,0,1,1,5
TLEAI,0,0,0,1,1,5
LEAIA,0,0,0,1,1,5
EAIAE,0,0,0,2,2,5
AIAEN,0,0,0,1,1,5
DPETN,0,0,0,1,1,5
PETNI,0,0,0,1,1,5
ETNIN,0,0,0,1,1,5
TNINI,0,0,0,1,1,5
NINIG,0,0,0,1,1,5
INIGT,0,0,0,1,1,5
NIGTS,0,0,0,1,1,5
IGTSY,0,0,0,1,1,5
GTSYL,0,0,0,1,1,5
TSYLQ,0,0,0,1,1,5
SYLQY,0,0,0,1,1,5
YLQYV,0,0,0,1,1,5
LQYVY,0,0,0,1,1,5
QYVYQ,0,0,0,1,1,5
YVYQQ,0,0,0,1,1,5
VYQQF,0,0,0,1,1,5
DPKRL,0,0,0,1,1,5
PKRLQ,0,0,0,1,1,5
KRLQA,0,0,0,1,1,5
RLQAS,0,0,0,1,1,5
LQASL,0,0,0,1,1,5
QASLQ,0,0,0,1,1,5
ASLQT,0,0,0,1,1,5
SLQTI,0,0,0,1,1,5
LQTIV,0,0,0,1,1,5
QTIVG,0,0,0,1,1,5
TIVGM,0,0,0,1,1,5
IVGMV,0,0,0,1,1,5
VGMVV,0,0,0,1,1,5
GMVVY,0,0,0,1,1,5
MVVYS,0,0,0,1,1,5
VVYSW,0,0,0,1,1,5
DPLRE,0,0,0,1,1,5
PLRER,0,0,0,1,1,5
LRERQ,0,0,0,1,1,5
RERQV,0,0,0,1,1,5
ERQVA,0,0,0,1,1,5
RQVAE,0,0,0,2,2,5
QVAEK,0,0,0,1,1,5
VAEKQ,0,0,0,1,1,5
AEKQL,0,0,0,1,1,5
EKQLA,0,0,0,1,1,5
KQLAA,0,0,0,1,1,5
QLAAL,0,0,0,1,1,5
LAALG,0,0,0,1,1,5
AALGD,0,0,0,1,1,5
ALGDI,0,0,0,1,1,5
LGDIL,0,0,0,1,1,5
GDILS,0,0,0,1,1,5
DILSA,0,0,0,1,1,5
DPLWK,0,0,0,1,1,5
PLWKK,0,0,0,1,1,5
LWKKE,0,0,0,1,1,5
WKKEM,0,0,0,1,1,5
KKEMF,0,0,0,1,1,5
KEMFE,0,0,0,1,1,5
EMFEK,0,0,0,1,1,5
MFEKY,0,0,0,1,1,5
FEKYL,0,0,0,1,1,5
EKYLS,0,0,0,1,1,5
KYLSN,0,0,0,1,1,5
DPQKA,0,0,0,1,1,5
PQKAD,0,0,0,1,1,5
QKADA,0,0,0,1,1,5
KADAV,0,0,0,1,1,5
ADAVA,0,0,0,1,1,5
DAVAV,0,0,0,1,1,5
AVAVN,0,0,0,1,1,5
DPQKR,0,0,0,1,1,5
PQKRA,0,0,0,1,1,5
QKRAV,0,0,0,1,1,5
KRAVV,0,0,0,1,1,5
RAVVN,0,0,0,1,1,5
AVVNQ,0,0,0,1,1,5
VVNQR,0,0,0,1,1,5
VNQRL,0,0,0,1,1,5
NQRLY,0,0,0,1,1,5
QRLYF,0,0,0,1,1,5
RLYFD,0,0,0,1,1,5
LYFDM,0,0,0,1,1,5
YFDMG,0,0,0,1,1,5
FDMGT,0,0,0,1,1,5
DPTKL,0,0,0,1,1,5
PTKLN,0,0,0,1,1,5
TKLNH,0,0,0,1,1,5
KLNHA,0,0,0,1,1,5
LNHAV,0,0,0,1,1,5
NHAVA,0,0,0,1,1,5
HAVAG,0,0,0,1,1,5
AVAGL,0,0,0,1,1,5
DPYVI,0,0,0,1,1,5
PYVIL,0,0,0,1,1,5
YVILI,0,0,0,1,1,5
VILIT,0,0,0,1,1,5
ILITE,0,0,0,1,1,5
LITEI,0,0,0,1,1,5
ITEIL,0,0,0,1,1,5
TEILL,0,0,0,1,1,5
DQDKI,0,0,0,1,1,5
QDKIQ,0,0,0,1,1,5
DKIQK,0,0,0,1,1,5
KIQKA,0,0,0,1,1,5
IQKAI,0,0,0,1,1,5
QKAIA,0,0,0,1,1,5
KAIAA,0,0,0,1,1,5
AIAAG,0,0,0,1,1,5
DQEDV,0,0,0,1,1,5
QEDVA,0,0,0,1,1,5
EDVAQ,0,0,0,2,2,5
DVAQT,0,0,0,1,1,5
VAQTI,0,0,0,1,1,5
AQTIR,0,0,0,1,1,5
QTIRD,0,0,0,1,1,5
TIRDY,0,0,0,1,1,5
IRDYD,0,0,0,1,1,5
DQGTL,0,0,0,1,1,5
QGTLF,0,0,0,1,1,5
GTLFE,0,0,0,1,1,5
TLFEL,0,0,0,1,1,5
LFELI,0,0,0,1,1,5
FELIL,0,0,0,1,1,5
ELILA,0,0,0,1,1,5
LILAA,0,0,0,1,1,5
ILAAN,0,0,0,1,1,5
LAANY,0,0,0,1,1,5
AANYL,0,0,0,1,1,5
ANYLD,0,0,0,1,1,5
DQHLM,0,0,0,1,1,5
QHLMA,0,0,0,1,1,5
HLMAE,0,0,0,1,1,5
LMAEY,0,0,0,1,1,5
MAEYR,0,0,0,1,1,5
AEYRE,0,0,0,1,1,5
EYREL,0,0,0,1,1,5
YRELP,0,0,0,1,1,5
RELPR,0,0,0,1,1,5
ELPRV,0,0,0,1,1,5
LPRVF,0,0,0,1,1,5
PRVFG,0,0,0,1,1,5
RVFGA,0,0,0,1,1,5
VFGAV,0,0,0,1,1,5
FGAVR,0,0,0,1,1,5
GAVRK,0,0,0,1,1,5
AVRKH,0,0,0,1,1,5
VRKHV,0,0,0,1,1,5
RKHVA,0,0,0,2,2,5
KHVAN,0,0,0,1,1,5
HVANG,0,0,0,1,1,5
DQNGE,0,0,0,1,1,5
QNGEI,0,0,0,1,1,5
NGEIY,0,0,0,1,1,5
GEIYM,0,0,0,1,1,5
EIYMW,0,0,0,1,1,5
IYMWP,0,0,0,1,1,5
YMWPV,0,0,0,1,1,5
MWPVA,0,0,0,1,1,5
WPVAQ,0,0,0,1,1,5
PVAQA,0,0,0,1,1,5
DQQGV,0,0,0,1,1,5
QQGVF,0,0,0,1,1,5
QGVFV,0,0,0,1,1,5
GVFVK,0,0,0,1,1,5
VFVKG,0,0,0,1,1,5
FVKGY,0,0,0,1,1,5
VKGYA,0,0,0,1,1,5
KGYAM,0,0,0,1,1,5
DRASY,0,0,0,1,1,5
RASYE,0,0,0,1,1,5
ASYEA,0,0,0,1,1,5
SYEAR,0,0,0,1,1,5
YEARE,0,0,0,1,1,5
EARER,0,0,0,1,1,5
ARERH,0,0,0,1,1,5
RERHV,0,0,0,1,1,5
ERHVA,0,0,0,1,1,5
RHVAE,0,0,0,1,1,5
HVAER,0,0,0,2,2,5
VAERL,0,0,0,1,1,5
AERLL,0,0,0,1,1,5
ERLLM,0,0,0,1,1,5
RLLMH,0,0,0,1,1,5
LLMHL,0,0,0,1,1,5
LMHLE,0,0,0,1,1,5
MHLEE,0,0,0,1,1,5
HLEEM,0,0,0,1,1,5
DRAVI,0,0,0,1,1,5
RAVIE,0,0,0,1,1,5
AVIEH,0,0,0,1,1,5
VIEHN,0,0,0,1,1,5
IEHNL,0,0,0,1,1,5
EHNLL,0,0,0,1,1,5
HNLLS,0,0,0,1,1,5
NLLSA,0,0,0,1,1,5
LLSAS,0,0,0,1,1,5
LSASK,0,0,0,1,1,5
SASKL,0,0,0,1,1,5
DRQLR,0,0,0,1,1,5
RQLRS,0,0,0,1,1,5
QLRSS,0,0,0,1,1,5
LRSSI,0,0,0,1,1,5
RSSIE,0,0,0,1,1,5
SSIER,0,0,0,1,1,5
SIERV,0,0,0,1,1,5
IERVI,0,0,0,1,1,5
ERVIS,0,0,0,1,1,5
RVISI,0,0,0,1,1,5
VISIF,0,0,0,1,1,5
ISIFQ,0,0,0,1,1,5
SIFQS,0,0,0,1,1,5
DRTSF,0,0,0,1,1,5
RTSFD,0,0,0,1,1,5
TSFDK,0,0,0,1,1,5
SFDKL,0,0,0,1,1,5
FDKLA,0,0,0,1,1,5
DKLAN,0,0,0,1,1,5
KLANS,0,0,0,1,1,5
DSEQV,0,0,0,1,1,5
SEQVV,0,0,0,1,1,5
EQVVH,0,0,0,1,1,5
QVVHQ,0,0,0,1,1,5
VVHQL,0,0,0,1,1,5
VHQLE,0,0,0,1,1,5
HQLER,0,0,0,1,1,5
QLERL,0,0,0,1,1,5
LERLI,0,0,0,1,1,5
ERLIA,0,0,0,2,2,5
RLIAR,0,0,0,1,1,5
DSGYR,0,0,0,1,1,5
SGYRS,0,0,0,1,1,5
GYRSA,0,0,0,1,1,5
YRSAM,0,0,0,1,1,5
RSAMS,0,0,0,1,1,5
SAMSV,0,0,0,1,1,5
AMSVQ,0,0,0,1,1,5
MSVQS,0,0,0,1,1,5
SVQSS,0,0,0,1,1,5
VQSSL,0,0,0,1,1,5
DSMVV,0,0,0,1,1,5
SMVVL,0,0,0,1,1,5
MVVLQ,0,0,0,1,1,5
VVLQQ,0,0,0,1,1,5
VLQQR,0,0,0,1,1,5
LQQRA,0,0,0,1,1,5
QQRAY,0,0,0,1,1,5
QRAYE,0,0,0,1,1,5
RAYEI,0,0,0,1,1,5
AYEIL,0,0,0,1,1,5
YEILM,0,0,0,1,1,5
EILMT,0,0,0,1,1,5
ILMTI,0,0,0,1,1,5
LMTIM,0,0,0,1,1,5
MTIME,0,0,0,1,1,5
DSSVI,0,0,0,1,1,5
SSVII,0,0,0,1,1,5
SVIIS,0,0,0,1,1,5
VIISA,0,0,0,1,1,5
IISAL,0,0,0,1,1,5
ISALK,0,0,0,1,1,5
SALKT,0,0,0,1,1,5
ALKTY,0,0,0,1,1,5
LKTYL,0,0,0,1,1,5
KTYLV,0,0,0,1,1,5
TYLVS,0,0,0,1,1,5
YLVSG,0,0,0,1,1,5
DSVAS,0,0,0,1,1,5
SVASL,0,0,0,1,1,5
VASLL,0,0,0,1,1,5
ASLLD,0,0,0,1,1,5
SLLDV,0,0,0,1,1,5
LLDVV,0,0,0,1,1,5
LDVVK,0,0,0,1,1,5
DVVKS,0,0,0,1,1,5
VVKST,0,0,0,1,1,5
VKSTG,0,0,0,1,1,5
DSVTN,0,0,0,1,1,5
SVTND,0,0,0,1,1,5
VTNDI,0,0,0,1,1,5
TNDIF,0,0,0,1,1,5
NDIFN,0,0,0,1,1,5
DIFNV,0,0,0,1,1,5
IFNVA,0,0,0,1,1,5
FNVAK,0,0,0,1,1,5
NVAKA,0,0,0,1,1,5
VAKAS,0,0,0,1,1,5
AKASI,0,0,0,1,1,5
KASIE,0,0,0,1,1,5
ASIEK,0,0,0,1,1,5
SIEKH,0,0,0,1,1,5
IEKHI,0,0,0,1,1,5
EKHIW,0,0,0,1,1,5
KHIWM,0,0,0,1,1,5
HIWML,0,0,0,1,1,5
IWMLQ,0,0,0,1,1,5
WMLQA,0,0,0,1,1,5
MLQAE,0,0,0,1,1,5
LQAEL,0,0,0,1,1,5
DTAFL,0,0,0,1,1,5
TAFLM,0,0,0,1,1,5
AFLME,0,0,0,1,1,5
FLMEQ,0,0,0,1,1,5
LMEQL,0,0,0,1,1,5
MEQLE,0,0,0,1,1,5
EQLEL,0,0,0,1,1,5
QLELR,0,0,0,1,1,5
LELRE,0,0,0,1,1,5
ELREE,0,0,0,1,1,5
LREEL,0,0,0,1,1,5
REELD,0,0,0,1,1,5
EELDE,0,0,0,1,1,5
ELDEI,0,0,0,1,1,5
LDEIE,0,0,0,1,1,5
DEIEQ,0,0,0,1,1,5
EIEQA,0,0,0,1,1,5
IEQAK,0,0,0,2,2,5
DTMKD,0,0,0,1,1,5
TMKDA,0,0,0,1,1,5
MKDAG,0,0,0,1,1,5
KDAGM,0,0,0,1,1,5
DAGMQ,0,0,0,1,1,5
AGMQM,0,0,0,1,1,5
GMQMK,0,0,0,1,1,5
MQMKK,0,0,0,1,1,5
QMKKV,0,0,0,1,1,5
MKKVL,0,0,0,1,1,5
KKVLD,0,0,0,1,1,5
KVLDS,0,0,0,1,1,5
DTRAW,0,0,0,1,1,5
TRAWA,0,0,0,1,1,5
RAWAL,0,0,0,1,1,5
AWALA,0,0,0,1,1,5
WALAE,0,0,0,1,1,5
ALAEK,0,0,0,1,1,5
LAEKL,0,0,0,1,1,5
AEKLF,0,0,0,1,1,5
EKLFG,0,0,0,1,1,5
DVALA,0,0,0,1,1,5
VALAD,0,0,0,1,1,5
ALADS,0,0,0,1,1,5
LADSF,0,0,0,1,1,5
ADSFD,0,0,0,1,1,5
DSFDA,0,0,0,1,1,5
SFDAL,0,0,0,1,1,5
DVEAV,0,0,0,1,1,5
VEAVE,0,0,0,1,1,5
EAVEI,0,0,0,2,2,5
AVEIM,0,0,0,1,1,5
VEIMQ,0,0,0,1,1,5
EIMQR,0,0,0,1,1,5
IMQRI,0,0,0,1,1,5
MQRIH,0,0,0,1,1,5
QRIHV,0,0,0,1,1,5
RIHVL,0,0,0,1,1,5
IHVLR,0,0,0,1,1,5
HVLRS,0,0,0,1,1,5
VLRSQ,0,0,0,1,1,5
LRSQG,0,0,0,1,1,5
RSQGG,0,0,0,1,1,5
SQGGF,0,0,0,1,1,5
QGGFN,0,0,0,1,1,5
DVLAE,0,0,0,1,1,5
VLAED,0,0,0,1,1,5
LAEDT,0,0,0,1,1,5
AEDTI,0,0,0,1,1,5
EDTIT,0,0,0,1,1,5
DTITA,0,0,0,1,1,5
TITAL,0,0,0,1,1,5
ITALL,0,0,0,1,1,5
TALLH,0,0,0,1,1,5
DVRVK,0,0,0,1,1,5
VRVKE,0,0,0,1,1,5
RVKEY,0,0,0,1,1,5
VKEYF,0,0,0,1,1,5
KEYFD,0,0,0,1,1,5
EYFDD,0,0,0,1,1,5
YFDDI,0,0,0,1,1,5
FDDIA,0,0,0,1,1,5
DDIAR,0,0,0,1,1,5
DIARY,0,0,0,1,1,5
IARYF,0,0,0,1,1,5
ARYFS,0,0,0,1,1,5
RYFSI,0,0,0,1,1,5
YFSIG,0,0,0,1,1,5
FSIGL,0,0,0,1,1,5
SIGLL,0,0,0,1,1,5
IGLLN,0,0,0,1,1,5
GLLNL,0,0,0,1,1,5
LLNLI,0,0,0,1,1,5
LNLIH,0,0,0,1,1,5
NLIHL,0,0,0,1,1,5
LIHLF,0,0,0,1,1,5
IHLFG,0,0,0,1,1,5
DWGEA,0,0,0,1,1,5
WGEAF,0,0,0,1,1,5
GEAFT,0,0,0,1,1,5
EAFTA,0,0,0,1,1,5
AFTAI,0,0,0,1,1,5
FTAIN,0,0,0,1,1,5
TAINL,0,0,0,1,1,5
DWLKR,0,0,0,1,1,5
WLKRL,0,0,0,1,1,5
LKRLQ,0,0,0,1,1,5
KRLQK,0,0,0,1,1,5
RLQKI,0,0,0,1,1,5
LQKIF,0,0,0,1,1,5
QKIFP,0,0,0,1,1,5
KIFPP,0,0,0,1,1,5
IFPPI,0,0,0,1,1,5
FPPIL,0,0,0,1,1,5
PPILS,0,0,0,1,1,5
PILSI,0,0,0,1,1,5
DWYRT,0,0,0,1,1,5
WYRTY,0,0,0,1,1,5
YRTYA,0,0,0,1,1,5
RTYAE,0,0,0,1,1,5
TYAEL,0,0,0,1,1,5
YAELR,0,0,0,1,1,5
AELRE,0,0,0,1,1,5
ELRET,0,0,0,1,1,5
LRETA,0,0,0,1,1,5
DYERF,0,0,0,1,1,5
YERFK,0,0,0,1,1,5
ERFKS,0,0,0,1,1,5
RFKSY,0,0,0,1,1,5
FKSYI,0,0,0,1,1,5
KSYIQ,0,0,0,1,1,5
SYIQT,0,0,0,1,1,5
YIQTL,0,0,0,1,1,5
EALVH,0,0,0,1,1,5
ALVHK,0,0,0,1,1,5
LVHKL,0,0,0,2,2,5
VHKLT,0,0,0,1,1,5
HKLTE,0,0,0,1,1,5
KLTER,0,0,0,1,1,5
LTERM,0,0,0,1,1,5
EAQKI,0,0,0,1,1,5
AQKID,0,0,0,1,1,5
QKIDR,0,0,0,1,1,5
KIDRL,0,0,0,1,1,5
IDRLV,0,0,0,1,1,5
DRLVQ,0,0,0,1,1,5
RLVQS,0,0,0,1,1,5
LVQSF,0,0,0,1,1,5
VQSFS,0,0,0,1,1,5
QSFSG,0,0,0,1,1,5
SFSGA,0,0,0,1,1,5
FSGAY,0,0,0,1,1,5
SGAYF,0,0,0,1,1,5
GAYFQ,0,0,0,1,1,5
AYFQQ,0,0,0,1,1,5
YFQQN,0,0,0,1,1,5
EDDIM,0,0,0,1,1,5
DDIMY,0,0,0,1,1,5
DIMYL,0,0,0,1,1,5
IMYLM,0,0,0,1,1,5
EDDSK,0,0,0,1,1,5
DDSKL,0,0,0,1,1,5
DSKLA,0,0,0,1,1,5
SKLAS,0,0,0,1,1,5
KLASR,0,0,0,1,1,5
LASRK,0,0,0,1,1,5
ASRKY,0,0,0,1,1,5
SRKYA,0,0,0,1,1,5
RKYAR,0,0,0,1,1,5
KYARI,0,0,0,1,1,5
YARII,0,0,0,1,1,5
ARIIQ,0,0,0,1,1,5
RIIQK,0,0,0,1,1,5
IIQKI,0,0,0,1,1,5
EDKEA,0,0,0,1,1,5
DKEAV,0,0,0,1,1,5
KEAVF,0,0,0,1,1,5
EAVFD,0,0,0,1,1,5
AVFDV,0,0,0,1,1,5
VFDVV,0,0,0,1,1,5
FDVVD,0,0,0,1,1,5
DVVDT,0,0,0,1,1,5
VVDTL,0,0,0,1,1,5
VDTLT,0,0,0,1,1,5
DTLTA,0,0,0,1,1,5
TLTAV,0,0,0,1,1,5
LTAVL,0,0,0,1,1,5
TAVLQ,0,0,0,1,1,5
AVLQV,0,0,0,1,1,5
VLQVA,0,0,0,1,1,5
LQVAT,0,0,0,1,1,5
QVATG,0,0,0,1,1,5
VATGV,0,0,0,1,1,5
ATGVI,0,0,0,1,1,5
TGVIS,0,0,0,1,1,5
GVIST,0,0,0,1,1,5
VISTL,0,0,0,1,1,5
EDLPK,0,0,0,1,1,5
DLPKW,0,0,0,1,1,5
LPKWS,0,0,0,1,1,5
PKWSG,0,0,0,1,1,5
KWSGY,0,0,0,1,1,5
WSGYF,0,0,0,1,1,5
SGYFE,0,0,0,1,1,5
GYFEK,0,0,0,1,1,5
YFEKL,0,0,0,1,1,5
FEKLL,0,0,0,1,1,5
EKLLK,0,0,0,2,2,5
LLKKN,0,0,0,1,1,5
EDMIF,0,0,0,1,1,5
DMIFE,0,0,0,1,1,5
MIFEI,0,0,0,1,1,5
IFEIF,0,0,0,1,1,5
FEIFK,0,0,0,1,1,5
EIFKN,0,0,0,1,1,5
IFKNY,0,0,0,1,1,5
FKNYL,0,0,0,1,1,5
KNYLT,0,0,0,1,1,5
NYLTK,0,0,0,1,1,5
YLTKV,0,0,0,1,1,5
LTKVA,0,0,0,1,1,5
TKVAY,0,0,0,1,1,5
KVAYY,0,0,0,1,1,5
VAYYA,0,0,0,1,1,5
AYYAR,0,0,0,1,1,5
YYARQ,0,0,0,1,1,5
YARQV,0,0,0,1,1,5
ARQVA,0,0,0,1,1,5
QVAEM,0,0,0,1,1,5
VAEMN,0,0,0,1,1,5
EDNLL,0,0,0,1,1,5
DNLLR,0,0,0,1,1,5
NLLRQ,0,0,0,1,1,5
LLRQL,0,0,0,1,1,5
LRQLA,0,0,0,1,1,5
RQLAQ,0,0,0,1,1,5
QLAQK,0,0,0,1,1,5
LAQKV,0,0,0,1,1,5
EELHT,0,0,0,1,1,5
ELHTS,0,0,0,1,1,5
LHTSL,0,0,0,1,1,5
HTSLV,0,0,0,1,1,5
TSLVE,0,0,0,1,1,5
SLVEE,0,0,0,2,2,5
LVEEL,0,0,0,2,2,5
EEMIA,0,0,0,1,1,5
EMIAE,0,0,0,1,1,5
MIAEF,0,0,0,1,1,5
IAEFK,0,0,0,1,1,5
AEFKA,0,0,0,1,1,5
EFKAA,0,0,0,1,1,5
FKAAF,0,0,0,1,1,5
KAAFD,0,0,0,1,1,5
AAFDM,0,0,0,1,1,5
AFDMF,0,0,0,1,1,5
EERVK,0,0,0,1,1,5
ERVKN,0,0,0,1,1,5
RVKNG,0,0,0,1,1,5
VKNGL,0,0,0,1,1,5
KNGLE,0,0,0,1,1,5
NGLER,0,0,0,1,1,5
GLERL,0,0,0,1,1,5
LERLK,0,0,0,1,1,5
ERLKK,0,0,0,1,1,5
RLKKA,0,0,0,1,1,5
LKKAI,0,0,0,1,1,5
KKAIK,0,0,0,1,1,5
KAIKS,0,0,0,1,1,5
AIKSG,0,0,0,1,1,5
IKSGK,0,0,0,1,1,5
KSGKQ,0,0,0,1,1,5
SGKQS,0,0,0,1,1,5
GKQST,0,0,0,1,1,5
EESDI,0,0,0,1,1,5
ESDIK,0,0,0,1,1,5
SDIKY,0,0,0,1,1,5
DIKYK,0,0,0,1,1,5
IKYKT,0,0,0,1,1,5
KYKTS,0,0,0,1,1,5
YKTSK,0,0,0,1,1,5
KTSKN,0,0,0,1,1,5
TSKNF,0,0,0,1,1,5
SKNFI,0,0,0,1,1,5
KNFIN,0,0,0,1,1,5
NFINK,0,0,0,1,1,5
FINKV,0,0,0,1,1,5
INKVY,0,0,0,1,1,5
EEVKK,0,0,0,2,2,5
EVKKH,0,0,0,2,2,5
VKKHG,0,0,0,1,1,5
KKHGT,0,0,0,1,1,5
KHGTT,0,0,0,1,1,5
HGTTV,0,0,0,1,1,5
GTTVL,0,0,0,1,1,5
TTVLT,0,0,0,1,1,5
TVLTA,0,0,0,1,1,5
VLTAL,0,0,0,1,1,5
LTALG,0,0,0,1,1,5
TALGR,0,0,0,1,1,5
ALGRI,0,0,0,1,1,5
LGRIL,0,0,0,1,1,5
GRILK,0,0,0,1,1,5
RILKQ,0,0,0,1,1,5
EFPEM,0,0,0,1,1,5
FPEML,0,0,0,1,1,5
PEMLA,0,0,0,1,1,5
EMLAE,0,0,0,1,1,5
MLAEI,0,0,0,1,1,5
LAEII,0,0,0,1,1,5
AEIIT,0,0,0,1,1,5
EFRDL,0,0,0,1,1,5
FRDLH,0,0,0,1,1,5
RDLHL,0,0,0,1,1,5
DLHLF,0,0,0,1,1,5
LHLFL,0,0,0,1,1,5
HLFLG,0,0,0,1,1,5
LFLGE,0,0,0,1,1,5
FLGEA,0,0,0,1,1,5
LGEAA,0,0,0,1,1,5
GEAAE,0,0,0,1,1,5
EAAET,0,0,0,2,2,5
AAETA,0,0,0,1,1,5
AETAE,0,0,0,1,1,5
ETAEE,0,0,0,1,1,5
TAEEV,0,0,0,1,1,5
AEEVA,0,0,0,1,1,5
EEVAD,0,0,0,1,1,5
EVADE,0,0,0,1,1,5
VADEL,0,0,0,1,1,5
ADELA,0,0,0,1,1,5
DELAE,0,0,0,1,1,5
ELAER,0,0,0,1,1,5
LAERV,0,0,0,1,1,5
AERVQ,0,0,0,1,1,5
ERVQA,0,0,0,1,1,5
RVQAL,0,0,0,1,1,5
EGDQQ,0,0,0,1,1,5
GDQQL,0,0,0,1,1,5
DQQLL,0,0,0,1,1,5
QQLLK,0,0,0,1,1,5
QLLKR,0,0,0,1,1,5
LLKRV,0,0,0,1,1,5
LKRVL,0,0,0,1,1,5
KRVLV,0,0,0,1,1,5
RVLVR,0,0,0,1,1,5
VLVRK,0,0,0,1,1,5
LVRKL,0,0,0,1,1,5
EGHVA,0,0,0,1,1,5
GHVAA,0,0,0,1,1,5
HVAAV,0,0,0,1,1,5
VAAVE,0,0,0,1,1,5
AAVEV,0,0,0,1,1,5
AVEVL,0,0,0,1,1,5
VEVLR,0,0,0,1,1,5
EVLRG,0,0,0,1,1,5
VLRGI,0,0,0,1,1,5
LRGIH,0,0,0,1,1,5
RGIHR,0,0,0,1,1,5
GIHRI,0,0,0,1,1,5
IHRIA,0,0,0,1,1,5
HRIAD,0,0,0,1,1,5
RIADM,0,0,0,1,1,5
IADMS,0,0,0,1,1,5
EGKDR,0,0,0,1,1,5
GKDRE,0,0,0,1,1,5
KDREL,0,0,0,1,1,5
DRELY,0,0,0,1,1,5
RELYG,0,0,0,1,1,5
ELYGK,0,0,0,2,2,5
LYGKL,0,0,0,1,1,5
YGKLH,0,0,0,1,1,5
GKLHE,0,0,0,1,1,5
KLHET,0,0,0,1,1,5
LHETL,0,0,0,1,1,5
HETLK,0,0,0,1,1,5
ETLKK,0,0,0,1,1,5
TLKKV,0,0,0,1,1,5
LKKVT,0,0,0,1,1,5
KKVTE,0,0,0,1,1,5
KVTED,0,0,0,1,1,5
VTEDL,0,0,0,1,1,5
TEDLE,0,0,0,1,1,5
EDLEA,0,0,0,1,1,5
EGNKR,0,0,0,1,1,5
GNKRL,0,0,0,1,1,5
NKRLD,0,0,0,1,1,5
KRLDS,0,0,0,1,1,5
RLDSV,0,0,0,1,1,5
LDSVN,0,0,0,1,1,5
DSVNS,0,0,0,1,1,5
SVNSI,0,0,0,1,1,5
VNSIV,0,0,0,1,1,5
NSIVS,0,0,0,1,1,5
EGQQR,0,0,0,1,1,5
GQQRR,0,0,0,1,1,5
QQRRI,0,0,0,1,1,5
QRRIR,0,0,0,1,1,5
RRIRQ,0,0,0,1,1,5
RIRQQ,0,0,0,1,1,5
IRQQR,0,0,0,1,1,5
RQQRL,0,0,0,1,1,5
QQRLI,0,0,0,1,1,5
QRLIS,0,0,0,1,1,5
RLISI,0,0,0,1,1,5
LISIG,0,0,0,1,1,5
ISIGK,0,0,0,1,1,5
SIGKW,0,0,0,1,1,5
IGKWI,0,0,0,1,1,5
GKWIA,0,0,0,1,1,5
KWIAD,0,0,0,1,1,5
WIADN,0,0,0,1,1,5
IADNQ,0,0,0,1,1,5
EGVAW,0,0,0,1,1,5
GVAWL,0,0,0,1,1,5
VAWLE,0,0,0,1,1,5
AWLEA,0,0,0,1,1,5
WLEAV,0,0,0,1,1,5
LEAVL,0,0,0,1,1,5
EAVLR,0,0,0,1,1,5
AVLRL,0,0,0,1,1,5
VLRLL,0,0,0,1,1,5
LRLLA,0,0,0,1,1,5
RLLAQ,0,0,0,1,1,5
EHEIQ,0,0,0,1,1,5
HEIQE,0,0,0,1,1,5
EIQEW,0,0,0,1,1,5
IQEWY,0,0,0,1,1,5
QEWYK,0,0,0,1,1,5
EWYKG,0,0,0,1,1,5
WYKGF,0,0,0,1,1,5
YKGFL,0,0,0,1,1,5
KGFLR,0,0,0,1,1,5
GFLRD,0,0,0,1,1,5
EIEKF,0,0,0,1,1,5
IEKFR,0,0,0,1,1,5
EKFRV,0,0,0,1,1,5
KFRVW,0,0,0,1,1,5
FRVWI,0,0,0,1,1,5
RVWIS,0,0,0,1,1,5
VWISI,0,0,0,1,1,5
WISIL,0,0,0,1,1,5
EISEM,0,0,0,1,1,5
ISEMV,0,0,0,1,1,5
SEMVR,0,0,0,1,1,5
EMVRM,0,0,0,1,1,5
MVRMR,0,0,0,1,1,5
VRMRE,0,0,0,1,1,5
RMRER,0,0,0,1,1,5
MRERI,0,0,0,1,1,5
RERIL,0,0,0,1,1,5
ERILD,0,0,0,1,1,5
RILDS,0,0,0,1,1,5
ILDSI,0,0,0,1,1,5
LDSIH,0,0,0,1,1,5
DSIHL,0,0,0,1,1,5
SIHLG,0,0,0,1,1,5
EISKL,0,0,0,1,1,5
ISKLV,0,0,0,1,1,5
SKLVK,0,0,0,1,1,5
LVKKM,0,0,0,1,1,5
VKKMI,0,0,0,1,1,5
KKMIS,0,0,0,1,1,5
KMISS,0,0,0,1,1,5
MISSW,0,0,0,1,1,5
ISSWK,0,0,0,1,1,5
SSWKD,0,0,0,1,1,5
SWKDA,0,0,0,1,1,5
WKDAI,0,0,0,1,1,5
KDAIN,0,0,0,1,1,5
EKETF,0,0,0,1,1,5
KETFR,0,0,0,1,1,5
ETFRE,0,0,0,1,1,5
TFREK,0,0,0,1,1,5
FREKF,0,0,0,1,1,5
REKFM,0,0,0,1,1,5
EKFMQ,0,0,0,1,1,5
KFMQH,0,0,0,1,1,5
EKNSY,0,0,0,1,1,5
KNSYR,0,0,0,1,1,5
NSYRK,0,0,0,1,1,5
SYRKL,0,0,0,1,1,5
YRKLV,0,0,0,1,1,5
RKLVG,0,0,0,1,1,5
KLVGN,0,0,0,1,1,5
LVGNL,0,0,0,1,1,5
VGNLY,0,0,0,1,1,5
GNLYF,0,0,0,1,1,5
NLYFV,0,0,0,1,1,5
LYFVY,0,0,0,1,1,5
YFVYS,0,0,0,1,1,5
FVYSA,0,0,0,1,1,5
VYSAM,0,0,0,1,1,5
YSAME,0,0,0,1,1,5
SAMEE,0,0,0,1,1,5
AMEEE,0,0,0,1,1,5
MEEEM,0,0,0,1,1,5
EEEMA,0,0,0,1,1,5
EEMAK,0,0,0,1,1,5
EMAKF,0,0,0,1,1,5
EKVQY,0,0,0,1,1,5
KVQYL,0,0,0,1,1,5
VQYLT,0,0,0,1,1,5
QYLTR,0,0,0,1,1,5
YLTRS,0,0,0,1,1,5
LTRSA,0,0,0,1,1,5
TRSAI,0,0,0,1,1,5
RSAIR,0,0,0,1,1,5
SAIRR,0,0,0,1,1,5
EMNYY,0,0,0,1,1,5
MNYYT,0,0,0,1,1,5
NYYTV,0,0,0,1,1,5
YYTVL,0,0,0,1,1,5
YTVLF,0,0,0,1,1,5
TVLFG,0,0,0,1,1,5
VLFGV,0,0,0,1,1,5
LFGVS,0,0,0,1,1,5
FGVSR,0,0,0,1,1,5
GVSRA,0,0,0,1,1,5
VSRAL,0,0,0,1,1,5
SRALG,0,0,0,1,1,5
RALGV,0,0,0,1,1,5
ALGVL,0,0,0,1,1,5
LGVLA,0,0,0,1,1,5
GVLAQ,0,0,0,1,1,5
VLAQL,0,0,0,1,1,5
LAQLI,0,0,0,1,1,5
AQLIW,0,0,0,1,1,5
QLIWS,0,0,0,1,1,5
LIWSR,0,0,0,1,1,5
IWSRA,0,0,0,1,1,5
WSRAL,0,0,0,1,1,5
EPEEV,0,0,0,1,1,5
PEEVF,0,0,0,1,1,5
EEVFK,0,0,0,1,1,5
EVFKS,0,0,0,1,1,5
VFKSV,0,0,0,1,1,5
FKSVL,0,0,0,1,1,5
KSVLK,0,0,0,1,1,5
SVLKE,0,0,0,1,1,5
VLKEM,0,0,0,1,1,5
LKEME,0,0,0,1,1,5
KEMEG,0,0,0,1,1,5
EPEKV,0,0,0,1,1,5
PEKVD,0,0,0,1,1,5
EKVDK,0,0,0,1,1,5
KVDKL,0,0,0,1,1,5
VDKLQ,0,0,0,1,1,5
DKLQE,0,0,0,1,1,5
KLQEP,0,0,0,1,1,5
LQEPL,0,0,0,1,1,5
QEPLL,0,0,0,1,1,5
EPLLE,0,0,0,1,1,5
PLLEA,0,0,0,1,1,5
LLEAL,0,0,0,2,2,5
LEALR,0,0,0,1,1,5
EALRL,0,0,0,2,2,5
ALRLY,0,0,0,1,1,5
LRLYA,0,0,0,1,1,5
RLYAR,0,0,0,1,1,5
LYARR,0,0,0,1,1,5
YARRR,0,0,0,1,1,5
ARRRR,0,0,0,1,1,5
EPGQR,0,0,0,1,1,5
PGQRK,0,0,0,1,1,5
GQRKI,0,0,0,1,1,5
QRKIV,0,0,0,1,1,5
RKIVM,0,0,0,1,1,5
KIVMH,0,0,0,1,1,5
IVMHK,0,0,0,1,1,5
EQEIL,0,0,0,1,1,5
QEILR,0,0,0,1,1,5
EILRQ,0,0,0,1,1,5
ILRQV,0,0,0,1,1,5
LRQVK,0,0,0,1,1,5
RQVKK,0,0,0,1,1,5
QVKKA,0,0,0,1,1,5
VKKAY,0,0,0,1,1,5
KKAYD,0,0,0,1,1,5
KAYDR,0,0,0,1,1,5
AYDRA,0,0,0,1,1,5
YDRAA,0,0,0,1,1,5
DRAAR,0,0,0,1,1,5
RAARL,0,0,0,1,1,5
AARLG,0,0,0,1,1,5
EQEVY,0,0,0,1,1,5
QEVYA,0,0,0,1,1,5
EVYAQ,0,0,0,1,1,5
VYAQV,0,0,0,1,1,5
YAQVA,0,0,0,1,1,5
AQVAR,0,0,0,1,1,5
QVARL,0,0,0,1,1,5
EQPSL,0,0,0,1,1,5
QPSLV,0,0,0,1,1,5
PSLVR,0,0,0,1,1,5
SLVRT,0,0,0,1,1,5
LVRTL,0,0,0,1,1,5
VRTLD,0,0,0,1,1,5
RTLDQ,0,0,0,1,1,5
TLDQL,0,0,0,1,1,5
LDQLE,0,0,0,1,1,5
DQLED,0,0,0,1,1,5
QLEDK,0,0,0,1,1,5
ERQEV,0,0,0,1,1,5
RQEVK,0,0,0,1,1,5
QEVKQ,0,0,0,1,1,5
EVKQM,0,0,0,1,1,5
VKQMV,0,0,0,1,1,5
KQMVV,0,0,0,1,1,5
QMVVA,0,0,0,1,1,5
MVVAT,0,0,0,1,1,5
VVATL,0,0,0,1,1,5
ATLAE,0,0,0,1,1,5
TLAES,0,0,0,1,1,5
ERVRA,0,0,0,1,1,5
RVRAA,0,0,0,1,1,5
VRAAM,0,0,0,1,1,5
RAAME,0,0,0,1,1,5
AAMEK,0,0,0,1,1,5
AMEKL,0,0,0,1,1,5
MEKLA,0,0,0,1,1,5
ESLYE,0,0,0,1,1,5
SLYES,0,0,0,1,1,5
LYESI,0,0,0,1,1,5
YESIR,0,0,0,1,1,5
ESIRR,0,0,0,1,1,5
SIRRR,0,0,0,1,1,5
IRRRY,0,0,0,1,1,5
RRRYE,0,0,0,1,1,5
RRYEE,0,0,0,1,1,5
RYEEL,0,0,0,1,1,5
ESPVR,0,0,0,1,1,5
SPVRK,0,0,0,1,1,5
PVRKI,0,0,0,1,1,5
VRKIL,0,0,0,1,1,5
RKILR,0,0,0,1,1,5
KILRI,0,0,0,1,1,5
ILRIV,0,0,0,1,1,5
LRIVF,0,0,0,1,1,5
RIVFH,0,0,0,1,1,5
IVFHD,0,0,0,1,1,5
VFHDA,0,0,0,1,1,5
FHDAI,0,0,0,1,1,5
ETNIR,0,0,0,1,1,5
TNIRV,0,0,0,1,1,5
NIRVA,0,0,0,1,1,5
IRVAL,0,0,0,1,1,5
RVALE,0,0,0,1,1,5
VALEK,0,0,0,1,1,5
ALEKS,0,0,0,1,1,5
LEKSF,0,0,0,1,1,5
EKSFL,0,0,0,1,1,5
EVKRR,0,0,0,1,1,5
VKRRF,0,0,0,1,1,5
KRRFP,0,0,0,1,1,5
RRFPT,0,0,0,1,1,5
RFPTK,0,0,0,1,1,5
FPTKL,0,0,0,1,1,5
PTKLG,0,0,0,1,1,5
TKLGA,0,0,0,1,1,5
KLGAW,0,0,0,1,1,5
LGAWA,0,0,0,1,1,5
GAWAL,0,0,0,1,1,5
AWALI,0,0,0,1,1,5
WALIW,0,0,0,1,1,5
ALIWW,0,0,0,1,1,5
LIWWL,0,0,0,1,1,5
IWWLL,0,0,0,1,1,5
EVKRS,0,0,0,1,1,5
VKRSV,0,0,0,1,1,5
KRSVN,0,0,0,1,1,5
RSVNR,0,0,0,1,1,5
SVNRD,0,0,0,1,1,5
VNRDF,0,0,0,1,1,5
NRDFA,0,0,0,1,1,5
RDFAK,0,0,0,1,1,5
DFAKW,0,0,0,1,1,5
FAKWF,0,0,0,1,1,5
AKWFL,0,0,0,1,1,5
KWFLI,0,0,0,1,1,5
WFLIV,0,0,0,1,1,5
FLIVF,0,0,0,1,1,5
LIVFI,0,0,0,2,2,5
EVNRN,0,0,0,1,1,5
VNRNF,0,0,0,1,1,5
NRNFG,0,0,0,1,1,5
RNFGE,0,0,0,1,1,5
NFGER,0,0,0,1,1,5
FGERI,0,0,0,1,1,5
GERIN,0,0,0,1,1,5
ERIND,0,0,0,1,1,5
RINDL,0,0,0,1,1,5
INDLR,0,0,0,1,1,5
NDLRI,0,0,0,1,1,5
DLRIL,0,0,0,1,1,5
LRILI,0,0,0,1,1,5
RILIL,0,0,0,1,1,5
ILILL,0,0,0,1,1,5
LILLL,0,0,0,1,1,5
EVVGR,0,0,0,1,1,5
VVGRV,0,0,0,1,1,5
VGRVS,0,0,0,1,1,5
GRVSK,0,0,0,1,1,5
RVSKL,0,0,0,1,1,5
VSKLW,0,0,0,1,1,5
SKLWN,0,0,0,1,1,5
KLWNE,0,0,0,1,1,5
LWNEW,0,0,0,1,1,5
WNEWW,0,0,0,1,1,5
NEWWL,0,0,0,1,1,5
EWWLI,0,0,0,1,1,5
WWLIV,0,0,0,1,1,5
EWQTM,0,0,0,1,1,5
WQTMV,0,0,0,1,1,5
QTMVA,0,0,0,1,1,5
TMVAA,0,0,0,1,1,5
MVAAL,0,0,0,1,1,5
VAALQ,0,0,0,1,1,5
AALQA,0,0,0,1,1,5
EYKYY,0,0,0,1,1,5
YKYYK,0,0,0,1,1,5
KYYKL,0,0,0,1,1,5
YYKLK,0,0,0,1,1,5
YKLKL,0,0,0,1,1,5
KLKLA,0,0,0,1,1,5
LKLAE,0,0,0,1,1,5
KLAEM,0,0,0,1,1,5
LAEMQ,0,0,0,1,1,5
AEMQR,0,0,0,1,1,5
FADLF,0,0,0,1,1,5
ADLFD,0,0,0,1,1,5
DLFDP,0,0,0,1,1,5
LFDPV,0,0,0,1,1,5
FDPVI,0,0,0,1,1,5
DPVIQ,0,0,0,1,1,5
PVIQE,0,0,0,1,1,5
VIQER,0,0,0,1,1,5
IQERH,0,0,0,1,1,5
FALRL,0,0,0,1,1,5
ALRLR,0,0,0,1,1,5
LRLRR,0,0,0,1,1,5
RLRRV,0,0,0,1,1,5
LRRVI,0,0,0,1,1,5
RRVIN,0,0,0,1,1,5
RVINR,0,0,0,1,1,5
VINRI,0,0,0,1,1,5
INRIG,0,0,0,1,1,5
NRIGQ,0,0,0,1,1,5
RIGQA,0,0,0,1,1,5
IGQAW,0,0,0,1,1,5
GQAWR,0,0,0,1,1,5
FEVID,0,0,0,1,1,5
EVIDT,0,0,0,1,1,5
VIDTI,0,0,0,1,1,5
IDTIK,0,0,0,1,1,5
DTIKA,0,0,0,1,1,5
TIKAA,0,0,0,2,2,5
IKAAV,0,0,0,1,1,5
KAAVE,0,0,0,1,1,5
AAVEN,0,0,0,1,1,5
AVENA,0,0,0,1,1,5
FFSFE,0,0,0,1,1,5
FSFEL,0,0,0,1,1,5
SFELV,0,0,0,1,1,5
FELVE,0,0,0,1,1,5
ELVES,0,0,0,1,1,5
LVESI,0,0,0,1,1,5
VESIN,0,0,0,1,1,5
ESIND,0,0,0,1,1,5
SINDV,0,0,0,1,1,5
INDVK,0,0,0,1,1,5
NDVKK,0,0,0,1,1,5
DVKKS,0,0,0,1,1,5
VKKSL,0,0,0,2,2,5
KKSLR,0,0,0,1,1,5
FGLKV,0,0,0,1,1,5
GLKVL,0,0,0,1,1,5
LKVLG,0,0,0,2,2,5
KVLGW,0,0,0,1,1,5
VLGWY,0,0,0,1,1,5
LGWYS,0,0,0,1,1,5
GWYSE,0,0,0,1,1,5
WYSEM,0,0,0,1,1,5
YSEMK,0,0,0,1,1,5
SEMKR,0,0,0,1,1,5
EMKRN,0,0,0,1,1,5
MKRNV,0,0,0,1,1,5
KRNVQ,0,0,0,1,1,5
RNVQR,0,0,0,1,1,5
NVQRL,0,0,0,1,1,5
VQRLE,0,0,0,1,1,5
QRLER,0,0,0,1,1,5
RLERA,0,0,0,1,1,5
LERAI,0,0,0,2,2,5
ERAIE,0,0,0,1,1,5
RAIEE,0,0,0,1,1,5
AIEEV,0,0,0,1,1,5
FHSVA,0,0,0,1,1,5
HSVAE,0,0,0,1,1,5
SVAEQ,0,0,0,1,1,5
VAEQF,0,0,0,1,1,5
FIAVH,0,0,0,1,1,5
IAVHE,0,0,0,2,2,5
AVHEM,0,0,0,1,1,5
VHEML,0,0,0,1,1,5
HEMLD,0,0,0,1,1,5
EMLDG,0,0,0,1,1,5
MLDGF,0,0,0,1,1,5
LDGFR,0,0,0,1,1,5
DGFRT,0,0,0,1,1,5
GFRTA,0,0,0,1,1,5
FRTAL,0,0,0,1,1,5
RTALI,0,0,0,1,1,5
TALID,0,0,0,1,1,5
ALIDH,0,0,0,1,1,5
LIDHL,0,0,0,1,1,5
IDHLD,0,0,0,1,1,5
DHLDT,0,0,0,1,1,5
HLDTM,0,0,0,1,1,5
LDTMA,0,0,0,1,1,5
DTMAE,0,0,0,1,1,5
TMAER,0,0,0,1,1,5
MAERA,0,0,0,1,1,5
AERAV,0,0,0,1,1,5
ERAVQ,0,0,0,1,1,5
FKATI,0,0,0,1,1,5
KATIA,0,0,0,1,1,5
ATIAD,0,0,0,1,1,5
TIADL,0,0,0,1,1,5
IADLS,0,0,0,1,1,5
ADLSK,0,0,0,1,1,5
DLSKK,0,0,0,1,1,5
LSKKR,0,0,0,1,1,5
FKEAI,0,0,0,1,1,5
KEAIE,0,0,0,1,1,5
AIEAI,0,0,0,1,1,5
IEAIA,0,0,0,1,1,5
AIAES,0,0,0,1,1,5
IAESA,0,0,0,1,1,5
FKGKI,0,0,0,1,1,5
KGKII,0,0,0,1,1,5
GKIIK,0,0,0,1,1,5
KIIKK,0,0,0,1,1,5
IIKKV,0,0,0,1,1,5
IKKVI,0,0,0,1,1,5
KKVIS,0,0,0,1,1,5
KVIST,0,0,0,1,1,5
VISTG,0,0,0,1,1,5
ISTGA,0,0,0,1,1,5
STGAK,0,0,0,1,1,5
TGAKL,0,0,0,1,1,5
GAKLI,0,0,0,1,1,5
FKSIY,0,0,0,1,1,5
KSIYR,0,0,0,1,1,5
SIYRF,0,0,0,1,1,5
IYRFF,0,0,0,1,1,5
YRFFE,0,0,0,1,1,5
RFFEH,0,0,0,1,1,5
FFEHG,0,0,0,1,1,5
FEHGL,0,0,0,1,1,5
EHGLK,0,0,0,1,1,5
FKSVQ,0,0,0,1,1,5
KSVQN,0,0,0,1,1,5
SVQNS,0,0,0,1,1,5
VQNSL,0,0,0,1,1,5
QNSLQ,0,0,0,1,1,5
NSLQR,0,0,0,1,1,5
SLQRI,0,0,0,1,1,5
LQRIL,0,0,0,1,1,5
QRILY,0,0,0,1,1,5
RILYL,0,0,0,1,1,5
ILYLW,0,0,0,1,1,5
LYLWA,0,0,0,1,1,5
YLWAI,0,0,0,1,1,5
LWAIR,0,0,0,1,1,5
WAIRH,0,0,0,1,1,5
FLDQN,0,0,0,1,1,5
LDQNM,0,0,0,1,1,5
DQNML,0,0,0,1,1,5
QNMLA,0,0,0,1,1,5
NMLAV,0,0,0,1,1,5
MLAVI,0,0,0,1,1,5
LAVID,0,0,0,1,1,5
AVIDE,0,0,0,1,1,5
VIDEL,0,0,0,1,1,5
IDELM,0,0,0,1,1,5
DELMQ,0,0,0,1,1,5
ELMQA,0,0,0,1,1,5
LMQAL,0,0,0,1,1,5
FLLKK,0,0,0,1,1,5
KLKKV,0,0,0,1,1,5
LKKVA,0,0,0,2,2,5
KKVAT,0,0,0,1,1,5
KVATG,0,0,0,1,1,5
VATGF,0,0,0,1,1,5
ATGFA,0,0,0,1,1,5
TGFAK,0,0,0,1,1,5
GFAKG,0,0,0,1,1,5
FLLSK,0,0,0,1,1,5
LLSKA,0,0,0,1,1,5
LSKAK,0,0,0,1,1,5
SKAKD,0,0,0,1,1,5
KAKDA,0,0,0,1,1,5
AKDAK,0,0,0,1,1,5
KDAKS,0,0,0,1,1,5
DAKSS,0,0,0,1,1,5
AKSSA,0,0,0,1,1,5
KSSAE,0,0,0,1,1,5
SSAEG,0,0,0,1,1,5
SAEGA,0,0,0,1,1,5
AEGAV,0,0,0,1,1,5
FNQRR,0,0,0,1,1,5
NQRRI,0,0,0,1,1,5
QRRIS,0,0,0,1,1,5
RRISS,0,0,0,1,1,5
RISSA,0,0,0,1,1,5
ISSAK,0,0,0,1,1,5
SSAKF,0,0,0,1,1,5
SAKFL,0,0,0,1,1,5
AKFLG,0,0,0,1,1,5
KFLGE,0,0,0,1,1,5
FLGEL,0,0,0,1,1,5
LGELY,0,0,0,1,1,5
GELYN,0,0,0,1,1,5
ELYNY,0,0,0,1,1,5
FNRMF,0,0,0,2,2,5
NRMFE,0,0,0,2,2,5
RMFEK,0,0,0,2,2,5
MFEKS,0,0,0,2,2,5
FEKST,0,0,0,2,2,5
EKSTH,0,0,0,2,2,5
KSTHH,0,0,0,2,2,5
STHHY,0,0,0,2,2,5
THHYT,0,0,0,2,2,5
HHYTD,0,0,0,2,2,5
HYTDS,0,0,0,2,2,5
YTDSV,0,0,0,2,2,5
TDSVG,0,0,0,2,2,5
DSVGG,0,0,0,2,2,5
SVGGI,0,0,0,2,2,5
VGGIL,0,0,0,1,1,5
GGILR,0,0,0,1,1,5
FPLLV,0,0,0,1,1,5
PLLVD,0,0,0,1,1,5
LLVDH,0,0,0,1,1,5
LVDHT,0,0,0,1,1,5
VDHTS,0,0,0,1,1,5
DHTSR,0,0,0,1,1,5
HTSRE,0,0,0,1,1,5
TSREA,0,0,0,1,1,5
SREAD,0,0,0,1,1,5
READY,0,0,0,1,1,5
EADYF,0,0,0,1,1,5
ADYFR,0,0,0,1,1,5
DYFRK,0,0,0,1,1,5
YFRKR,0,0,0,1,1,5
FRKRL,0,0,0,1,1,5
RKRLI,0,0,0,1,1,5
KRLIQ,0,0,0,1,1,5
RLIQL,0,0,0,1,1,5
LIQLN,0,0,0,1,1,5
IQLNE,0,0,0,1,1,5
QLNEG,0,0,0,1,1,5
FPNLA,0,0,0,1,1,5
PNLAS,0,0,0,1,1,5
NLASA,0,0,0,1,1,5
LASAA,0,0,0,1,1,5
ASAAF,0,0,0,1,1,5
SAAFY,0,0,0,1,1,5
AAFYW,0,0,0,1,1,5
AFYWS,0,0,0,1,1,5
FYWSK,0,0,0,1,1,5
YWSKK,0,0,0,1,1,5
WSKKE,0,0,0,1,1,5
SKKEN,0,0,0,1,1,5
FPQLT,0,0,0,1,1,5
PQLTQ,0,0,0,1,1,5
QLTQN,0,0,0,1,1,5
LTQNN,0,0,0,1,1,5
TQNNS,0,0,0,1,1,5
QNNSR,0,0,0,1,1,5
NNSRE,0,0,0,1,1,5
FSALN,0,0,0,1,1,5
SALNI,0,0,0,1,1,5
ALNIA,0,0,0,1,1,5
LNIAV,0,0,0,1,1,5
NIAVH,0,0,0,1,1,5
AVHEL,0,0,0,1,1,5
VHELS,0,0,0,1,1,5
HELSD,0,0,0,1,1,5
ELSDV,0,0,0,1,1,5
LSDVG,0,0,0,1,1,5
SDVGR,0,0,0,1,1,5
DVGRA,0,0,0,1,1,5
VGRAI,0,0,0,1,1,5
GRAIV,0,0,0,1,1,5
RAIVR,0,0,0,1,1,5
AIVRN,0,0,0,1,1,5
FSEFI,0,0,0,1,1,5
SEFIQ,0,0,0,1,1,5
EFIQA,0,0,0,1,1,5
FIQAL,0,0,0,1,1,5
IQALS,0,0,0,1,1,5
QALSV,0,0,0,1,1,5
ALSVT,0,0,0,1,1,5
LSVTS,0,0,0,1,1,5
SVTSR,0,0,0,1,1,5
VTSRG,0,0,0,1,1,5
FTELQ,0,0,0,1,1,5
TELQR,0,0,0,1,1,5
ELQRD,0,0,0,1,1,5
LQRDF,0,0,0,1,1,5
QRDFL,0,0,0,1,1,5
RDFLR,0,0,0,1,1,5
DFLRN,0,0,0,1,1,5
FTRII,0,0,0,1,1,5
TRIIK,0,0,0,1,1,5
RIIKA,0,0,0,1,1,5
IIKAA,0,0,0,1,1,5
IKAAG,0,0,0,1,1,5
FVPVF,0,0,0,1,1,5
VPVFF,0,0,0,1,1,5
PVFFV,0,0,0,1,1,5
VFFVV,0,0,0,2,2,5
FFVVV,0,0,0,1,1,5
FVVVR,0,0,0,1,1,5
VVVRR,0,0,0,1,1,5
VVRRR,0,0,0,1,1,5
FYQTF,0,0,0,1,1,5
YQTFF,0,0,0,1,1,5
QTFFD,0,0,0,1,1,5
TFFDE,0,0,0,1,1,5
FFDEA,0,0,0,1,1,5
FDEAD,0,0,0,1,1,5
DEADE,0,0,0,1,1,5
EADEL,0,0,0,1,1,5
ADELL,0,0,0,1,1,5
DELLA,0,0,0,1,1,5
ELLAD,0,0,0,1,1,5
LLADM,0,0,0,1,1,5
LADME,0,0,0,1,1,5
ADMEQ,0,0,0,1,1,5
DMEQH,0,0,0,1,1,5
MEQHL,0,0,0,1,1,5
EQHLL,0,0,0,1,1,5
QHLLD,0,0,0,1,1,5
HLLDL,0,0,0,1,1,5
GAFRK,0,0,0,1,1,5
AFRKL,0,0,0,1,1,5
FRKLL,0,0,0,1,1,5
RKLLQ,0,0,0,1,1,5
KLLQS,0,0,0,1,1,5
LLQSA,0,0,0,1,1,5
LQSAK,0,0,0,1,1,5
QSAKD,0,0,0,1,1,5
SAKDN,0,0,0,1,1,5
GAGTS,0,0,0,1,1,5
AGTSV,0,0,0,1,1,5
GTSVN,0,0,0,1,1,5
TSVNM,0,0,0,1,1,5
SVNMN,0,0,0,1,1,5
VNMNT,0,0,0,1,1,5
NMNTN,0,0,0,1,1,5
MNTNE,0,0,0,1,1,5
NTNEV,0,0,0,1,1,5
TNEVL,0,0,0,1,1,5
NEVLA,0,0,0,1,1,5
EVLAN,0,0,0,1,1,5
VLANI,0,0,0,1,1,5
LANIG,0,0,0,1,1,5
ANIGL,0,0,0,1,1,5
NIGLE,0,0,0,1,1,5
IGLEL,0,0,0,1,1,5
GLELM,0,0,0,1,1,5
GAPLA,0,0,0,1,1,5
APLAR,0,0,0,1,1,5
PLARM,0,0,0,1,1,5
LARME,0,0,0,1,1,5
ARMEV,0,0,0,1,1,5
RMEVT,0,0,0,1,1,5
MEVTL,0,0,0,1,1,5
EVTLA,0,0,0,1,1,5
VTLAL,0,0,0,1,1,5
TLALE,0,0,0,1,1,5
LALES,0,0,0,1,1,5
ALESL,0,0,0,1,1,5
LESLF,0,0,0,1,1,5
ESLFG,0,0,0,1,1,5
SLFGR,0,0,0,1,1,5
LFGRF,0,0,0,1,1,5
GAQYI,0,0,0,1,1,5
AQYIQ,0,0,0,1,1,5
QYIQA,0,0,0,1,1,5
YIQAA,0,0,0,1,1,5
IQAAG,0,0,0,1,1,5
QAAGV,0,0,0,1,1,5
AAGVA,0,0,0,1,1,5
AGVAL,0,0,0,1,1,5
GVALG,0,0,0,1,1,5
VALGL,0,0,0,1,1,5
ALGLK,0,0,0,1,1,5
LGLKM,0,0,0,1,1,5
GLKMR,0,0,0,1,1,5
GAVAI,0,0,0,1,1,5
AVAIA,0,0,0,1,1,5
VAIAR,0,0,0,1,1,5
AIARV,0,0,0,1,1,5
IARVF,0,0,0,1,1,5
ARVFS,0,0,0,1,1,5
RVFSY,0,0,0,1,1,5
GEAEI,0,0,0,1,1,5
EAEIA,0,0,0,1,1,5
AEIAS,0,0,0,1,1,5
EIASL,0,0,0,1,1,5
IASLK,0,0,0,1,1,5
ASLKS,0,0,0,1,1,5
SLKSQ,0,0,0,1,1,5
LKSQI,0,0,0,1,1,5
KSQIR,0,0,0,1,1,5
SQIRA,0,0,0,1,1,5
GEAYL,0,0,0,1,1,5
EAYLL,0,0,0,1,1,5
AYLLL,0,0,0,1,1,5
YLLLE,0,0,0,1,1,5
LLLER,0,0,0,1,1,5
LLERY,0,0,0,1,1,5
LERYV,0,0,0,1,1,5
ERYVA,0,0,0,1,1,5
RYVAF,0,0,0,1,1,5
YVAFL,0,0,0,1,1,5
VAFLR,0,0,0,1,1,5
AFLRA,0,0,0,1,1,5
GEDAI,0,0,0,1,1,5
EDAIL,0,0,0,1,1,5
DAILK,0,0,0,1,1,5
AILKK,0,0,0,1,1,5
ILKKV,0,0,0,1,1,5
KKVAE,0,0,0,1,1,5
KVAEE,0,0,0,1,1,5
VAEEA,0,0,0,1,1,5
AEEAA,0,0,0,1,1,5
EEAAE,0,0,0,2,2,5
AAETL,0,0,0,1,1,5
AETLM,0,0,0,1,1,5
ETLMA,0,0,0,1,1,5
TLMAS,0,0,0,1,1,5
LMASK,0,0,0,1,1,5
MASKD,0,0,0,1,1,5
GEGWA,0,0,0,1,1,5
EGWAK,0,0,0,1,1,5
GWAKS,0,0,0,1,1,5
WAKSI,0,0,0,1,1,5
AKSIL,0,0,0,1,1,5
KSILF,0,0,0,1,1,5
SILFN,0,0,0,1,1,5
GEKRA,0,0,0,1,1,5
EKRAE,0,0,0,1,1,5
RAEEI,0,0,0,1,1,5
AEEIK,0,0,0,1,1,5
EEIKK,0,0,0,1,1,5
EIKKI,0,0,0,1,1,5
IKKIL,0,0,0,1,1,5
KKILM,0,0,0,1,1,5
KILMT,0,0,0,1,1,5
GFFGW,0,0,0,1,1,5
FFGWF,0,0,0,1,1,5
FGWFN,0,0,0,1,1,5
GWFNR,0,0,0,1,1,5
WFNRM,0,0,0,1,1,5
GFKNE,0,0,0,1,1,5
FKNEV,0,0,0,1,1,5
KNEVR,0,0,0,1,1,5
NEVRT,0,0,0,1,1,5
EVRTP,0,0,0,1,1,5
VRTPV,0,0,0,1,1,5
RTPVT,0,0,0,1,1,5
TPVTK,0,0,0,1,1,5
PVTKF,0,0,0,1,1,5
VTKFR,0,0,0,1,1,5
TKFRI,0,0,0,1,1,5
KFRIV,0,0,0,1,1,5
FRIVF,0,0,0,1,1,5
RIVFF,0,0,0,1,1,5
IVFFV,0,0,0,1,1,5
GFMIW,0,0,0,1,1,5
FMIWH,0,0,0,1,1,5
MIWHP,0,0,0,1,1,5
IWHPK,0,0,0,1,1,5
WHPKM,0,0,0,1,1,5
HPKMD,0,0,0,1,1,5
PKMDE,0,0,0,1,1,5
KMDEY,0,0,0,1,1,5
MDEYM,0,0,0,1,1,5
DEYME,0,0,0,1,1,5
EYMEE,0,0,0,1,1,5
YMEEI,0,0,0,1,1,5
MEEID,0,0,0,1,1,5
EEIDG,0,0,0,1,1,5
EIDGY,0,0,0,1,1,5
IDGYL,0,0,0,1,1,5
DGYLD,0,0,0,1,1,5
GYLDE,0,0,0,1,1,5
YLDEM,0,0,0,1,1,5
LDEMS,0,0,0,1,1,5
DEMSE,0,0,0,1,1,5
EMSER,0,0,0,1,1,5
MSERL,0,0,0,1,1,5
SERLI,0,0,0,1,1,5
ERLIT,0,0,0,1,1,5
RLITL,0,0,0,1,1,5
GFSVQ,0,0,0,1,1,5
FSVQR,0,0,0,1,1,5
SVQRR,0,0,0,1,1,5
VQRRL,0,0,0,1,1,5
QRRLW,0,0,0,1,1,5
RRLWL,0,0,0,1,1,5
RLWLA,0,0,0,1,1,5
LWLAS,0,0,0,1,1,5
GFYPM,0,0,0,1,1,5
FYPMV,0,0,0,1,1,5
YPMVA,0,0,0,1,1,5
PMVAA,0,0,0,1,1,5
MVAAQ,0,0,0,1,1,5
VAAQR,0,0,0,1,1,5
AAQRI,0,0,0,1,1,5
GGFAA,0,0,0,1,1,5
GFAAA,0,0,0,1,1,5
FAAAI,0,0,0,1,1,5
AAAIA,0,0,0,1,1,5
AAIAR,0,0,0,1,1,5
AIARR,0,0,0,1,1,5
IARRA,0,0,0,1,1,5
GGKEA,0,0,0,1,1,5
GKEAL,0,0,0,1,1,5
KEALA,0,0,0,1,1,5
EALAI,0,0,0,1,1,5
ALAIE,0,0,0,1,1,5
LAIEN,0,0,0,1,1,5
AIENF,0,0,0,1,1,5
IENFA,0,0,0,1,1,5
ENFAD,0,0,0,1,1,5
NFADA,0,0,0,1,1,5
FADAL,0,0,0,1,1,5
GGSSG,0,0,0,1,1,5
GSSGV,0,0,0,1,1,5
SSGVL,0,0,0,1,1,5
SGVLM,0,0,0,1,1,5
GVLMS,0,0,0,1,1,5
VLMSI,0,0,0,1,1,5
LMSIF,0,0,0,1,1,5
MSIFF,0,0,0,1,1,5
SIFFT,0,0,0,1,1,5
IFFTA,0,0,0,1,1,5
FFTAA,0,0,0,1,1,5
FTAAG,0,0,0,1,1,5
TAAGQ,0,0,0,1,1,5
AAGQK,0,0,0,1,1,5
AGQKL,0,0,0,1,1,5
GQKLE,0,0,0,1,1,5
QKLEQ,0,0,0,1,1,5
GHNLI,0,0,0,1,1,5
HNLIS,0,0,0,1,1,5
NLISL,0,0,0,1,1,5
LISLL,0,0,0,1,1,5
ISLLE,0,0,0,1,1,5
SLLEV,0,0,0,1,1,5
LLEVL,0,0,0,1,1,5
LEVLS,0,0,0,1,1,5
EVLSG,0,0,0,1,1,5
GIHEL,0,0,0,1,1,5
IHELA,0,0,0,1,1,5
HELAV,0,0,0,1,1,5
ELAVF,0,0,0,1,1,5
LAVFA,0,0,0,1,1,5
AVFAE,0,0,0,1,1,5
VFAEE,0,0,0,1,1,5
FAEEH,0,0,0,1,1,5
GKASL,0,0,0,1,1,5
KASLR,0,0,0,1,1,5
ASLRA,0,0,0,1,1,5
SLRAA,0,0,0,1,1,5
LRAAE,0,0,0,1,1,5
RAAEL,0,0,0,1,1,5
AAELY,0,0,0,1,1,5
AELYS,0,0,0,1,1,5
ELYSK,0,0,0,1,1,5
LYSKY,0,0,0,1,1,5
GKDAA,0,0,0,1,1,5
KDAAA,0,0,0,1,1,5
DAAAE,0,0,0,1,1,5
AAAEE,0,0,0,1,1,5
AAEEI,0,0,0,1,1,5
AEEIS,0,0,0,1,1,5
EEISQ,0,0,0,1,1,5
EISQL,0,0,0,1,1,5
ISQLL,0,0,0,1,1,5
SQLLY,0,0,0,1,1,5
QLLYH,0,0,0,1,1,5
LLYHV,0,0,0,1,1,5
LYHVQ,0,0,0,1,1,5
YHVQV,0,0,0,1,1,5
HVQVM,0,0,0,1,1,5
VQVMM,0,0,0,1,1,5
QVMMV,0,0,0,1,1,5
VMMVA,0,0,0,1,1,5
MMVAR,0,0,0,1,1,5
MVARG,0,0,0,1,1,5
GKKGP,0,0,0,1,1,5
KKGPK,0,0,0,1,1,5
KGPKF,0,0,0,1,1,5
GPKFI,0,0,0,1,1,5
PKFIQ,0,0,0,1,1,5
KFIQA,0,0,0,1,1,5
FIQAV,0,0,0,1,1,5
IQAVA,0,0,0,1,1,5
QAVAS,0,0,0,1,1,5
AVASL,0,0,0,1,1,5
VASLK,0,0,0,1,1,5
ASLKA,0,0,0,1,1,5
GKSNM,0,0,0,1,1,5
KSNMM,0,0,0,1,1,5
SNMMD,0,0,0,1,1,5
NMMDA,0,0,0,1,1,5
MMDAI,0,0,0,1,1,5
MDAIS,0,0,0,1,1,5
DAISF,0,0,0,1,1,5
AISFV,0,0,0,1,1,5
ISFVL,0,0,0,1,1,5
GKTTA,0,0,0,1,1,5
KTTAA,0,0,0,1,1,5
TTAAL,0,0,0,1,1,5
ALALA,0,0,0,1,1,5
LALAR,0,0,0,1,1,5
ALARE,0,0,0,1,1,5
LAREL,0,0,0,1,1,5
ARELF,0,0,0,1,1,5
RELFG,0,0,0,1,1,5
GKTTF,0,0,0,1,1,5
KTTFV,0,0,0,1,1,5
TTFVK,0,0,0,1,1,5
TFVKR,0,0,0,1,1,5
FVKRH,0,0,0,1,1,5
VKRHL,0,0,0,1,1,5
KRHLT,0,0,0,1,1,5
RHLTG,0,0,0,1,1,5
GKTTI,0,0,0,1,1,5
KTTIL,0,0,0,1,1,5
TTILY,0,0,0,1,1,5
TILYR,0,0,0,1,1,5
ILYRL,0,0,0,2,2,5
LYRLQ,0,0,0,1,1,5
YRLQV,0,0,0,1,1,5
RLQVG,0,0,0,1,1,5
GLEKL,0,0,0,1,1,5
LEKLE,0,0,0,1,1,5
EKLEE,0,0,0,1,1,5
KLEES,0,0,0,1,1,5
LEESI,0,0,0,1,1,5
EESIY,0,0,0,1,1,5
ESIYR,0,0,0,1,1,5
SIYRE,0,0,0,1,1,5
GLFDK,0,0,0,1,1,5
LFDKV,0,0,0,1,1,5
FDKVK,0,0,0,1,1,5
DKVKS,0,0,0,1,1,5
KVKSL,0,0,0,1,1,5
VKSLV,0,0,0,1,1,5
KSLVP,0,0,0,1,1,5
SLVPK,0,0,0,1,1,5
LVPKI,0,0,0,1,1,5
VPKIA,0,0,0,1,1,5
PKIAK,0,0,0,1,1,5
KIAKA,0,0,0,1,1,5
IAKAV,0,0,0,1,1,5
FDVIG,0,0,0,1,1,5
DVIGS,0,0,0,1,1,5
VIGSQ,0,0,0,1,1,5
IGSQA,0,0,0,1,1,5
GSQAG,0,0,0,1,1,5
SQAGG,0,0,0,1,1,5
QAGGA,0,0,0,1,1,5
AGGAA,0,0,0,1,1,5
GGAAP,0,0,0,1,1,5
GAAPH,0,0,0,1,1,5
AAPHF,0,0,0,1,1,5
APHFL,0,0,0,1,1,5
PHFLG,0,0,0,1,1,5
GLFKL,0,0,0,1,1,5
LFKLI,0,0,0,1,1,5
FKLIK,0,0,0,1,1,5
KLIKF,0,0,0,1,1,5
LIKFA,0,0,0,1,1,5
IKFAK,0,0,0,1,1,5
FAKKK,0,0,0,1,1,5
AKKKS,0,0,0,1,1,5
KKKSP,0,0,0,1,1,5
KKSPG,0,0,0,1,1,5
KSPGA,0,0,0,1,1,5
SPGAF,0,0,0,1,1,5
GLGKI,0,0,0,1,1,5
LGKII,0,0,0,1,1,5
GKIIG,0,0,0,1,1,5
KIIGK,0,0,0,1,1,5
IIGKV,0,0,0,1,1,5
IGKVK,0,0,0,1,1,5
GKVKK,0,0,0,1,1,5
KVKKS,0,0,0,1,1,5
KKSLL,0,0,0,1,1,5
KSLLK,0,0,0,1,1,5
SLLKS,0,0,0,2,2,5
LLKSI,0,0,0,1,1,5
GLGLV,0,0,0,1,1,5
LGLVL,0,0,0,1,1,5
GLVLK,0,0,0,1,1,5
LVLKI,0,0,0,1,1,5
VLKIA,0,0,0,1,1,5
LKIAV,0,0,0,1,1,5
KIAVN,0,0,0,1,1,5
IAVNA,0,0,0,1,1,5
AVNAF,0,0,0,1,1,5
VNAFL,0,0,0,1,1,5
NAFLK,0,0,0,1,1,5
AFLKL,0,0,0,2,2,5
FLKLV,0,0,0,1,1,5
LKLVA,0,0,0,1,1,5
GLLDI,0,0,0,1,1,5
LLDIA,0,0,0,1,1,5
LDIAG,0,0,0,1,1,5
DIAGG,0,0,0,1,1,5
IAGGN,0,0,0,1,1,5
AGGNA,0,0,0,1,1,5
GGNAE,0,0,0,1,1,5
GNAET,0,0,0,1,1,5
NAETL,0,0,0,1,1,5
AETLA,0,0,0,1,1,5
ETLAG,0,0,0,1,1,5
TLAGH,0,0,0,1,1,5
LAGHA,0,0,0,1,1,5
AGHAV,0,0,0,1,1,5
GLNAE,0,0,0,1,1,5
LNAEL,0,0,0,1,1,5
NAELT,0,0,0,1,1,5
AELTR,0,0,0,1,1,5
ELTRY,0,0,0,1,1,5
LTRYT,0,0,0,1,1,5
TRYTL,0,0,0,1,1,5
RYTLS,0,0,0,1,1,5
YTLSL,0,0,0,1,1,5
TLSLM,0,0,0,1,1,5
LSLMV,0,0,0,1,1,5
SLMVL,0,0,0,1,1,5
LMVLE,0,0,0,1,1,5
MVLER,0,0,0,1,1,5
VLERK,0,0,0,1,1,5
LERKL,0,0,0,1,1,5
ERKLS,0,0,0,1,1,5
RKLSS,0,0,0,1,1,5
KLSSA,0,0,0,1,1,5
GLTSL,0,0,0,1,1,5
LTSLM,0,0,0,1,1,5
TSLMA,0,0,0,1,1,5
SLMAI,0,0,0,1,1,5
LMAID,0,0,0,1,1,5
MAIDK,0,0,0,1,1,5
AIDKL,0,0,0,1,1,5
GLWAI,0,0,0,1,1,5
LWAIA,0,0,0,1,1,5
WAIAV,0,0,0,1,1,5
AIAVK,0,0,0,1,1,5
IAVKA,0,0,0,1,1,5
AVKAG,0,0,0,1,1,5
VKAGK,0,0,0,1,1,5
KAGKV,0,0,0,1,1,5
AGKVI,0,0,0,1,1,5
GKVIL,0,0,0,1,1,5
KVILK,0,0,0,1,1,5
VILKL,0,0,0,1,1,5
ILKLI,0,0,0,1,1,5
LKLIV,0,0,0,1,1,5
KLIVF,0,0,0,1,1,5
IVFIW,0,0,0,1,1,5
VFIWI,0,0,0,1,1,5
FIWIR,0,0,0,1,1,5
IWIRV,0,0,0,1,1,5
GLWKS,0,0,0,1,1,5
LWKSL,0,0,0,1,1,5
WKSLG,0,0,0,1,1,5
KSLGA,0,0,0,1,1,5
SLGAV,0,0,0,1,1,5
LGAVV,0,0,0,1,1,5
GAVVK,0,0,0,1,1,5
AVVKR,0,0,0,1,1,5
VVKRV,0,0,0,1,1,5
VKRVE,0,0,0,1,1,5
KRVEG,0,0,0,1,1,5
RVEGL,0,0,0,1,1,5
VEGLW,0,0,0,1,1,5
EGLWV,0,0,0,1,1,5
GLWVG,0,0,0,1,1,5
LWVGL,0,0,0,1,1,5
WVGLF,0,0,0,1,1,5
GNFAD,0,0,0,1,1,5
NFADL,0,0,0,1,1,5
FADLL,0,0,0,1,1,5
ADLLA,0,0,0,1,1,5
DLLAH,0,0,0,1,1,5
LLAHS,0,0,0,1,1,5
LAHSD,0,0,0,1,1,5
AHSDG,0,0,0,1,1,5
HSDGL,0,0,0,1,1,5
SDGLI,0,0,0,1,1,5
DGLIK,0,0,0,1,1,5
GLIKN,0,0,0,1,1,5
LIKNI,0,0,0,1,1,5
IKNIS,0,0,0,1,1,5
KNISD,0,0,0,1,1,5
NISDD,0,0,0,1,1,5
ISDDL,0,0,0,1,1,5
SDDLR,0,0,0,1,1,5
DDLRA,0,0,0,1,1,5
DLRAL,0,0,0,1,1,5
LRALD,0,0,0,1,1,5
RALDK,0,0,0,1,1,5
ALDKL,0,0,0,2,2,5
LDKLI,0,0,0,1,1,5
GNYLR,0,0,0,1,1,5
NYLRA,0,0,0,1,1,5
YLRAE,0,0,0,1,1,5
LRAEI,0,0,0,1,1,5
RAEIL,0,0,0,1,1,5
AEILY,0,0,0,1,1,5
EILYR,0,0,0,1,1,5
LYRLK,0,0,0,1,1,5
GPDMT,0,0,0,1,1,5
PDMTA,0,0,0,1,1,5
DMTAM,0,0,0,1,1,5
MTAMV,0,0,0,1,1,5
TAMVA,0,0,0,1,1,5
AMVAL,0,0,0,1,1,5
MVALI,0,0,0,1,1,5
VALIA,0,0,0,1,1,5
ALIAS,0,0,0,1,1,5
LIASV,0,0,0,1,1,5
GPKDA,0,0,0,1,1,5
PKDAV,0,0,0,1,1,5
KDAVV,0,0,0,1,1,5
DAVVK,0,0,0,1,1,5
AVVKV,0,0,0,1,1,5
VVKVF,0,0,0,1,1,5
VKVFN,0,0,0,1,1,5
KVFNQ,0,0,0,1,1,5
VFNQW,0,0,0,1,1,5
FNQWG,0,0,0,1,1,5
GPKKA,0,0,0,1,1,5
PKKAQ,0,0,0,1,1,5
KKAQL,0,0,0,1,1,5
KAQLI,0,0,0,1,1,5
AQLIV,0,0,0,1,1,5
QLIVG,0,0,0,1,1,5
LIVGW,0,0,0,1,1,5
IVGWR,0,0,0,1,1,5
VGWRE,0,0,0,1,1,5
GWREL,0,0,0,1,1,5
WRELH,0,0,0,1,1,5
RELHG,0,0,0,1,1,5
GSDFL,0,0,0,1,1,5
SDFLI,0,0,0,1,1,5
DFLIH,0,0,0,1,1,5
FLIHF,0,0,0,1,1,5
LIHFI,0,0,0,1,1,5
IHFID,0,0,0,1,1,5
HFIDE,0,0,0,1,1,5
GSHAN,0,0,0,1,1,5
SHANE,0,0,0,1,1,5
HANEF,0,0,0,1,1,5
ANEFF,0,0,0,2,2,5
NEFFF,0,0,0,1,1,5
EFFFR,0,0,0,1,1,5
FFFRA,0,0,0,1,1,5
GTLRH,0,0,0,1,1,5
TLRHA,0,0,0,1,1,5
LRHAA,0,0,0,1,1,5
RHAAN,0,0,0,1,1,5
HAANA,0,0,0,1,1,5
AANAA,0,0,0,1,1,5
ANAAF,0,0,0,1,1,5
NAAFI,0,0,0,1,1,5
AAFIM,0,0,0,1,1,5
AFIML,0,0,0,1,1,5
FIMLE,0,0,0,1,1,5
IMLEA,0,0,0,1,1,5
MLEAA,0,0,0,1,1,5
LEAAE,0,0,0,1,1,5
EAAEL,0,0,0,1,1,5
GTTTA,0,0,0,1,1,5
TTTAV,0,0,0,1,1,5
TTAVI,0,0,0,1,1,5
TAVII,0,0,0,1,1,5
AVIIA,0,0,0,1,1,5
VIIAG,0,0,0,1,1,5
IIAGG,0,0,0,1,1,5
IAGGL,0,0,0,1,1,5
AGGLL,0,0,0,1,1,5
GGLLQ,0,0,0,1,1,5
GLLQQ,0,0,0,1,1,5
LLQQA,0,0,0,1,1,5
LQQAQ,0,0,0,1,1,5
QQAQG,0,0,0,1,1,5
QAQGL,0,0,0,1,1,5
AQGLI,0,0,0,1,1,5
QGLIN,0,0,0,1,1,5
GVSGL,0,0,0,1,1,5
VSGLA,0,0,0,1,1,5
SGLAA,0,0,0,1,1,5
GLAAA,0,0,0,1,1,5
LAAAR,0,0,0,1,1,5
AAARQ,0,0,0,1,1,5
AARQL,0,0,0,1,1,5
ARQLQ,0,0,0,1,1,5
RQLQS,0,0,0,1,1,5
QLQSF,0,0,0,1,1,5
GWQNE,0,0,0,1,1,5
WQNEL,0,0,0,1,1,5
QNELL,0,0,0,1,1,5
NELLL,0,0,0,1,1,5
ELLLL,0,0,0,1,1,5
LLLLL,0,0,0,1,1,5
LLLLR,0,0,0,1,1,5
LLLRY,0,0,0,1,1,5
LLRYL,0,0,0,1,1,5
LRYLD,0,0,0,1,1,5
RYLDE,0,0,0,1,1,5
YLDEN,0,0,0,1,1,5
GYKKV,0,0,0,1,1,5
YKKVS,0,0,0,1,1,5
KKVSK,0,0,0,1,1,5
KVSKS,0,0,0,1,1,5
VSKSY,0,0,0,1,1,5
SKSYT,0,0,0,1,1,5
KSYTG,0,0,0,1,1,5
SYTGE,0,0,0,1,1,5
YTGEW,0,0,0,1,1,5
TGEWK,0,0,0,1,1,5
GEWKK,0,0,0,1,1,5
EWKKY,0,0,0,1,1,5
WKKYL,0,0,0,1,1,5
KKYLN,0,0,0,1,1,5
KYLNS,0,0,0,1,1,5
YLNSL,0,0,0,1,1,5
HAHAS,0,0,0,1,1,5
AHASA,0,0,0,1,1,5
HASAI,0,0,0,1,1,5
ASAIA,0,0,0,1,1,5
SAIAK,0,0,0,1,1,5
AIAKA,0,0,0,1,1,5
IAKAY,0,0,0,1,1,5
AKAYA,0,0,0,1,1,5
KAYAS,0,0,0,1,1,5
AYASE,0,0,0,1,1,5
YASEI,0,0,0,1,1,5
ASEIA,0,0,0,1,1,5
SEIAF,0,0,0,1,1,5
EIAFE,0,0,0,1,1,5
IAFEA,0,0,0,1,1,5
AFEAA,0,0,0,1,1,5
FEAAN,0,0,0,1,1,5
EAANQ,0,0,0,1,1,5
AANQA,0,0,0,1,1,5
ANQAI,0,0,0,1,1,5
NQAIQ,0,0,0,1,1,5
QAIQI,0,0,0,1,1,5
AIQIH,0,0,0,1,1,5
IQIHG,0,0,0,1,1,5
HALRT,0,0,0,1,1,5
ALRTI,0,0,0,1,1,5
LRTIV,0,0,0,1,1,5
RTIVF,0,0,0,1,1,5
TIVFE,0,0,0,1,1,5
IVFEL,0,0,0,1,1,5
VFELL,0,0,0,1,1,5
FELLT,0,0,0,1,1,5
ELLTR,0,0,0,1,1,5
LLTRH,0,0,0,1,1,5
HDKHI,0,0,0,1,1,5
DKHIE,0,0,0,1,1,5
KHIEI,0,0,0,1,1,5
HIEIV,0,0,0,1,1,5
IEIVV,0,0,0,1,1,5
EIVVR,0,0,0,1,1,5
IVVRQ,0,0,0,1,1,5
VVRQM,0,0,0,1,1,5
HDLVT,0,0,0,1,1,5
DLVTD,0,0,0,1,1,5
LVTDG,0,0,0,1,1,5
VTDGL,0,0,0,1,1,5
TDGLI,0,0,0,1,1,5
DGLIT,0,0,0,1,1,5
GLITL,0,0,0,1,1,5
LITLY,0,0,0,1,1,5
ITLYI,0,0,0,1,1,5
TLYIE,0,0,0,1,1,5
LYIET,0,0,0,1,1,5
YIETK,0,0,0,1,1,5
HFGSL,0,0,0,1,1,5
FGSLL,0,0,0,1,1,5
GSLLL,0,0,0,1,1,5
SLLLL,0,0,0,1,1,5
LLLLA,0,0,0,1,1,5
LLLAA,0,0,0,1,1,5
LLAAW,0,0,0,1,1,5
LAAWL,0,0,0,1,1,5
AAWLA,0,0,0,1,1,5
AWLAE,0,0,0,1,1,5
WLAEN,0,0,0,1,1,5
HGLVK,0,0,0,1,1,5
GLVKA,0,0,0,1,1,5
LVKAG,0,0,0,1,1,5
VKAGH,0,0,0,1,1,5
KAGHP,0,0,0,1,1,5
AGHPL,0,0,0,1,1,5
GHPLK,0,0,0,1,1,5
HPLKR,0,0,0,1,1,5
PLKRK,0,0,0,1,1,5
LKRKL,0,0,0,1,1,5
KRKLG,0,0,0,1,1,5
RKLGH,0,0,0,1,1,5
HHKAY,0,0,0,1,1,5
HKAYV,0,0,0,1,1,5
KAYVD,0,0,0,1,1,5
AYVDG,0,0,0,1,1,5
YVDGA,0,0,0,1,1,5
VDGAN,0,0,0,1,1,5
DGANT,0,0,0,1,1,5
GANTA,0,0,0,1,1,5
ANTAL,0,0,0,1,1,5
NTALD,0,0,0,1,1,5
TALDK,0,0,0,1,1,5
LDKLA,0,0,0,3,3,5
DKLAE,0,0,0,2,2,5
KLAEA,0,0,0,1,1,5
LAEAR,0,0,0,1,1,5
AEARD,0,0,0,1,1,5
EARDK,0,0,0,1,1,5
HKEMA,0,0,0,1,1,5
KEMAK,0,0,0,1,1,5
EMAKA,0,0,0,1,1,5
MAKAF,0,0,0,1,1,5
AKAFE,0,0,0,1,1,5
KAFEE,0,0,0,2,2,5
AFEEW,0,0,0,1,1,5
HLDLI,0,0,0,1,1,5
LDLIN,0,0,0,1,1,5
DLINM,0,0,0,1,1,5
LINMM,0,0,0,1,1,5
INMMS,0,0,0,1,1,5
NMMSR,0,0,0,1,1,5
MMSRL,0,0,0,1,1,5
MSRLA,0,0,0,1,1,5
SRLAR,0,0,0,1,1,5
RLARE,0,0,0,1,1,5
LAREE,0,0,0,1,1,5
AREEL,0,0,0,1,1,5
REELV,0,0,0,1,1,5
EELVH,0,0,0,1,1,5
ELVHH,0,0,0,1,1,5
LVHHE,0,0,0,1,1,5
VHHEQ,0,0,0,1,1,5
HHEQV,0,0,0,1,1,5
HEQVL,0,0,0,1,1,5
EQVLR,0,0,0,1,1,5
QVLRL,0,0,0,1,1,5
VLRLM,0,0,0,1,1,5
LRLMK,0,0,0,1,1,5
RLMKR,0,0,0,1,1,5
LMKRR,0,0,0,1,1,5
HMKMR,0,0,0,1,1,5
MKMRS,0,0,0,1,1,5
KMRSQ,0,0,0,1,1,5
MRSQL,0,0,0,1,1,5
RSQLL,0,0,0,1,1,5
SQLLI,0,0,0,1,1,5
QLLIV,0,0,0,1,1,5
LLIVL,0,0,0,1,1,5
LIVLQ,0,0,0,1,1,5
IVLQE,0,0,0,1,1,5
VLQEH,0,0,0,1,1,5
LQEHL,0,0,0,1,1,5
QEHLR,0,0,0,1,1,5
EHLRN,0,0,0,1,1,5
HPAFI,0,0,0,1,1,5
PAFIA,0,0,0,1,1,5
AFIAH,0,0,0,1,1,5
FIAHA,0,0,0,1,1,5
IAHAD,0,0,0,1,1,5
AHADR,0,0,0,1,1,5
HADRV,0,0,0,1,1,5
ADRVL,0,0,0,1,1,5
DRVLG,0,0,0,1,1,5
RVLGG,0,0,0,1,1,5
VLGGL,0,0,0,1,1,5
LGGLD,0,0,0,1,1,5
GGLDI,0,0,0,1,1,5
GLDIA,0,0,0,1,1,5
LDIAI,0,0,0,1,1,5
DIAIS,0,0,0,1,1,5
IAIST,0,0,0,1,1,5
HPFYQ,0,0,0,1,1,5
PFYQA,0,0,0,1,1,5
FYQAL,0,0,0,1,1,5
YQALG,0,0,0,1,1,5
QALGQ,0,0,0,1,1,5
ALGQL,0,0,0,1,1,5
LGQLA,0,0,0,1,1,5
GQLAR,0,0,0,1,1,5
QLARL,0,0,0,1,1,5
ARLTL,0,0,0,1,1,5
RLTLA,0,0,0,1,1,5
LTLAQ,0,0,0,1,1,5
TLAQW,0,0,0,1,1,5
LAQWQ,0,0,0,1,1,5
AQWQA,0,0,0,1,1,5
QWQAQ,0,0,0,1,1,5
WQAQL,0,0,0,1,1,5
HQAAM,0,0,0,1,1,5
QAAMQ,0,0,0,1,1,5
AAMQM,0,0,0,1,1,5
AMQML,0,0,0,1,1,5
MQMLK,0,0,0,1,1,5
QMLKE,0,0,0,1,1,5
MLKET,0,0,0,1,1,5
LKETI,0,0,0,1,1,5
KETIN,0,0,0,1,1,5
ETINE,0,0,0,1,1,5
TINEE,0,0,0,1,1,5
INEEA,0,0,0,1,1,5
NEEAA,0,0,0,1,1,5
EAAEW,0,0,0,1,1,5
AAEWD,0,0,0,1,1,5
AEWDR,0,0,0,1,1,5
EWDRL,0,0,0,1,1,5
WDRLH,0,0,0,1,1,5
HSATR,0,0,0,1,1,5
SATRA,0,0,0,1,1,5
ATRAA,0,0,0,1,1,5
TRAAM,0,0,0,1,1,5
RAAML,0,0,0,1,1,5
AAMLV,0,0,0,1,1,5
AMLVR,0,0,0,1,1,5
MLVRI,0,0,0,1,1,5
LVRIN,0,0,0,1,1,5
VRINT,0,0,0,1,1,5
HSDWI,0,0,0,1,1,5
SDWIS,0,0,0,1,1,5
DWISN,0,0,0,1,1,5
WISNA,0,0,0,1,1,5
ISNAN,0,0,0,1,1,5
SNANK,0,0,0,1,1,5
NANKV,0,0,0,1,1,5
ANKVR,0,0,0,1,1,5
NKVRV,0,0,0,1,1,5
KVRVI,0,0,0,1,1,5
VRVIY,0,0,0,1,1,5
RVIYW,0,0,0,1,1,5
VIYWQ,0,0,0,1,1,5
IYWQM,0,0,0,1,1,5
YWQMT,0,0,0,1,1,5
HSRRG,0,0,0,1,1,5
SRRGL,0,0,0,1,1,5
RRGLL,0,0,0,1,1,5
RGLLK,0,0,0,1,1,5
GLLKM,0,0,0,1,1,5
LLKMV,0,0,0,1,1,5
LKMVG,0,0,0,1,1,5
KMVGK,0,0,0,1,1,5
MVGKR,0,0,0,1,1,5
VGKRR,0,0,0,1,1,5
GKRRR,0,0,0,1,1,5
KRRRL,0,0,0,1,1,5
RRRLL,0,0,0,1,1,5
RRLLA,0,0,0,1,1,5
RLLAY,0,0,0,1,1,5
LLAYL,0,0,0,1,1,5
LAYLR,0,0,0,1,1,5
AYLRN,0,0,0,1,1,5
YLRNK,0,0,0,1,1,5
HTFLD,0,0,0,1,1,5
TFLDD,0,0,0,1,1,5
FLDDI,0,0,0,1,1,5
LDDIV,0,0,0,1,1,5
DDIVG,0,0,0,1,1,5
DIVGA,0,0,0,1,1,5
IVGAI,0,0,0,1,1,5
VGAIA,0,0,0,1,1,5
GAIAA,0,0,0,1,1,5
AIAAA,0,0,0,1,1,5
IAAAA,0,0,0,1,1,5
AAAAA,0,0,0,1,1,5
AAAAS,0,0,0,1,1,5
AAASR,0,0,0,1,1,5
AASRL,0,0,0,1,1,5
ASRLA,0,0,0,2,2,5
SRLAH,0,0,0,1,1,5
RLAHS,0,0,0,1,1,5
LAHSY,0,0,0,1,1,5
AHSYH,0,0,0,1,1,5
HSYHD,0,0,0,1,1,5
HVVDE,0,0,0,1,1,5
VVDEK,0,0,0,1,1,5
VDEKA,0,0,0,1,1,5
DEKAR,0,0,0,1,1,5
EKARL,0,0,0,1,1,5
KARLI,0,0,0,1,1,5
ARLIY,0,0,0,1,1,5
RLIYE,0,0,0,1,1,5
LIYED,0,0,0,1,1,5
HWDKV,0,0,0,1,1,5
WDKVA,0,0,0,1,1,5
DKVAD,0,0,0,1,1,5
KVADM,0,0,0,1,1,5
VADMV,0,0,0,1,1,5
ADMVA,0,0,0,1,1,5
DMVAN,0,0,0,1,1,5
MVANF,0,0,0,1,1,5
VANFA,0,0,0,1,1,5
ANFAH,0,0,0,1,1,5
NFAHE,0,0,0,1,1,5
FAHEI,0,0,0,1,1,5
AHEID,0,0,0,1,1,5
HEIDT,0,0,0,1,1,5
EIDTY,0,0,0,1,1,5
IDTYG,0,0,0,1,1,5
IAMVN,0,0,0,1,1,5
AMVNG,0,0,0,1,1,5
MVNGL,0,0,0,1,1,5
VNGLM,0,0,0,1,1,5
NGLMG,0,0,0,1,1,5
GLMGV,0,0,0,1,1,5
LMGVL,0,0,0,1,1,5
MGVLD,0,0,0,1,1,5
GVLDK,0,0,0,1,1,5
VLDKL,0,0,0,1,1,5
DKLAH,0,0,0,1,1,5
KLAHL,0,0,0,1,1,5
LAHLI,0,0,0,1,1,5
AHLID,0,0,0,1,1,5
HLIDE,0,0,0,1,1,5
IASEF,0,0,0,1,1,5
ASEFK,0,0,0,1,1,5
SEFKN,0,0,0,1,1,5
EFKNI,0,0,0,1,1,5
FKNIA,0,0,0,1,1,5
KNIAT,0,0,0,1,1,5
NIATN,0,0,0,1,1,5
IATNS,0,0,0,1,1,5
IDDLR,0,0,0,1,1,5
DDLRV,0,0,0,1,1,5
DLRVI,0,0,0,1,1,5
LRVIA,0,0,0,1,1,5
RVIAR,0,0,0,1,1,5
VIARE,0,0,0,1,1,5
IAREN,0,0,0,1,1,5
ARENL,0,0,0,1,1,5
RENLE,0,0,0,1,1,5
ENLER,0,0,0,1,1,5
NLERR,0,0,0,1,1,5
LERRR,0,0,0,1,1,5
ERRRK,0,0,0,1,1,5
IDDSV,0,0,0,1,1,5
DDSVN,0,0,0,1,1,5
DSVNN,0,0,0,1,1,5
SVNNL,0,0,0,1,1,5
VNNLI,0,0,0,1,1,5
NNLIP,0,0,0,1,1,5
NLIPF,0,0,0,1,1,5
LIPFM,0,0,0,1,1,5
IPFMQ,0,0,0,1,1,5
PFMQK,0,0,0,1,1,5
FMQKH,0,0,0,1,1,5
IEEAT,0,0,0,1,1,5
EEATE,0,0,0,1,1,5
EATEF,0,0,0,1,1,5
ATEFY,0,0,0,1,1,5
TEFYE,0,0,0,1,1,5
EFYEN,0,0,0,1,1,5
FYEND,0,0,0,1,1,5
YENDV,0,0,0,1,1,5
IEFRK,0,0,0,1,1,5
EFRKA,0,0,0,1,1,5
FRKAF,0,0,0,2,2,5
RKAFL,0,0,0,1,1,5
KAFLK,0,0,0,1,1,5
AFLKI,0,0,0,1,1,5
FLKIL,0,0,0,1,1,5
IGVQQ,0,0,0,1,1,5
GVQQH,0,0,0,1,1,5
VQQHA,0,0,0,1,1,5
QQHAD,0,0,0,1,1,5
QHADK,0,0,0,1,1,5
HADKV,0,0,0,1,1,5
ADKVQ,0,0,0,1,1,5
DKVQR,0,0,0,1,1,5
KVQRA,0,0,0,1,1,5
VQRAL,0,0,0,1,1,5
QRALG,0,0,0,1,1,5
RALGE,0,0,0,1,1,5
ALGEA,0,0,0,1,1,5
LGEAI,0,0,0,1,1,5
GEAID,0,0,0,1,1,5
EAIDD,0,0,0,1,1,5
IHNVV,0,0,0,1,1,5
HNVVG,0,0,0,1,1,5
NVVGK,0,0,0,1,1,5
VVGKL,0,0,0,1,1,5
IKPLN,0,0,0,1,1,5
KPLNN,0,0,0,1,1,5
PLNNF,0,0,0,1,1,5
LNNFA,0,0,0,1,1,5
NNFAA,0,0,0,1,1,5
NFAAE,0,0,0,1,1,5
FAAEV,0,0,0,1,1,5
AAEVG,0,0,0,1,1,5
AEVGK,0,0,0,1,1,5
EVGKI,0,0,0,1,1,5
VGKIR,0,0,0,1,1,5
GKIRD,0,0,0,1,1,5
KIRDS,0,0,0,1,1,5
IMELL,0,0,0,1,1,5
MELLG,0,0,0,1,1,5
ELLGT,0,0,0,1,1,5
LLGTV,0,0,0,1,1,5
LGTVI,0,0,0,1,1,5
GTVIQ,0,0,0,1,1,5
TVIQH,0,0,0,1,1,5
VIQHE,0,0,0,1,1,5
IQHEG,0,0,0,1,1,5
QHEGI,0,0,0,1,1,5
HEGIH,0,0,0,1,1,5
EGIHQ,0,0,0,1,1,5
GIHQG,0,0,0,1,1,5
IHQGQ,0,0,0,1,1,5
HQGQY,0,0,0,1,1,5
QGQYY,0,0,0,1,1,5
GQYYV,0,0,0,1,1,5
QYYVA,0,0,0,1,1,5
YYVAL,0,0,0,1,1,5
YVALK,0,0,0,1,1,5
VALKQ,0,0,0,1,1,5
ALKQS,0,0,0,1,1,5
LKQSG,0,0,0,1,1,5
IPAAK,0,0,0,1,1,5
PAAKI,0,0,0,1,1,5
AAKIN,0,0,0,1,1,5
AKINW,0,0,0,1,1,5
KINWD,0,0,0,1,1,5
INWDR,0,0,0,1,1,5
NWDRD,0,0,0,1,1,5
WDRDI,0,0,0,1,1,5
DRDIE,0,0,0,1,1,5
RDIEY,0,0,0,1,1,5
DIEYM,0,0,0,1,1,5
IEYMA,0,0,0,1,1,5
EYMAG,0,0,0,1,1,5
YMAGI,0,0,0,1,1,5
MAGIL,0,0,0,1,1,5
AGILE,0,0,0,1,1,5
GILEN,0,0,0,1,1,5
IPAVA,0,0,0,1,1,5
PAVAN,0,0,0,1,1,5
AVANW,0,0,0,1,1,5
VANWI,0,0,0,1,1,5
ANWIK,0,0,0,1,1,5
NWIKR,0,0,0,1,1,5
WIKRR,0,0,0,1,1,5
IPEAK,0,0,0,1,1,5
PEAKS,0,0,0,1,1,5
EAKSF,0,0,0,1,1,5
AKSFY,0,0,0,1,1,5
KSFYG,0,0,0,1,1,5
SFYGF,0,0,0,1,1,5
FYGFQ,0,0,0,1,1,5
YGFQI,0,0,0,1,1,5
GFQIM,0,0,0,1,1,5
FQIMI,0,0,0,1,1,5
QIMIE,0,0,0,1,1,5
IMIEN,0,0,0,1,1,5
MIENI,0,0,0,1,1,5
IENIH,0,0,0,1,1,5
ENIHS,0,0,0,1,1,5
NIHSE,0,0,0,1,1,5
IHSET,0,0,0,1,1,5
HSETY,0,0,0,1,1,5
SETYS,0,0,0,1,1,5
ETYSL,0,0,0,1,1,5
TYSLL,0,0,0,1,1,5
YSLLI,0,0,0,1,1,5
SLLID,0,0,0,1,1,5
LLIDT,0,0,0,1,1,5
LIDTY,0,0,0,1,1,5
IDTYI,0,0,0,1,1,5
IRVNA,0,0,0,1,1,5
RVNAT,0,0,0,1,1,5
VNATK,0,0,0,1,1,5
NATKA,0,0,0,1,1,5
ATKAY,0,0,0,1,1,5
TKAYE,0,0,0,1,1,5
KAYEM,0,0,0,1,1,5
AYEMA,0,0,0,1,1,5
YEMAL,0,0,0,1,1,5
KDAEN,0,0,0,1,1,5
DAENH,0,0,0,1,1,5
AENHK,0,0,0,1,1,5
ENHKA,0,0,0,1,1,5
NHKAY,0,0,0,1,1,5
HKAYL,0,0,0,1,1,5
KAYLK,0,0,0,1,1,5
AYLKS,0,0,0,1,1,5
YLKSH,0,0,0,1,1,5
KDFET,0,0,0,1,1,5
DFETL,0,0,0,1,1,5
FETLK,0,0,0,1,1,5
ETLKV,0,0,0,1,1,5
TLKVD,0,0,0,1,1,5
LKVDF,0,0,0,1,1,5
KVDFL,0,0,0,1,1,5
VDFLS,0,0,0,2,2,5
DFLSK,0,0,0,1,1,5
FLSKL,0,0,0,1,1,5
LSKLP,0,0,0,1,1,5
SKLPE,0,0,0,1,1,5
KLPEM,0,0,0,1,1,5
LPEML,0,0,0,1,1,5
PEMLK,0,0,0,1,1,5
EMLKM,0,0,0,1,1,5
MLKMF,0,0,0,1,1,5
LKMFE,0,0,0,1,1,5
KMFED,0,0,0,1,1,5
MFEDR,0,0,0,1,1,5
FEDRL,0,0,0,1,1,5
KDTVI,0,0,0,1,1,5
DTVIE,0,0,0,1,1,5
TVIED,0,0,0,1,1,5
VIEDI,0,0,0,1,1,5
IEDII,0,0,0,1,1,5
EDIID,0,0,0,1,1,5
DIIDK,0,0,0,1,1,5
IIDKT,0,0,0,1,1,5
IDKTF,0,0,0,1,1,5
DKTFE,0,0,0,1,1,5
KTFEE,0,0,0,1,1,5
TFEEA,0,0,0,1,1,5
FEEAD,0,0,0,1,1,5
KEDIH,0,0,0,1,1,5
EDIHR,0,0,0,1,1,5
DIHRS,0,0,0,1,1,5
IHRSL,0,0,0,1,1,5
HRSLV,0,0,0,1,1,5
RSLVE,0,0,0,1,1,5
VEELT,0,0,0,1,1,5
EELTK,0,0,0,1,1,5
ELTKI,0,0,0,1,1,5
LTKIS,0,0,0,1,1,5
TKISA,0,0,0,1,1,5
KISAK,0,0,0,1,1,5
ISAKE,0,0,0,1,1,5
SAKEK,0,0,0,1,1,5
KEEGY,0,0,0,1,1,5
EEGYF,0,0,0,1,1,5
EGYFY,0,0,0,1,1,5
GYFYF,0,0,0,1,1,5
YFYFR,0,0,0,1,1,5
FYFRS,0,0,0,1,1,5
YFRSR,0,0,0,1,1,5
FRSRL,0,0,0,1,1,5
RSRLS,0,0,0,1,1,5
SRLSQ,0,0,0,1,1,5
KEEVQ,0,0,0,1,1,5
EEVQK,0,0,0,1,1,5
EVQKV,0,0,0,2,2,5
VQKVL,0,0,0,1,1,5
QKVLE,0,0,0,1,1,5
KVLED,0,0,0,1,1,5
VLEDA,0,0,0,1,1,5
KEIAE,0,0,0,1,1,5
EIAEK,0,0,0,1,1,5
IAEKM,0,0,0,1,1,5
AEKMV,0,0,0,1,1,5
EKMVE,0,0,0,1,1,5
KMVEG,0,0,0,1,1,5
MVEGR,0,0,0,1,1,5
VEGRM,0,0,0,1,1,5
EGRMK,0,0,0,1,1,5
GRMKK,0,0,0,1,1,5
RMKKF,0,0,0,1,1,5
MKKFT,0,0,0,1,1,5
KKFTG,0,0,0,1,1,5
KFTGE,0,0,0,1,1,5
FTGEV,0,0,0,1,1,5
FLKKW,0,0,0,1,1,5
LKKWE,0,0,0,1,1,5
KKWEG,0,0,0,1,1,5
KWEGI,0,0,0,1,1,5
WEGIW,0,0,0,1,1,5
EGIWA,0,0,0,1,1,5
GIWAT,0,0,0,1,1,5
IWATF,0,0,0,1,1,5
WATFK,0,0,0,1,1,5
ATFKP,0,0,0,1,1,5
TFKPA,0,0,0,1,1,5
FKPAL,0,0,0,1,1,5
KPALS,0,0,0,1,1,5
PALSA,0,0,0,1,1,5
ALSAV,0,0,0,1,1,5
LSAVV,0,0,0,1,1,5
KFLRF,0,0,0,1,1,5
FLRFI,0,0,0,1,1,5
LRFIL,0,0,0,1,1,5
RFILK,0,0,0,1,1,5
FILKW,0,0,0,1,1,5
ILKWF,0,0,0,1,1,5
LKWFK,0,0,0,1,1,5
KWFKV,0,0,0,1,1,5
WFKVI,0,0,0,1,1,5
FKVIF,0,0,0,1,1,5
KVIFQ,0,0,0,1,1,5
FLTKL,0,0,0,1,1,5
LTKLK,0,0,0,1,1,5
TKLKN,0,0,0,1,1,5
KLKNI,0,0,0,1,1,5
LKNIV,0,0,0,1,1,5
KNIVA,0,0,0,1,1,5
NIVAN,0,0,0,1,1,5
IVANI,0,0,0,1,1,5
VANIR,0,0,0,1,1,5
ANIRI,0,0,0,1,1,5
NIRIW,0,0,0,1,1,5
IRIWW,0,0,0,1,1,5
RIWWV,0,0,0,1,1,5
IWWVI,0,0,0,1,1,5
WWVIL,0,0,0,1,1,5
WVILL,0,0,0,1,1,5
KGQEY,0,0,0,1,1,5
GQEYI,0,0,0,1,1,5
QEYIN,0,0,0,1,1,5
EYINN,0,0,0,1,1,5
YINNI,0,0,0,1,1,5
INNIH,0,0,0,1,1,5
NNIHL,0,0,0,1,1,5
KHFDF,0,0,0,1,1,5
HFDFL,0,0,0,1,1,5
FDFLA,0,0,0,1,1,5
DFLAE,0,0,0,1,1,5
FLAEF,0,0,0,1,1,5
LAEFN,0,0,0,1,1,5
AEFNA,0,0,0,1,1,5
EFNAK,0,0,0,1,1,5
FNAKA,0,0,0,1,1,5
NAKAN,0,0,0,1,1,5
AKAND,0,0,0,1,1,5
KHHAA,0,0,0,1,1,5
HHAAY,0,0,0,1,1,5
HAAYV,0,0,0,1,1,5
AAYVN,0,0,0,1,1,5
AYVNN,0,0,0,1,1,5
YVNNL,0,0,0,1,1,5
VNNLN,0,0,0,1,1,5
NNLNN,0,0,0,1,1,5
NLNNA,0,0,0,1,1,5
LNNAL,0,0,0,1,1,5
NNALK,0,0,0,1,1,5
NALKK,0,0,0,1,1,5
KIPDD,0,0,0,1,1,5
IPDDL,0,0,0,1,1,5
PDDLQ,0,0,0,1,1,5
DDLQA,0,0,0,1,1,5
DLQAD,0,0,0,1,1,5
LQADF,0,0,0,1,1,5
QADFN,0,0,0,1,1,5
ADFNK,0,0,0,1,1,5
DFNKF,0,0,0,1,1,5
FNKFR,0,0,0,1,1,5
KKAEA,0,0,0,1,1,5
KAEAV,0,0,0,1,1,5
AEAVA,0,0,0,1,1,5
EAVAT,0,0,0,1,1,5
AVATV,0,0,0,1,1,5
VATVV,0,0,0,1,1,5
ATVVA,0,0,0,1,1,5
TVVAA,0,0,0,1,1,5
VVAAV,0,0,0,1,1,5
VAAVD,0,0,0,1,1,5
AAVDQ,0,0,0,1,1,5
AVDQA,0,0,0,1,1,5
VDQAR,0,0,0,1,1,5
DQARV,0,0,0,1,1,5
QARVR,0,0,0,1,1,5
KKDVK,0,0,0,1,1,5
KDVKL,0,0,0,1,1,5
DVKLI,0,0,0,1,1,5
VKLIL,0,0,0,1,1,5
KLILD,0,0,0,1,1,5
LILDT,0,0,0,1,1,5
ILDTI,0,0,0,1,1,5
LDTIL,0,0,0,1,1,5
DTILE,0,0,0,1,1,5
TILET,0,0,0,1,1,5
ILETI,0,0,0,1,1,5
LETIT,0,0,0,1,1,5
ETITE,0,0,0,1,1,5
TITEA,0,0,0,1,1,5
ITEAL,0,0,0,1,1,5
TEALA,0,0,0,1,1,5
EALAK,0,0,0,2,2,5
KKEEL,0,0,0,2,2,5
KEELQ,0,0,0,1,1,5
EELQR,0,0,0,1,1,5
ELQRS,0,0,0,1,1,5
LQRSL,0,0,0,1,1,5
QRSLN,0,0,0,1,1,5
RSLNI,0,0,0,1,1,5
SLNIL,0,0,0,1,1,5
LNILT,0,0,0,1,1,5
NILTA,0,0,0,1,1,5
ILTAF,0,0,0,1,1,5
KKQEL,0,0,0,1,1,5
KQELL,0,0,0,1,1,5
QELLE,0,0,0,1,1,5
ELLEA,0,0,0,1,1,5
LEALT,0,0,0,2,2,5
ALTKH,0,0,0,1,1,5
LTKHF,0,0,0,1,1,5
TKHFQ,0,0,0,1,1,5
KKTAE,0,0,0,1,1,5
KTAER,0,0,0,1,1,5
TAERL,0,0,0,1,1,5
AERLI,0,0,0,1,1,5
ERLIV,0,0,0,1,1,5
RLIVE,0,0,0,1,1,5
LIVEM,0,0,0,1,1,5
IVEMK,0,0,0,1,1,5
VEMKD,0,0,0,1,1,5
EMKDR,0,0,0,1,1,5
MKDRF,0,0,0,1,1,5
KDRFK,0,0,0,1,1,5
DRFKG,0,0,0,1,1,5
KKVKG,0,0,0,1,1,5
KVKGY,0,0,0,1,1,5
VKGYK,0,0,0,1,1,5
KGYKR,0,0,0,1,1,5
GYKRA,0,0,0,1,1,5
YKRAL,0,0,0,1,1,5
KRALT,0,0,0,1,1,5
RALTE,0,0,0,1,1,5
KLDSR,0,0,0,1,1,5
LDSRF,0,0,0,1,1,5
DSRFD,0,0,0,1,1,5
SRFDN,0,0,0,1,1,5
RFDNN,0,0,0,1,1,5
FDNNL,0,0,0,1,1,5
DNNLG,0,0,0,1,1,5
NNLGK,0,0,0,1,1,5
NLGKF,0,0,0,1,1,5
LGKFR,0,0,0,1,1,5
GKFRF,0,0,0,1,1,5
KFRFV,0,0,0,1,1,5
FRFVL,0,0,0,1,1,5
RFVLL,0,0,0,1,1,5
FVLLL,0,0,0,1,1,5
VLLLF,0,0,0,1,1,5
LLLFV,0,0,0,1,1,5
KLEEK,0,0,0,1,1,5
LEEKF,0,0,0,1,1,5
EEKFP,0,0,0,1,1,5
EKFPQ,0,0,0,1,1,5
KFPQV,0,0,0,1,1,5
FPQVA,0,0,0,1,1,5
PQVAA,0,0,0,1,1,5
QVAAT,0,0,0,1,1,5
KLKEL,0,0,0,1,1,5
LKELA,0,0,0,1,1,5
KELAL,0,0,0,1,1,5
ELALI,0,0,0,1,1,5
LALIF,0,0,0,1,1,5
ALIFI,0,0,0,1,1,5
LIFIS,0,0,0,1,1,5
IFISN,0,0,0,1,1,5
FISNL,0,0,0,1,1,5
ISNLV,0,0,0,1,1,5
SNLVA,0,0,0,1,1,5
NLVAN,0,0,0,1,1,5
KNIKR,0,0,0,1,1,5
NIKRN,0,0,0,1,1,5
IKRNV,0,0,0,1,1,5
KRNVE,0,0,0,1,1,5
RNVEK,0,0,0,1,1,5
NVEKI,0,0,0,1,1,5
VEKII,0,0,0,1,1,5
EKIIA,0,0,0,1,1,5
KIIAQ,0,0,0,1,1,5
IIAQW,0,0,0,1,1,5
IAQWD,0,0,0,1,1,5
AQWDE,0,0,0,1,1,5
QWDER,0,0,0,1,1,5
WDERT,0,0,0,1,1,5
DERTR,0,0,0,1,1,5
ERTRK,0,0,0,1,1,5
KPEEV,0,0,0,1,1,5
PEEVE,0,0,0,1,1,5
EEVEQ,0,0,0,1,1,5
EVEQI,0,0,0,1,1,5
VEQIK,0,0,0,1,1,5
EQIKL,0,0,0,1,1,5
QIKLY,0,0,0,1,1,5
IKLYV,0,0,0,1,1,5
KLYVM,0,0,0,1,1,5
LYVMS,0,0,0,1,1,5
YVMSR,0,0,0,1,1,5
VMSRE,0,0,0,1,1,5
MSREY,0,0,0,1,1,5
SREYE,0,0,0,1,1,5
REYED,0,0,0,1,1,5
EYEDY,0,0,0,1,1,5
YEDYM,0,0,0,1,1,5
EDYMA,0,0,0,1,1,5
DYMAR,0,0,0,1,1,5
KPEQY,0,0,0,1,1,5
PEQYN,0,0,0,1,1,5
EQYNI,0,0,0,1,1,5
QYNIV,0,0,0,1,1,5
YNIVG,0,0,0,1,1,5
NIVGE,0,0,0,1,1,5
IVGEH,0,0,0,1,1,5
VGEHL,0,0,0,1,1,5
GEHLL,0,0,0,1,1,5
EHLLA,0,0,0,1,1,5
HLLAT,0,0,0,1,1,5
LLATL,0,0,0,1,1,5
LATLD,0,0,0,1,1,5
ATLDE,0,0,0,1,1,5
TLDEM,0,0,0,1,1,5
LDEMF,0,0,0,1,1,5
DEMFS,0,0,0,1,1,5
KPQEL,0,0,0,1,1,5
PQELL,0,0,0,1,1,5
QELLS,0,0,0,1,1,5
ELLSL,0,0,0,1,1,5
LLSLI,0,0,0,1,1,5
LSLII,0,0,0,1,1,5
SLIIE,0,0,0,1,1,5
LIIER,0,0,0,1,1,5
IIERF,0,0,0,1,1,5
IERFE,0,0,0,1,1,5
KPQER,0,0,0,1,1,5
PQERA,0,0,0,1,1,5
QERAD,0,0,0,1,1,5
ERADL,0,0,0,1,1,5
RADLI,0,0,0,1,1,5
ADLIS,0,0,0,1,1,5
DLISY,0,0,0,1,1,5
LISYL,0,0,0,1,1,5
ISYLK,0,0,0,1,1,5
SYLKE,0,0,0,1,1,5
YLKEA,0,0,0,1,1,5
LKEAT,0,0,0,1,1,5
KEATS,0,0,0,1,1,5
KPWLS,0,0,0,1,1,5
PWLSV,0,0,0,1,1,5
WLSVI,0,0,0,1,1,5
LSVIL,0,0,0,1,1,5
SVILF,0,0,0,1,1,5
VILFL,0,0,0,1,1,5
ILFLI,0,0,0,1,1,5
LFLIR,0,0,0,1,1,5
FLIRE,0,0,0,1,1,5
LIRER,0,0,0,1,1,5
IRERS,0,0,0,1,1,5
RERSR,0,0,0,1,1,5
KQAEA,0,0,0,1,1,5
QAEAE,0,0,0,1,1,5
AEAEE,0,0,0,1,1,5
EAEEF,0,0,0,1,1,5
AEEFV,0,0,0,1,1,5
EEFVQ,0,0,0,1,1,5
EFVQT,0,0,0,1,1,5
FVQTL,0,0,0,1,1,5
VQTLG,0,0,0,1,1,5
QTLGQ,0,0,0,1,1,5
TLGQS,0,0,0,1,1,5
LGQSL,0,0,0,1,1,5
GQSLA,0,0,0,1,1,5
KQLTA,0,0,0,1,1,5
QLTAI,0,0,0,1,1,5
LTAIA,0,0,0,1,1,5
TAIAA,0,0,0,1,1,5
AIAAL,0,0,0,1,1,5
IAALA,0,0,0,1,1,5
AALAE,0,0,0,1,1,5
KREII,0,0,0,1,1,5
REIIH,0,0,0,1,1,5
EIIHA,0,0,0,1,1,5
IIHAV,0,0,0,1,1,5
IHAVL,0,0,0,1,1,5
HAVLT,0,0,0,1,1,5
AVLTG,0,0,0,1,1,5
VLTGL,0,0,0,1,1,5
LTGLA,0,0,0,1,1,5
TGLAL,0,0,0,1,1,5
GLALD,0,0,0,1,1,5
LALDQ,0,0,0,1,1,5
ALDQL,0,0,0,1,1,5
LDQLA,0,0,0,1,1,5
DQLAE,0,0,0,1,1,5
QLAEQ,0,0,0,1,1,5
KREVQ,0,0,0,1,1,5
REVQN,0,0,0,1,1,5
EVQNA,0,0,0,1,1,5
VQNAI,0,0,0,1,1,5
QNAIL,0,0,0,1,1,5
NAILT,0,0,0,1,1,5
AILTG,0,0,0,1,1,5
ILTGI,0,0,0,1,1,5
LTGIQ,0,0,0,1,1,5
TGIQL,0,0,0,1,1,5
GIQLD,0,0,0,1,1,5
IQLDK,0,0,0,1,1,5
QLDKL,0,0,0,1,1,5
KLAED,0,0,0,1,1,5
KSEAL,0,0,0,1,1,5
SEALA,0,0,0,1,1,5
ALAKM,0,0,0,1,1,5
LAKMW,0,0,0,1,1,5
AKMWG,0,0,0,1,1,5
KMWGQ,0,0,0,1,1,5
MWGQR,0,0,0,1,1,5
WGQRK,0,0,0,1,1,5
KTAST,0,0,0,1,1,5
TASTG,0,0,0,1,1,5
ASTGF,0,0,0,1,1,5
STGFA,0,0,0,1,1,5
TGFAE,0,0,0,1,1,5
GFAEL,0,0,0,1,1,5
FAELL,0,0,0,1,1,5
AELLK,0,0,0,1,1,5
ELLKD,0,0,0,1,1,5
LLKDR,0,0,0,1,1,5
LKDRR,0,0,0,1,1,5
KDRRE,0,0,0,1,1,5
DRREQ,0,0,0,1,1,5
RREQV,0,0,0,1,1,5
KTFRT,0,0,0,1,1,5
TFRTT,0,0,0,1,1,5
FRTTF,0,0,0,1,1,5
RTTFK,0,0,0,1,1,5
TTFKT,0,0,0,1,1,5
TFKTL,0,0,0,1,1,5
FKTLL,0,0,0,1,1,5
KVAEF,0,0,0,1,1,5
VAEFE,0,0,0,1,1,5
AEFER,0,0,0,1,1,5
EFERL,0,0,0,1,1,5
FERLF,0,0,0,1,1,5
ERLFR,0,0,0,1,1,5
RLFRQ,0,0,0,1,1,5
LFRQA,0,0,0,1,1,5
FRQAA,0,0,0,1,1,5
RQAAG,0,0,0,1,1,5
KVNRA,0,0,0,1,1,5
VNRAV,0,0,0,1,1,5
NRAVA,0,0,0,1,1,5
RAVAA,0,0,0,1,1,5
AVAAE,0,0,0,1,1,5
VAAEI,0,0,0,1,1,5
AAEIR,0,0,0,1,1,5
AEIRN,0,0,0,1,1,5
EIRNW,0,0,0,1,1,5
IRNWT,0,0,0,1,1,5
RNWTW,0,0,0,1,1,5
NWTWV,0,0,0,1,1,5
WTWVF,0,0,0,1,1,5
TWVFL,0,0,0,1,1,5
WVFLI,0,0,0,1,1,5
VFLIW,0,0,0,1,1,5
KVRET,0,0,0,1,1,5
VRETR,0,0,0,1,1,5
RETRE,0,0,0,1,1,5
ETREI,0,0,0,1,1,5
TREIL,0,0,0,1,1,5
REILD,0,0,0,1,1,5
EILDI,0,0,0,1,1,5
ILDII,0,0,0,1,1,5
LDIID,0,0,0,1,1,5
DIIDT,0,0,0,1,1,5
IIDTV,0,0,0,1,1,5
IDTVY,0,0,0,1,1,5
DTVYN,0,0,0,1,1,5
TVYNS,0,0,0,1,1,5
KVRGL,0,0,0,1,1,5
VRGLI,0,0,0,1,1,5
RGLIE,0,0,0,1,1,5
GLIEI,0,0,0,1,1,5
LIEII,0,0,0,1,1,5
IEIIS,0,0,0,1,1,5
EIISN,0,0,0,1,1,5
KVSDI,0,0,0,1,1,5
VSDIL,0,0,0,1,1,5
SDILT,0,0,0,1,1,5
DILTV,0,0,0,1,1,5
ILTVA,0,0,0,1,1,5
LTVAI,0,0,0,1,1,5
TVAIR,0,0,0,1,1,5
VAIRL,0,0,0,1,1,5
AIRLE,0,0,0,1,1,5
IRLEE,0,0,0,1,1,5
RLEEE,0,0,0,1,1,5
LEEEG,0,0,0,1,1,5
EEEGE,0,0,0,1,1,5
EEGER,0,0,0,1,1,5
EGERF,0,0,0,1,1,5
GERFY,0,0,0,1,1,5
ERFYR,0,0,0,1,1,5
RFYRE,0,0,0,1,1,5
FYREL,0,0,0,1,1,5
YRELS,0,0,0,1,1,5
KVVDN,0,0,0,1,1,5
VVDNF,0,0,0,1,1,5
VDNFE,0,0,0,1,1,5
DNFEN,0,0,0,1,1,5
NFENI,0,0,0,1,1,5
FENIL,0,0,0,1,1,5
ENILI,0,0,0,1,1,5
NILII,0,0,0,1,1,5
KVWKG,0,0,0,1,1,5
VWKGV,0,0,0,1,1,5
WKGVK,0,0,0,1,1,5
KGVKT,0,0,0,1,1,5
GVKTI,0,0,0,1,1,5
VKTII,0,0,0,1,1,5
KTIIA,0,0,0,1,1,5
TIIAD,0,0,0,1,1,5
IIADV,0,0,0,1,1,5
IADVW,0,0,0,1,1,5
ADVWQ,0,0,0,1,1,5
DVWQV,0,0,0,1,1,5
KWEAE,0,0,0,1,1,5
WEAEK,0,0,0,1,1,5
EAEKI,0,0,0,1,1,5
AEKIH,0,0,0,1,1,5
EKIHI,0,0,0,1,1,5
KIHIG,0,0,0,1,1,5
IHIGF,0,0,0,1,1,5
HIGFR,0,0,0,1,1,5
IGFRQ,0,0,0,1,1,5
GFRQA,0,0,0,1,1,5
FRQAY,0,0,0,1,1,5
KWVRI,0,0,0,1,1,5
WVRIW,0,0,0,1,1,5
VRIWI,0,0,0,1,1,5
RIWIK,0,0,0,1,1,5
IWIKV,0,0,0,1,1,5
WIKVL,0,0,0,1,1,5
KVLRG,0,0,0,1,1,5
VLRGL,0,0,0,1,1,5
LRGLF,0,0,0,1,1,5
RGLFV,0,0,0,1,1,5
GLFVW,0,0,0,1,1,5
LFVWV,0,0,0,1,1,5
FVWVW,0,0,0,1,1,5
VWVWF,0,0,0,1,1,5
WVWFF,0,0,0,1,1,5
KYDHF,0,0,0,1,1,5
YDHFA,0,0,0,1,1,5
DHFAG,0,0,0,1,1,5
HFAGR,0,0,0,1,1,5
FAGRA,0,0,0,1,1,5
AGRAY,0,0,0,1,1,5
GRAYV,0,0,0,1,1,5
RAYVR,0,0,0,1,1,5
AYVRL,0,0,0,1,1,5
YVRLH,0,0,0,1,1,5
VRLHQ,0,0,0,1,1,5
RLHQD,0,0,0,1,1,5
LADLQ,0,0,0,1,1,5
ADLQE,0,0,0,1,1,5
DLQEQ,0,0,0,1,1,5
LQEQL,0,0,0,1,1,5
QEQLY,0,0,0,1,1,5
EQLYN,0,0,0,1,1,5
QLYNG,0,0,0,1,1,5
LDAYI,0,0,0,1,1,5
DAYIN,0,0,0,1,1,5
AYINL,0,0,0,1,1,5
YINLG,0,0,0,1,1,5
INLGN,0,0,0,1,1,5
NLGNV,0,0,0,1,1,5
LGNVL,0,0,0,1,1,5
GNVLK,0,0,0,1,1,5
NVLKE,0,0,0,1,1,5
VLKEA,0,0,0,1,1,5
LDEAA,0,0,0,1,1,5
DEAAT,0,0,0,1,1,5
EAATR,0,0,0,1,1,5
AATRS,0,0,0,1,1,5
ATRSK,0,0,0,1,1,5
TRSKA,0,0,0,1,1,5
RSKAW,0,0,0,1,1,5
SKAWM,0,0,0,1,1,5
KAWMV,0,0,0,1,1,5
AWMVD,0,0,0,1,1,5
WMVDA,0,0,0,1,1,5
MVDAL,0,0,0,1,1,5
VDALA,0,0,0,1,1,5
LEARM,0,0,0,1,1,5
EARMK,0,0,0,1,1,5
ARMKQ,0,0,0,1,1,5
RMKQF,0,0,0,1,1,5
MKQFK,0,0,0,1,1,5
KQFKD,0,0,0,1,1,5
QFKDM,0,0,0,1,1,5
FKDML,0,0,0,1,1,5
KDMLL,0,0,0,1,1,5
DMLLE,0,0,0,1,1,5
MLLER,0,0,0,1,1,5
LEEFD,0,0,0,1,1,5
EEFDK,0,0,0,1,1,5
EFDKV,0,0,0,1,1,5
FDKVS,0,0,0,1,1,5
DKVSK,0,0,0,1,1,5
KVSKN,0,0,0,1,1,5
VSKNV,0,0,0,1,1,5
SKNVD,0,0,0,1,1,5
LEPIK,0,0,0,1,1,5
EPIKA,0,0,0,1,1,5
PIKAW,0,0,0,1,1,5
IKAWI,0,0,0,1,1,5
KAWIE,0,0,0,1,1,5
AWIEK,0,0,0,1,1,5
WIEKR,0,0,0,1,1,5
LEQVE,0,0,0,1,1,5
EQVEF,0,0,0,1,1,5
QVEFK,0,0,0,1,1,5
VEFKL,0,0,0,1,1,5
EFKLN,0,0,0,1,1,5
FKLNQ,0,0,0,1,1,5
KLNQL,0,0,0,2,2,5
LNQLL,0,0,0,1,1,5
NQLLE,0,0,0,1,1,5
QLLEN,0,0,0,1,1,5
LLENL,0,0,0,1,1,5
LHDAI,0,0,0,1,1,5
HDAIH,0,0,0,1,1,5
DAIHM,0,0,0,1,1,5
AIHMA,0,0,0,1,1,5
IHMAA,0,0,0,1,1,5
HMAAD,0,0,0,1,1,5
MAADN,0,0,0,1,1,5
AADNA,0,0,0,1,1,5
ADNAV,0,0,0,1,1,5
KRAEA,0,0,0,1,1,5
RAEAL,0,0,0,1,1,5
AEALI,0,0,0,1,1,5
EALIH,0,0,0,1,1,5
ALIHL,0,0,0,1,1,5
LIHLA,0,0,0,1,1,5
IHLAN,0,0,0,1,1,5
HLANA,0,0,0,1,1,5
LANAA,0,0,0,1,1,5
ANAAL,0,0,0,1,1,5
NAALE,0,0,0,1,1,5
LKYVG,0,0,0,1,1,5
KYVGM,0,0,0,1,1,5
YVGMV,0,0,0,1,1,5
VGMVL,0,0,0,1,1,5
GMVLN,0,0,0,1,1,5
MVLNE,0,0,0,1,1,5
VLNEA,0,0,0,1,1,5
LNEAL,0,0,0,1,1,5
NEALR,0,0,0,1,1,5
ALRLW,0,0,0,1,1,5
LLNIR,0,0,0,1,1,5
LNIRR,0,0,0,1,1,5
NIRRE,0,0,0,1,1,5
IRREF,0,0,0,1,1,5
RREFI,0,0,0,1,1,5
REFIE,0,0,0,1,1,5
EFIEK,0,0,0,1,1,5
FIEKY,0,0,0,1,1,5
LLPAL,0,0,0,1,1,5
LPALL,0,0,0,1,1,5
PALLQ,0,0,0,1,1,5
ALLQQ,0,0,0,1,1,5
LLQQI,0,0,0,1,1,5
LQQIG,0,0,0,1,1,5
QQIGR,0,0,0,1,1,5
QIGRE,0,0,0,1,1,5
IGREN,0,0,0,1,1,5
LLTEV,0,0,0,1,1,5
LTEVE,0,0,0,1,1,5
TEVET,0,0,0,1,1,5
EVETY,0,0,0,1,1,5
VETYV,0,0,0,1,1,5
ETYVL,0,0,0,1,1,5
TYVLS,0,0,0,1,1,5
YVLSI,0,0,0,1,1,5
LMEPV,0,0,0,1,1,5
MEPVR,0,0,0,1,1,5
EPVRE,0,0,0,1,1,5
VREAA,0,0,0,1,1,5
REAAG,0,0,0,1,1,5
EAAGR,0,0,0,1,1,5
AAGRL,0,0,0,1,1,5
AGRLA,0,0,0,1,1,5
GRLAD,0,0,0,1,1,5
RLADA,0,0,0,1,1,5
LMGHQ,0,0,0,1,1,5
MGHQK,0,0,0,1,1,5
GHQKK,0,0,0,1,1,5
HQKKI,0,0,0,1,1,5
QKKIL,0,0,0,1,1,5
KKILG,0,0,0,1,1,5
KILGS,0,0,0,1,1,5
ILGSI,0,0,0,1,1,5
LGSIQ,0,0,0,1,1,5
GSIQT,0,0,0,1,1,5
SIQTM,0,0,0,1,1,5
IQTMR,0,0,0,1,1,5
QTMRA,0,0,0,1,1,5
TMRAQ,0,0,0,1,1,5
MRAQL,0,0,0,1,1,5
RAQLT,0,0,0,1,1,5
LNNFS,0,0,0,1,1,5
NNFSR,0,0,0,1,1,5
NFSRY,0,0,0,1,1,5
FSRYF,0,0,0,1,1,5
SRYFL,0,0,0,1,1,5
RYFLH,0,0,0,1,1,5
YFLHQ,0,0,0,1,1,5
FLHQS,0,0,0,1,1,5
LHQSR,0,0,0,1,1,5
HQSRE,0,0,0,1,1,5
QSREE,0,0,0,1,1,5
SREET,0,0,0,1,1,5
REETE,0,0,0,1,1,5
EETEH,0,0,0,1,1,5
ETEHA,0,0,0,1,1,5
TEHAE,0,0,0,1,1,5
EHAEK,0,0,0,1,1,5
HAEKL,0,0,0,1,1,5
AEKLM,0,0,0,1,1,5
EKLMR,0,0,0,1,1,5
KLMRL,0,0,0,1,1,5
LMRLQ,0,0,0,1,1,5
MRLQN,0,0,0,1,1,5
RLQNQ,0,0,0,1,1,5
LQNQR,0,0,0,1,1,5
QNQRG,0,0,0,1,1,5
LPEDQ,0,0,0,1,1,5
PEDQE,0,0,0,1,1,5
EDQEL,0,0,0,1,1,5
DQELL,0,0,0,1,1,5
QELLF,0,0,0,1,1,5
ELLFQ,0,0,0,1,1,5
LLFQS,0,0,0,1,1,5
LFQSA,0,0,0,1,1,5
FQSAS,0,0,0,1,1,5
QSASL,0,0,0,1,1,5
SASLE,0,0,0,1,1,5
ASLEL,0,0,0,1,1,5
SLELF,0,0,0,1,1,5
LELFV,0,0,0,1,1,5
ELFVL,0,0,0,1,1,5
LFVLR,0,0,0,1,1,5
FVLRL,0,0,0,1,1,5
LRLAY,0,0,0,1,1,5
RLAYR,0,0,0,1,1,5
LAYRA,0,0,0,1,1,5
LPHFY,0,0,0,1,1,5
PHFYE,0,0,0,1,1,5
HFYEL,0,0,0,1,1,5
FYELF,0,0,0,1,1,5
YELFS,0,0,0,1,1,5
ELFSL,0,0,0,1,1,5
LFSLW,0,0,0,1,1,5
FSLWA,0,0,0,1,1,5
LPIHY,0,0,0,1,1,5
PIHYK,0,0,0,1,1,5
IHYKL,0,0,0,1,1,5
HYKLS,0,0,0,1,1,5
YKLSQ,0,0,0,1,1,5
KLSQE,0,0,0,1,1,5
LSQEF,0,0,0,1,1,5
SQEFF,0,0,0,1,1,5
QEFFL,0,0,0,1,1,5
EFFLK,0,0,0,1,1,5
FFLKA,0,0,0,1,1,5
FLKAY,0,0,0,1,1,5
LKAYE,0,0,0,1,1,5
KAYEN,0,0,0,1,1,5
LQAPL,0,0,0,1,1,5
QAPLQ,0,0,0,1,1,5
APLQR,0,0,0,1,1,5
PLQRR,0,0,0,1,1,5
LQRRI,0,0,0,1,1,5
QRRIL,0,0,0,1,1,5
RRILE,0,0,0,1,1,5
RILEI,0,0,0,1,1,5
ILEIG,0,0,0,1,1,5
LEIGK,0,0,0,1,1,5
EIGKK,0,0,0,1,1,5
IGKKH,0,0,0,1,1,5
LQMEF,0,0,0,1,1,5
QMEFK,0,0,0,1,1,5
MEFKY,0,0,0,1,1,5
EFKYL,0,0,0,1,1,5
FKYLA,0,0,0,1,1,5
KYLAY,0,0,0,1,1,5
YLAYL,0,0,0,1,1,5
LAYLT,0,0,0,1,1,5
AYLTG,0,0,0,2,2,5
LQNAI,0,0,0,1,1,5
QNAII,0,0,0,1,1,5
NAIIE,0,0,0,1,1,5
AIIEF,0,0,0,1,1,5
IIEFY,0,0,0,1,1,5
IEFYT,0,0,0,1,1,5
EFYTE,0,0,0,1,1,5
FYTEY,0,0,0,1,1,5
YTEYY,0,0,0,1,1,5
LQWYV,0,0,0,1,1,5
QWYVS,0,0,0,1,1,5
WYVSE,0,0,0,1,1,5
YVSEQ,0,0,0,1,1,5
VSEQH,0,0,0,1,1,5
SEQHE,0,0,0,1,1,5
EQHEE,0,0,0,1,1,5
QHEEE,0,0,0,1,1,5
HEEEA,0,0,0,1,1,5
EEEAL,0,0,0,1,1,5
EEALF,0,0,0,1,1,5
EALFR,0,0,0,1,1,5
ALFRG,0,0,0,1,1,5
LFRGI,0,0,0,1,1,5
FRGIV,0,0,0,1,1,5
RGIVD,0,0,0,1,1,5
GIVDK,0,0,0,1,1,5
IVDKI,0,0,0,1,1,5
VDKIK,0,0,0,1,1,5
DKIKL,0,0,0,1,1,5
KIKLI,0,0,0,1,1,5
IKLIG,0,0,0,1,1,5
LREIV,0,0,0,1,1,5
REIVE,0,0,0,1,1,5
EIVEN,0,0,0,1,1,5
IVENM,0,0,0,1,1,5
VENMI,0,0,0,1,1,5
ENMIK,0,0,0,1,1,5
NMIKS,0,0,0,1,1,5
MIKSS,0,0,0,1,1,5
IKSSL,0,0,0,1,1,5
KSSLE,0,0,0,1,1,5
SSLER,0,0,0,1,1,5
SLERA,0,0,0,1,1,5
ERAIA,0,0,0,1,1,5
RAIAA,0,0,0,1,1,5
AIAAY,0,0,0,1,1,5
LRSWF,0,0,0,1,1,5
RSWFR,0,0,0,1,1,5
SWFRE,0,0,0,1,1,5
WFRER,0,0,0,1,1,5
RERLI,0,0,0,1,1,5
RLIAH,0,0,0,1,1,5
LIAHR,0,0,0,1,1,5
IAHRL,0,0,0,1,1,5
AHRLA,0,0,0,1,1,5
HRLAS,0,0,0,1,1,5
RLASV,0,0,0,1,1,5
LASVN,0,0,0,1,1,5
ASVNL,0,0,0,1,1,5
LRTYF,0,0,0,1,1,5
RTYFM,0,0,0,1,1,5
TYFME,0,0,0,1,1,5
YFMER,0,0,0,1,1,5
FMERL,0,0,0,1,1,5
MERLR,0,0,0,1,1,5
ERLRH,0,0,0,1,1,5
RLRHY,0,0,0,1,1,5
LRHYR,0,0,0,1,1,5
RHYRQ,0,0,0,1,1,5
HYRQL,0,0,0,1,1,5
YRQLS,0,0,0,1,1,5
RQLSL,0,0,0,1,1,5
LSTVS,0,0,0,1,1,5
STVSN,0,0,0,1,1,5
TVSNF,0,0,0,1,1,5
VSNFF,0,0,0,1,1,5
SNFFM,0,0,0,1,1,5
NFFMN,0,0,0,1,1,5
FFMNA,0,0,0,1,1,5
LVGAL,0,0,0,1,1,5
VGALM,0,0,0,1,1,5
GALMH,0,0,0,1,1,5
ALMHV,0,0,0,1,1,5
LMHVM,0,0,0,1,1,5
MHVMQ,0,0,0,1,1,5
HVMQK,0,0,0,1,1,5
VMQKR,0,0,0,1,1,5
MQKRS,0,0,0,1,1,5
QKRSR,0,0,0,1,1,5
LVLPI,0,0,0,1,1,5
VLPIA,0,0,0,1,1,5
LPIAQ,0,0,0,1,1,5
PIAQA,0,0,0,1,1,5
IAQAL,0,0,0,1,1,5
AQALK,0,0,0,1,1,5
QALKV,0,0,0,1,1,5
ALKVL,0,0,0,1,1,5
MEALK,0,0,0,1,1,5
EALKK,0,0,0,1,1,5
ALKKQ,0,0,0,1,1,5
LKKQI,0,0,0,1,1,5
KKQIL,0,0,0,1,1,5
KQILQ,0,0,0,1,1,5
QILQI,0,0,0,1,1,5
MEKLN,0,0,0,1,1,5
EKLNQ,0,0,0,1,1,5
LNQLW,0,0,0,1,1,5
NQLWE,0,0,0,1,1,5
QLWEK,0,0,0,1,1,5
LWEKA,0,0,0,1,1,5
WEKAQ,0,0,0,1,1,5
EKAQR,0,0,0,1,1,5
KAQRL,0,0,0,1,1,5
AQRLH,0,0,0,1,1,5
MLEEY,0,0,0,1,1,5
LEEYR,0,0,0,1,1,5
EEYRK,0,0,0,1,1,5
EYRKH,0,0,0,1,1,5
YRKHV,0,0,0,1,1,5
KHVAE,0,0,0,1,1,5
VAERA,0,0,0,1,1,5
AERAA,0,0,0,1,1,5
ERAAE,0,0,0,1,1,5
MPEVF,0,0,0,1,1,5
PEVFN,0,0,0,1,1,5
EVFNY,0,0,0,1,1,5
VFNYL,0,0,0,1,1,5
FNYLG,0,0,0,1,1,5
NYLGI,0,0,0,1,1,5
YLGIY,0,0,0,1,1,5
LGIYL,0,0,0,1,1,5
GIYLT,0,0,0,1,1,5
IYLTQ,0,0,0,1,1,5
YLTQA,0,0,0,1,1,5
MPGTA,0,0,0,1,1,5
PGTAT,0,0,0,1,1,5
GTATH,0,0,0,1,1,5
TATHT,0,0,0,1,1,5
ATHTV,0,0,0,1,1,5
THTVK,0,0,0,1,1,5
HTVKM,0,0,0,1,1,5
TVKMF,0,0,0,1,1,5
VKMFS,0,0,0,1,1,5
MPYTD,0,0,0,1,1,5
PYTDA,0,0,0,1,1,5
YTDAV,0,0,0,1,1,5
TDAVV,0,0,0,1,1,5
DAVVH,0,0,0,1,1,5
AVVHE,0,0,0,1,1,5
VVHEV,0,0,0,1,1,5
VHEVQ,0,0,0,1,1,5
HEVQR,0,0,0,1,1,5
EVQRY,0,0,0,1,1,5
VQRYI,0,0,0,1,1,5
QRYID,0,0,0,1,1,5
MTDQQ,0,0,0,1,1,5
TDQQA,0,0,0,1,1,5
DQQAE,0,0,0,1,1,5
QQAEA,0,0,0,1,1,5
QAEAR,0,0,0,1,1,5
AEARA,0,0,0,1,1,5
EARAF,0,0,0,1,1,5
MVFKQ,0,0,0,1,1,5
VFKQM,0,0,0,1,1,5
FKQME,0,0,0,1,1,5
KQMEQ,0,0,0,1,1,5
QMEQV,0,0,0,1,1,5
MEQVA,0,0,0,1,1,5
EQVAQ,0,0,0,1,1,5
QVAQF,0,0,0,1,1,5
VAQFL,0,0,0,1,1,5
AQFLK,0,0,0,1,1,5
QFLKA,0,0,0,1,1,5
FLKAA,0,0,0,1,1,5
LKAAE,0,0,0,1,1,5
KAAED,0,0,0,1,1,5
AAEDY,0,0,0,1,1,5
MYSNR,0,0,0,1,1,5
YSNRM,0,0,0,1,1,5
SNRMR,0,0,0,1,1,5
NRMRS,0,0,0,1,1,5
RMRSY,0,0,0,1,1,5
MRSYK,0,0,0,1,1,5
RSYKQ,0,0,0,1,1,5
SYKQE,0,0,0,1,1,5
YKQEM,0,0,0,1,1,5
KQEMG,0,0,0,1,1,5
QEMGK,0,0,0,1,1,5
EMGKL,0,0,0,1,1,5
MGKLE,0,0,0,1,1,5
GKLET,0,0,0,1,1,5
KLETD,0,0,0,1,1,5
LETDF,0,0,0,1,1,5
ETDFK,0,0,0,1,1,5
TDFKR,0,0,0,1,1,5
DFKRS,0,0,0,1,1,5
FKRSR,0,0,0,1,1,5
KRSRI,0,0,0,1,1,5
NAAGW,0,0,0,1,1,5
AAGWD,0,0,0,1,1,5
AGWDL,0,0,0,1,1,5
GWDLL,0,0,0,1,1,5
WDLLL,0,0,0,1,1,5
DLLLT,0,0,0,1,1,5
LLLTL,0,0,0,1,1,5
LLTLY,0,0,0,1,1,5
LTLYR,0,0,0,1,1,5
TLYRS,0,0,0,1,1,5
LYRSA,0,0,0,1,1,5
NAAQL,0,0,0,1,1,5
AAQLD,0,0,0,1,1,5
AQLDA,0,0,0,1,1,5
QLDAL,0,0,0,1,1,5
LDALA,0,0,0,1,1,5
DALAH,0,0,0,1,1,5
ALAHA,0,0,0,1,1,5
LAHAL,0,0,0,1,1,5
AHALL,0,0,0,1,1,5
HALLE,0,0,0,1,1,5
ALLEI,0,0,0,1,1,5
LLEIP,0,0,0,1,1,5
LEIPR,0,0,0,1,1,5
EIPRF,0,0,0,1,1,5
IPRFS,0,0,0,1,1,5
PRFSY,0,0,0,1,1,5
RFSYA,0,0,0,1,1,5
FSYAT,0,0,0,1,1,5
SYATR,0,0,0,1,1,5
NAGQA,0,0,0,1,1,5
AGQAN,0,0,0,1,1,5
GQANE,0,0,0,1,1,5
QANEF,0,0,0,1,1,5
NEFFN,0,0,0,1,1,5
EFFNE,0,0,0,1,1,5
FFNEF,0,0,0,1,1,5
FNEFW,0,0,0,1,1,5
NEFWS,0,0,0,1,1,5
NAKIA,0,0,0,1,1,5
AKIAR,0,0,0,1,1,5
KIARI,0,0,0,1,1,5
IARIN,0,0,0,1,1,5
ARINE,0,0,0,1,1,5
RINEL,0,0,0,1,1,5
INELA,0,0,0,1,1,5
NELAA,0,0,0,1,1,5
ELAAK,0,0,0,1,1,5
AAKAK,0,0,0,1,1,5
AKAKA,0,0,0,1,1,5
KAKAG,0,0,0,1,1,5
AKAGV,0,0,0,1,1,5
NAKYV,0,0,0,1,1,5
AKYVA,0,0,0,1,1,5
KYVAE,0,0,0,1,1,5
YVAEA,0,0,0,1,1,5
VAEAT,0,0,0,1,1,5
AEATG,0,0,0,1,1,5
EATGN,0,0,0,1,1,5
ATGNF,0,0,0,1,1,5
TGNFI,0,0,0,1,1,5
GNFIT,0,0,0,1,1,5
NFITV,0,0,0,1,1,5
FITVM,0,0,0,1,1,5
ITVMD,0,0,0,1,1,5
TVMDA,0,0,0,1,1,5
VMDAL,0,0,0,1,1,5
MDALK,0,0,0,1,1,5
DALKL,0,0,0,1,1,5
NASRT,0,0,0,1,1,5
ASRTV,0,0,0,1,1,5
SRTVG,0,0,0,1,1,5
RTVGV,0,0,0,1,1,5
TVGVV,0,0,0,1,1,5
VGVVA,0,0,0,1,1,5
GVVAA,0,0,0,1,1,5
VVAAL,0,0,0,1,1,5
VAALL,0,0,0,1,1,5
NDAEV,0,0,0,1,1,5
DAEVK,0,0,0,1,1,5
AEVKK,0,0,0,2,2,5
EVKKI,0,0,0,1,1,5
KKIAA,0,0,0,1,1,5
KIAAQ,0,0,0,1,1,5
IAAQY,0,0,0,1,1,5
AAQYG,0,0,0,1,1,5
AQYGK,0,0,0,1,1,5
QYGKD,0,0,0,1,1,5
NDEET,0,0,0,1,1,5
DEETV,0,0,0,1,1,5
EETVA,0,0,0,1,1,5
ETVAL,0,0,0,1,1,5
TVALT,0,0,0,1,1,5
VALTA,0,0,0,1,1,5
ALTAG,0,0,0,1,1,5
LTAGG,0,0,0,1,1,5
TAGGH,0,0,0,1,1,5
AGGHT,0,0,0,1,1,5
NEEVR,0,0,0,1,1,5
EEVRI,0,0,0,1,1,5
EVRIE,0,0,0,1,1,5
VRIEA,0,0,0,1,1,5
RIEAI,0,0,0,1,1,5
IEAII,0,0,0,1,1,5
EAIIG,0,0,0,1,1,5
AIIGL,0,0,0,1,1,5
IIGLS,0,0,0,1,1,5
IGLSY,0,0,0,1,1,5
GLSYR,0,0,0,1,1,5
NEQDL,0,0,0,1,1,5
EQDLG,0,0,0,1,1,5
QDLGI,0,0,0,1,1,5
DLGIQ,0,0,0,1,1,5
LGIQY,0,0,0,1,1,5
GIQYK,0,0,0,1,1,5
IQYKA,0,0,0,1,1,5
QYKAL,0,0,0,1,1,5
YKALK,0,0,0,1,1,5
KALKP,0,0,0,1,1,5
ALKPE,0,0,0,1,1,5
LKPEV,0,0,0,1,1,5
KPEVD,0,0,0,1,1,5
PEVDK,0,0,0,1,1,5
EVDKL,0,0,0,1,1,5
VDKLN,0,0,0,1,1,5
DKLNI,0,0,0,1,1,5
KLNIM,0,0,0,1,1,5
LNIMA,0,0,0,1,1,5
NIMAA,0,0,0,1,1,5
IMAAK,0,0,0,1,1,5
MAAKR,0,0,0,1,1,5
AAKRQ,0,0,0,1,1,5
AKRQQ,0,0,0,1,1,5
KRQQE,0,0,0,1,1,5
RQQEL,0,0,0,1,1,5
NEYIM,0,0,0,1,1,5
EYIMS,0,0,0,1,1,5
YIMSL,0,0,0,1,1,5
IMSLI,0,0,0,1,1,5
MSLIS,0,0,0,1,1,5
SLISD,0,0,0,1,1,5
LISDN,0,0,0,1,1,5
NFKDV,0,0,0,1,1,5
FKDVI,0,0,0,1,1,5
KDVIE,0,0,0,1,1,5
DVIET,0,0,0,1,1,5
VIETA,0,0,0,1,1,5
IETAK,0,0,0,1,1,5
ETAKK,0,0,0,1,1,5
TAKKV,0,0,0,1,1,5
AKKVM,0,0,0,1,1,5
KKVMN,0,0,0,1,1,5
KVMNF,0,0,0,1,1,5
NGETF,0,0,0,1,1,5
GETFL,0,0,0,1,1,5
ETFLT,0,0,0,1,1,5
TFLTE,0,0,0,1,1,5
FLTEL,0,0,0,1,1,5
LTELL,0,0,0,1,1,5
TELLD,0,0,0,1,1,5
NGLEV,0,0,0,1,1,5
GLEVV,0,0,0,1,1,5
LEVVK,0,0,0,1,1,5
EVVKA,0,0,0,1,1,5
VVKAL,0,0,0,1,1,5
VKALA,0,0,0,1,1,5
KALAQ,0,0,0,1,1,5
ALAQG,0,0,0,1,1,5
NIDEI,0,0,0,1,1,5
IDEIE,0,0,0,1,1,5
DEIER,0,0,0,1,1,5
EIERK,0,0,0,1,1,5
IERKI,0,0,0,1,1,5
ERKID,0,0,0,1,1,5
RKIDE,0,0,0,1,1,5
KIDEA,0,0,0,1,1,5
IDEAI,0,0,0,1,1,5
DEAIE,0,0,0,1,1,5
EAIEK,0,0,0,1,1,5
NIDSY,0,0,0,1,1,5
IDSYL,0,0,0,1,1,5
DSYLN,0,0,0,1,1,5
SYLNA,0,0,0,1,1,5
YLNAV,0,0,0,1,1,5
LNAVN,0,0,0,1,1,5
NAVNI,0,0,0,1,1,5
AVNII,0,0,0,1,1,5
VNIIN,0,0,0,1,1,5
NIINI,0,0,0,1,1,5
IINIF,0,0,0,1,1,5
INIFK,0,0,0,1,1,5
NIFKI,0,0,0,1,1,5
IFKII,0,0,0,1,1,5
FKIIG,0,0,0,1,1,5
NIEQL,0,0,0,1,1,5
IEQLW,0,0,0,1,1,5
EQLWR,0,0,0,1,1,5
QLWRD,0,0,0,1,1,5
LWRDY,0,0,0,1,1,5
WRDYN,0,0,0,1,1,5
RDYNK,0,0,0,1,1,5
DYNKY,0,0,0,1,1,5
YNKYE,0,0,0,1,1,5
NKYEE,0,0,0,1,1,5
KYEEG,0,0,0,1,1,5
YEEGI,0,0,0,1,1,5
EEGIN,0,0,0,1,1,5
NILKQ,0,0,0,1,1,5
ILKQI,0,0,0,1,1,5
LKQIF,0,0,0,1,1,5
KQIFK,0,0,0,1,1,5
QIFKL,0,0,0,1,1,5
IFKLL,0,0,0,1,1,5
FKLLQ,0,0,0,1,1,5
KLLQA,0,0,0,1,1,5
NINEL,0,0,0,1,1,5
INELF,0,0,0,1,1,5
NELFI,0,0,0,1,1,5
ELFIE,0,0,0,1,1,5
LFIEI,0,0,0,1,1,5
FIEIS,0,0,0,1,1,5
IEISR,0,0,0,1,1,5
EISRR,0,0,0,1,1,5
ISRRI,0,0,0,1,1,5
NIPKH,0,0,0,1,1,5
IPKHT,0,0,0,1,1,5
PKHTH,0,0,0,1,1,5
KHTHR,0,0,0,1,1,5
HTHRF,0,0,0,1,1,5
THRFF,0,0,0,1,1,5
HRFFI,0,0,0,1,1,5
RFFIL,0,0,0,1,1,5
FFILV,0,0,0,1,1,5
FILVL,0,0,0,1,1,5
ILVLE,0,0,0,1,1,5
LVLEI,0,0,0,1,1,5
NKDQW,0,0,0,1,1,5
KDQWE,0,0,0,1,1,5
DQWEE,0,0,0,1,1,5
QWEER,0,0,0,1,1,5
WEERI,0,0,0,1,1,5
EERIQ,0,0,0,1,1,5
ERIQV,0,0,0,1,1,5
RIQVW,0,0,0,1,1,5
IQVWH,0,0,0,1,1,5
QVWHE,0,0,0,1,1,5
VWHEE,0,0,0,1,1,5
WHEEH,0,0,0,1,1,5
NKEEM,0,0,0,1,1,5
KEEMM,0,0,0,1,1,5
EEMMD,0,0,0,1,1,5
EMMDI,0,0,0,1,1,5
MMDIV,0,0,0,1,1,5
MDIVK,0,0,0,1,1,5
DIVKA,0,0,0,1,1,5
IVKAI,0,0,0,1,1,5
VKAIY,0,0,0,1,1,5
KAIYD,0,0,0,1,1,5
AIYDM,0,0,0,1,1,5
IYDMM,0,0,0,1,1,5
YDMMG,0,0,0,1,1,5
NKLVD,0,0,0,1,1,5
KLVDR,0,0,0,1,1,5
LVDRW,0,0,0,1,1,5
VDRWL,0,0,0,1,1,5
DRWLH,0,0,0,1,1,5
RWLHV,0,0,0,1,1,5
WLHVR,0,0,0,1,1,5
LHVRK,0,0,0,1,1,5
HVRKH,0,0,0,1,1,5
VRKHL,0,0,0,1,1,5
RKHLL,0,0,0,1,1,5
KHLLV,0,0,0,1,1,5
HLLVA,0,0,0,1,1,5
LLVAY,0,0,0,1,1,5
LVAYY,0,0,0,1,1,5
VAYYN,0,0,0,1,1,5
AYYNL,0,0,0,1,1,5
YYNLV,0,0,0,1,1,5
YNLVG,0,0,0,1,1,5
NKQAD,0,0,0,1,1,5
KQADS,0,0,0,1,1,5
QADSI,0,0,0,1,1,5
ADSIK,0,0,0,1,1,5
DSIKQ,0,0,0,1,1,5
SIKQM,0,0,0,1,1,5
IKQME,0,0,0,1,1,5
KQMEE,0,0,0,1,1,5
QMEER,0,0,0,1,1,5
MEERN,0,0,0,1,1,5
EERNK,0,0,0,1,1,5
ERNKK,0,0,0,1,1,5
RNKKR,0,0,0,1,1,5
NKKRV,0,0,0,1,1,5
KKRVE,0,0,0,1,1,5
KRVEN,0,0,0,1,1,5
RVENF,0,0,0,1,1,5
VENFK,0,0,0,1,1,5
ENFKK,0,0,0,1,1,5
NFKKT,0,0,0,1,1,5
FKKTG,0,0,0,1,1,5
NKRAV,0,0,0,1,1,5
KRAVD,0,0,0,1,1,5
RAVDW,0,0,0,1,1,5
AVDWA,0,0,0,1,1,5
VDWAM,0,0,0,1,1,5
DWAMR,0,0,0,1,1,5
WAMRA,0,0,0,1,1,5
AMRAA,0,0,0,1,1,5
MRAAM,0,0,0,1,1,5
RAAMA,0,0,0,1,1,5
AAMAL,0,0,0,1,1,5
NKSVG,0,0,0,1,1,5
KSVGA,0,0,0,1,1,5
SVGAV,0,0,0,1,1,5
VGAVY,0,0,0,1,1,5
GAVYA,0,0,0,1,1,5
AVYAI,0,0,0,1,1,5
VYAIL,0,0,0,1,1,5
YAILY,0,0,0,1,1,5
AILYL,0,0,0,1,1,5
ILYLS,0,0,0,1,1,5
NLDSI,0,0,0,1,1,5
LDSIQ,0,0,0,1,1,5
DSIQE,0,0,0,1,1,5
SIQEE,0,0,0,1,1,5
IQEEL,0,0,0,2,2,5
QEELA,0,0,0,1,1,5
EELAD,0,0,0,1,1,5
ELADV,0,0,0,1,1,5
LADVI,0,0,0,1,1,5
ADVIA,0,0,0,1,1,5
DVIAW,0,0,0,1,1,5
VIAWT,0,0,0,1,1,5
IAWTV,0,0,0,1,1,5
AWTVS,0,0,0,1,1,5
WTVSI,0,0,0,1,1,5
TVSIA,0,0,0,1,1,5
VSIAN,0,0,0,1,1,5
SIANL,0,0,0,1,1,5
IANLE,0,0,0,1,1,5
ANLEG,0,0,0,1,1,5
NLEQT,0,0,0,1,1,5
LEQTA,0,0,0,1,1,5
EQTAR,0,0,0,1,1,5
QTARR,0,0,0,1,1,5
TARRW,0,0,0,1,1,5
ARRWL,0,0,0,1,1,5
RRWLE,0,0,0,1,1,5
RWLEE,0,0,0,1,1,5
WLEER,0,0,0,1,1,5
LEERG,0,0,0,2,2,5
NLESE,0,0,0,1,1,5
LESEI,0,0,0,1,1,5
ESEIH,0,0,0,1,1,5
SEIHT,0,0,0,1,1,5
EIHTV,0,0,0,1,1,5
IHTVL,0,0,0,1,1,5
HTVLK,0,0,0,1,1,5
TVLKH,0,0,0,1,1,5
VLKHL,0,0,0,1,1,5
LKHLV,0,0,0,1,1,5
KHLVE,0,0,0,1,1,5
HLVEN,0,0,0,1,1,5
LVENN,0,0,0,1,1,5
NLFDH,0,0,0,1,1,5
LFDHF,0,0,0,1,1,5
FDHFS,0,0,0,1,1,5
DHFSA,0,0,0,1,1,5
HFSAV,0,0,0,1,1,5
FSAVA,0,0,0,1,1,5
SAVAQ,0,0,0,1,1,5
AVAQR,0,0,0,1,1,5
VAQRL,0,0,0,1,1,5
NLFPI,0,0,0,1,1,5
LFPIV,0,0,0,1,1,5
FPIVF,0,0,0,1,1,5
PIVFG,0,0,0,1,1,5
IVFGV,0,0,0,1,1,5
VFGVI,0,0,0,1,1,5
FGVIF,0,0,0,1,1,5
GVIFD,0,0,0,1,1,5
VIFDA,0,0,0,1,1,5
NLLYD,0,0,0,1,1,5
LLYDI,0,0,0,1,1,5
LYDIV,0,0,0,1,1,5
YDIVK,0,0,0,1,1,5
DIVKE,0,0,0,1,1,5
IVKEN,0,0,0,1,1,5
VKENG,0,0,0,1,1,5
NLNQS,0,0,0,1,1,5
LNQSI,0,0,0,1,1,5
NQSID,0,0,0,1,1,5
QSIDN,0,0,0,1,1,5
SIDNF,0,0,0,1,1,5
IDNFV,0,0,0,1,1,5
DNFVN,0,0,0,1,1,5
NFVNM,0,0,0,1,1,5
FVNMA,0,0,0,1,1,5
VNMAF,0,0,0,1,1,5
NMAFF,0,0,0,1,1,5
MAFFA,0,0,0,1,1,5
NLSTL,0,0,0,1,1,5
LSTLA,0,0,0,1,1,5
STLAA,0,0,0,1,1,5
TLAAL,0,0,0,1,1,5
LAALV,0,0,0,1,1,5
AALVA,0,0,0,1,1,5
ALVAA,0,0,0,1,1,5
LVAAA,0,0,0,1,1,5
VAAAG,0,0,0,1,1,5
NLTQL,0,0,0,1,1,5
LTQLK,0,0,0,1,1,5
TQLKA,0,0,0,1,1,5
QLKAS,0,0,0,1,1,5
LKASF,0,0,0,1,1,5
KASFA,0,0,0,1,1,5
ASFAV,0,0,0,1,1,5
SFAVQ,0,0,0,1,1,5
NLVAD,0,0,0,1,1,5
LVADM,0,0,0,1,1,5
VADMR,0,0,0,1,1,5
ADMRF,0,0,0,1,1,5
DMRFN,0,0,0,1,1,5
MRFNV,0,0,0,1,1,5
RFNVV,0,0,0,1,1,5
FNVVR,0,0,0,1,1,5
NVVRE,0,0,0,1,1,5
VVRES,0,0,0,1,1,5
VRESE,0,0,0,1,1,5
RESEA,0,0,0,1,1,5
ESEAR,0,0,0,1,1,5
SEARL,0,0,0,1,1,5
EARLQ,0,0,0,1,1,5
ARLQV,0,0,0,1,1,5
RLQVS,0,0,0,1,1,5
LQVSR,0,0,0,1,1,5
QVSRL,0,0,0,1,1,5
VSRLY,0,0,0,1,1,5
SRLYS,0,0,0,1,1,5
NNAIT,0,0,0,1,1,5
NAITK,0,0,0,1,1,5
AITKG,0,0,0,1,1,5
ITKGF,0,0,0,1,1,5
TKGFT,0,0,0,1,1,5
KGFTA,0,0,0,1,1,5
GFTAL,0,0,0,1,1,5
FTALE,0,0,0,1,1,5
TALEK,0,0,0,1,1,5
ALEKL,0,0,0,1,1,5
LEKLL,0,0,0,1,1,5
EKLLV,0,0,0,1,1,5
NPAAE,0,0,0,1,1,5
PAAEK,0,0,0,1,1,5
AAEKM,0,0,0,1,1,5
AEKMQ,0,0,0,1,1,5
EKMQV,0,0,0,1,1,5
KMQVL,0,0,0,1,1,5
MQVLQ,0,0,0,1,1,5
QVLQV,0,0,0,1,1,5
VLQVL,0,0,0,1,1,5
LQVLD,0,0,0,1,1,5
QVLDR,0,0,0,1,1,5
VLDRL,0,0,0,1,1,5
LDRLR,0,0,0,1,1,5
DRLRG,0,0,0,1,1,5
RLRGK,0,0,0,1,1,5
LRGKL,0,0,0,1,1,5
RGKLQ,0,0,0,1,1,5
GKLQE,0,0,0,1,1,5
KLQEK,0,0,0,1,1,5
LQEKG,0,0,0,1,1,5
NPAQY,0,0,0,1,1,5
PAQYL,0,0,0,1,1,5
AQYLA,0,0,0,1,1,5
QYLAQ,0,0,0,1,1,5
YLAQH,0,0,0,1,1,5
LAQHE,0,0,0,1,1,5
AQHEQ,0,0,0,1,1,5
QHEQL,0,0,0,1,1,5
HEQLL,0,0,0,1,1,5
NPARA,0,0,0,1,1,5
ARALY,0,0,0,1,1,5
RALYQ,0,0,0,1,1,5
ALYQT,0,0,0,1,1,5
LYQTV,0,0,0,1,1,5
YQTVR,0,0,0,1,1,5
QTVRE,0,0,0,1,1,5
TVREL,0,0,0,1,1,5
VRELI,0,0,0,1,1,5
ELIEN,0,0,0,1,1,5
LIENS,0,0,0,1,1,5
IENSL,0,0,0,1,1,5
ENSLD,0,0,0,1,1,5
NSLDA,0,0,0,1,1,5
NPEIL,0,0,0,1,1,5
PEILL,0,0,0,1,1,5
EILLA,0,0,0,1,1,5
ILLAR,0,0,0,1,1,5
LLARV,0,0,0,1,1,5
LARVK,0,0,0,1,1,5
ARVKR,0,0,0,1,1,5
RVKRF,0,0,0,1,1,5
VKRFL,0,0,0,1,1,5
KRFLE,0,0,0,1,1,5
RFLER,0,0,0,1,1,5
FLERE,0,0,0,2,2,5
NPERV,0,0,0,1,1,5
PERVL,0,0,0,1,1,5
ERVLL,0,0,0,1,1,5
RVLLQ,0,0,0,1,1,5
VLLQL,0,0,0,2,2,5
LLQLK,0,0,0,1,1,5
LQLKY,0,0,0,1,1,5
QLKYR,0,0,0,1,1,5
LKYRY,0,0,0,1,1,5
KYRYD,0,0,0,1,1,5
YRYDV,0,0,0,1,1,5
RYDVE,0,0,0,1,1,5
YDVEI,0,0,0,1,1,5
NPGQA,0,0,0,1,1,5
PGQAI,0,0,0,1,1,5
GQAIW,0,0,0,1,1,5
QAIWL,0,0,0,1,1,5
AIWLG,0,0,0,1,1,5
IWLGE,0,0,0,1,1,5
WLGEF,0,0,0,1,1,5
LGEFS,0,0,0,1,1,5
GEFSK,0,0,0,1,1,5
EFSKR,0,0,0,1,1,5
FSKRH,0,0,0,1,1,5
NPMII,0,0,0,1,1,5
PMIIE,0,0,0,1,1,5
MIIEG,0,0,0,1,1,5
IIEGQ,0,0,0,1,1,5
IEGQI,0,0,0,1,1,5
EGQIH,0,0,0,1,1,5
GQIHG,0,0,0,1,1,5
QIHGG,0,0,0,1,1,5
IHGGL,0,0,0,1,1,5
HGGLT,0,0,0,1,1,5
GGLTE,0,0,0,1,1,5
GLTEG,0,0,0,1,1,5
LTEGY,0,0,0,1,1,5
TEGYA,0,0,0,1,1,5
EGYAV,0,0,0,1,1,5
GYAVA,0,0,0,1,1,5
YAVAM,0,0,0,1,1,5
AVAMG,0,0,0,1,1,5
NPQVL,0,0,0,1,1,5
PQVLA,0,0,0,1,1,5
QVLAD,0,0,0,1,1,5
VLADI,0,0,0,1,1,5
LADIG,0,0,0,1,1,5
ADIGA,0,0,0,1,1,5
DIGAE,0,0,0,1,1,5
IGAEA,0,0,0,1,1,5
GAEAT,0,0,0,1,1,5
NPRWI,0,0,0,1,1,5
PRWIG,0,0,0,1,1,5
RWIGR,0,0,0,1,1,5
WIGRH,0,0,0,1,1,5
IGRHK,0,0,0,1,1,5
GRHKH,0,0,0,1,1,5
RHKHM,0,0,0,1,1,5
HKHMF,0,0,0,1,1,5
KHMFN,0,0,0,1,1,5
HMFNF,0,0,0,1,1,5
MFNFL,0,0,0,1,1,5
FNFLD,0,0,0,1,1,5
NPVLQ,0,0,0,1,1,5
PVLQQ,0,0,0,1,1,5
VLQQH,0,0,0,1,1,5
LQQHF,0,0,0,1,1,5
QQHFR,0,0,0,1,1,5
QHFRN,0,0,0,1,1,5
HFRNL,0,0,0,1,1,5
FRNLE,0,0,0,1,1,5
RNLEA,0,0,0,1,1,5
NLEAL,0,0,0,1,1,5
LEALA,0,0,0,1,1,5
EALAL,0,0,0,1,1,5
NQDEL,0,0,0,1,1,5
QDELE,0,0,0,1,1,5
DELEG,0,0,0,1,1,5
ELEGY,0,0,0,1,1,5
LEGYN,0,0,0,1,1,5
EGYNL,0,0,0,1,1,5
GYNLF,0,0,0,1,1,5
YNLFK,0,0,0,1,1,5
NLFKG,0,0,0,1,1,5
LFKGS,0,0,0,1,1,5
FKGSG,0,0,0,1,1,5
NQPFA,0,0,0,1,1,5
QPFAL,0,0,0,1,1,5
PFALE,0,0,0,1,1,5
FALEM,0,0,0,1,1,5
ALEMI,0,0,0,1,1,5
LEMIK,0,0,0,1,1,5
EMIKS,0,0,0,1,1,5
MIKSR,0,0,0,1,1,5
IKSRQ,0,0,0,1,1,5
KSRQK,0,0,0,1,1,5
SRQKK,0,0,0,1,1,5
RQKKD,0,0,0,1,1,5
NQRAL,0,0,0,1,1,5
QRALL,0,0,0,1,1,5
RALLK,0,0,0,1,1,5
ALLKS,0,0,0,1,1,5
LLKSL,0,0,0,1,1,5
LKSLQ,0,0,0,1,1,5
KSLQD,0,0,0,1,1,5
SLQDY,0,0,0,1,1,5
LQDYR,0,0,0,1,1,5
QDYRQ,0,0,0,1,1,5
DYRQH,0,0,0,1,1,5
YRQHL,0,0,0,1,1,5
RQHLD,0,0,0,1,1,5
QHLDQ,0,0,0,1,1,5
HLDQL,0,0,0,1,1,5
LDQLI,0,0,0,1,1,5
DQLIT,0,0,0,1,1,5
QLITL,0,0,0,1,1,5
LITLI,0,0,0,1,1,5
ITLIS,0,0,0,1,1,5
TLISN,0,0,0,1,1,5
NREAN,0,0,0,1,1,5
REANL,0,0,0,1,1,5
EANLQ,0,0,0,1,1,5
ANLQA,0,0,0,1,1,5
NLQAL,0,0,0,1,1,5
LQALI,0,0,0,1,1,5
QALIA,0,0,0,1,1,5
ALIAT,0,0,0,1,1,5
LIATG,0,0,0,1,1,5
NRKMA,0,0,0,1,1,5
RKMAM,0,0,0,1,1,5
KMAMG,0,0,0,1,1,5
MAMGR,0,0,0,1,1,5
AMGRK,0,0,0,1,1,5
MGRKK,0,0,0,1,1,5
GRKKF,0,0,0,1,1,5
RKKFN,0,0,0,1,1,5
KKFNM,0,0,0,1,1,5
KFNMD,0,0,0,1,1,5
NSDQD,0,0,0,1,1,5
SDQDA,0,0,0,1,1,5
DQDAG,0,0,0,1,1,5
QDAGI,0,0,0,1,1,5
DAGIA,0,0,0,1,1,5
AGIAI,0,0,0,1,1,5
GIAII,0,0,0,1,1,5
IAIIR,0,0,0,1,1,5
AIIRR,0,0,0,1,1,5
IIRRA,0,0,0,1,1,5
IRRAL,0,0,0,1,1,5
NSNHQ,0,0,0,1,1,5
SNHQM,0,0,0,1,1,5
NHQML,0,0,0,1,1,5
HQMLL,0,0,0,1,1,5
QMLLV,0,0,0,1,1,5
MLLVQ,0,0,0,1,1,5
LLVQQ,0,0,0,1,1,5
LVQQA,0,0,0,1,1,5
VQQAE,0,0,0,1,1,5
QQAED,0,0,0,1,1,5
QAEDK,0,0,0,1,1,5
AEDKI,0,0,0,1,1,5
EDKIK,0,0,0,1,1,5
DKIKE,0,0,0,1,1,5
KIKEL,0,0,0,2,2,5
IKELL,0,0,0,1,1,5
KELLN,0,0,0,1,1,5
ELLNT,0,0,0,1,1,5
NSNTF,0,0,0,1,1,5
SNTFL,0,0,0,1,1,5
NTFLT,0,0,0,1,1,5
TFLTR,0,0,0,1,1,5
FLTRL,0,0,0,1,1,5
LTRLL,0,0,0,1,1,5
TRLLV,0,0,0,1,1,5
RLLVH,0,0,0,1,1,5
LLVHM,0,0,0,1,1,5
NSRER,0,0,0,1,1,5
SRERE,0,0,0,1,1,5
REREM,0,0,0,1,1,5
EREMF,0,0,0,1,1,5
REMFV,0,0,0,1,1,5
EMFVQ,0,0,0,1,1,5
MFVQE,0,0,0,1,1,5
FVQEV,0,0,0,1,1,5
VQEVR,0,0,0,1,1,5
QEVRR,0,0,0,1,1,5
EVRRY,0,0,0,1,1,5
VRRYY,0,0,0,1,1,5
NSSDS,0,0,0,1,1,5
SSDSI,0,0,0,1,1,5
SDSID,0,0,0,1,1,5
DSIDW,0,0,0,1,1,5
SIDWL,0,0,0,1,1,5
IDWLT,0,0,0,1,1,5
DWLTS,0,0,0,1,1,5
WLTSM,0,0,0,1,1,5
NSVLR,0,0,0,1,1,5
SVLRA,0,0,0,1,1,5
VLRAV,0,0,0,1,1,5
LRAVA,0,0,0,1,1,5
RAVAE,0,0,0,1,1,5
AVAEV,0,0,0,1,1,5
VAEVY,0,0,0,1,1,5
AEVYA,0,0,0,1,1,5
NTDTL,0,0,0,1,1,5
TDTLE,0,0,0,1,1,5
DTLER,0,0,0,1,1,5
TLERV,0,0,0,1,1,5
LERVT,0,0,0,1,1,5
ERVTE,0,0,0,1,1,5
RVTEI,0,0,0,1,1,5
VTEIF,0,0,0,1,1,5
TEIFK,0,0,0,1,1,5
EIFKA,0,0,0,1,1,5
IFKAL,0,0,0,1,1,5
FKALG,0,0,0,1,1,5
NTEKL,0,0,0,1,1,5
TEKLL,0,0,0,1,1,5
KLLKT,0,0,0,1,1,5
LLKTV,0,0,0,1,1,5
LKTVP,0,0,0,1,1,5
KTVPI,0,0,0,1,1,5
TVPII,0,0,0,1,1,5
VPIIQ,0,0,0,1,1,5
PIIQN,0,0,0,1,1,5
IIQNQ,0,0,0,1,1,5
IQNQM,0,0,0,1,1,5
QNQMD,0,0,0,1,1,5
NQMDA,0,0,0,1,1,5
QMDAL,0,0,0,1,1,5
MDALL,0,0,0,1,1,5
DALLD,0,0,0,1,1,5
NTPEA,0,0,0,1,1,5
TPEAY,0,0,0,1,1,5
PEAYS,0,0,0,1,1,5
EAYSV,0,0,0,1,1,5
AYSVL,0,0,0,1,1,5
YSVLF,0,0,0,1,1,5
SVLFD,0,0,0,1,1,5
VLFDM,0,0,0,1,1,5
LFDMA,0,0,0,1,1,5
FDMAR,0,0,0,1,1,5
DMARE,0,0,0,1,1,5
MAREV,0,0,0,1,1,5
AREVN,0,0,0,1,1,5
REVNR,0,0,0,1,1,5
EVNRL,0,0,0,1,1,5
VNRLK,0,0,0,1,1,5
NRLKA,0,0,0,1,1,5
RLKAE,0,0,0,1,1,5
LKAED,0,0,0,1,1,5
NVGKA,0,0,0,1,1,5
VGKAW,0,0,0,1,1,5
GKAWA,0,0,0,1,1,5
KAWAE,0,0,0,1,1,5
AWAED,0,0,0,1,1,5
WAEDV,0,0,0,1,1,5
AEDVL,0,0,0,1,1,5
EDVLA,0,0,0,1,1,5
DVLAL,0,0,0,1,1,5
VLALV,0,0,0,1,1,5
LALVK,0,0,0,1,1,5
ALVKH,0,0,0,1,1,5
NVKDL,0,0,0,1,1,5
VKDLA,0,0,0,1,1,5
KDLAD,0,0,0,1,1,5
DLADA,0,0,0,1,1,5
LADAA,0,0,0,1,1,5
ADAAK,0,0,0,1,1,5
DAAKR,0,0,0,1,1,5
AAKRT,0,0,0,1,1,5
NVKDV,0,0,0,1,1,5
VKDVT,0,0,0,1,1,5
KDVTK,0,0,0,1,1,5
DVTKL,0,0,0,1,1,5
VTKLV,0,0,0,1,1,5
TKLVA,0,0,0,1,1,5
KLVAN,0,0,0,1,1,5
NWDDM,0,0,0,1,1,5
WDDME,0,0,0,1,1,5
DDMEK,0,0,0,1,1,5
DMEKI,0,0,0,1,1,5
MEKIW,0,0,0,1,1,5
EKIWH,0,0,0,1,1,5
KIWHH,0,0,0,1,1,5
IWHHT,0,0,0,1,1,5
WHHTF,0,0,0,1,1,5
HHTFY,0,0,0,1,1,5
HTFYN,0,0,0,1,1,5
NYAHL,0,0,0,1,1,5
YAHLN,0,0,0,1,1,5
AHLNR,0,0,0,1,1,5
HLNRG,0,0,0,1,1,5
LNRGI,0,0,0,1,1,5
NRGIA,0,0,0,1,1,5
RGIAL,0,0,0,1,1,5
GIALY,0,0,0,1,1,5
IALYY,0,0,0,1,1,5
ALYYG,0,0,0,1,1,5
NYEEI,0,0,0,1,1,5
YEEIY,0,0,0,1,1,5
EEIYI,0,0,0,1,1,5
EIYIL,0,0,0,1,1,5
IYILN,0,0,0,1,1,5
YILNH,0,0,0,1,1,5
ILNHI,0,0,0,1,1,5
LNHIL,0,0,0,1,1,5
NHILR,0,0,0,1,1,5
NYEKF,0,0,0,1,1,5
YEKFS,0,0,0,1,1,5
EKFSE,0,0,0,1,1,5
KFSET,0,0,0,1,1,5
FSETK,0,0,0,1,1,5
SETKE,0,0,0,1,1,5
ETKER,0,0,0,1,1,5
TKERL,0,0,0,1,1,5
KERLL,0,0,0,2,2,5
ERLLE,0,0,0,2,2,5
RLLEK,0,0,0,1,1,5
LLEKF,0,0,0,1,1,5
PAERY,0,0,0,1,1,5
AERYY,0,0,0,1,1,5
ERYYR,0,0,0,1,1,5
RYYRD,0,0,0,1,1,5
YYRDA,0,0,0,1,1,5
YRDAR,0,0,0,1,1,5
RDARI,0,0,0,1,1,5
DARIT,0,0,0,1,1,5
PALDI,0,0,0,1,1,5
ALDIL,0,0,0,1,1,5
LDILK,0,0,0,1,1,5
DILKA,0,0,0,1,1,5
ILKAL,0,0,0,1,1,5
LKALV,0,0,0,1,1,5
KALVD,0,0,0,1,1,5
ALVDN,0,0,0,1,1,5
LVDNL,0,0,0,1,1,5
VDNLY,0,0,0,1,1,5
DNLYV,0,0,0,1,1,5
NLYVE,0,0,0,1,1,5
LYVEN,0,0,0,1,1,5
PATSR,0,0,0,1,1,5
ATSRK,0,0,0,1,1,5
TSRKI,0,0,0,1,1,5
SRKIF,0,0,0,2,2,5
RKIFK,0,0,0,1,1,5
KIFKY,0,0,0,1,1,5
IFKYI,0,0,0,1,1,5
FKYIR,0,0,0,1,1,5
KYIRE,0,0,0,1,1,5
YIREL,0,0,0,1,1,5
IRELD,0,0,0,1,1,5
RELDE,0,0,0,1,1,5
PDEVS,0,0,0,1,1,5
DEVSA,0,0,0,1,1,5
EVSAL,0,0,0,1,1,5
VSALR,0,0,0,1,1,5
SALRR,0,0,0,1,1,5
ALRRT,0,0,0,1,1,5
LRRTT,0,0,0,1,1,5
RRTTE,0,0,0,1,1,5
RTTEK,0,0,0,1,1,5
TTEKN,0,0,0,1,1,5
TEKNT,0,0,0,1,1,5
EKNTT,0,0,0,1,1,5
KNTTT,0,0,0,1,1,5
NTTTL,0,0,0,1,1,5
TTTLI,0,0,0,1,1,5
TTLIN,0,0,0,1,1,5
TLINL,0,0,0,1,1,5
LINLA,0,0,0,1,1,5
INLAK,0,0,0,1,1,5
NLAKQ,0,0,0,1,1,5
LAKQH,0,0,0,1,1,5
PDFRK,0,0,0,1,1,5
DFRKA,0,0,0,1,1,5
RKAFK,0,0,0,1,1,5
KAFKR,0,0,0,1,1,5
AFKRL,0,0,0,1,1,5
FKRLL,0,0,0,1,1,5
PDIKA,0,0,0,1,1,5
DIKAQ,0,0,0,1,1,5
IKAQY,0,0,0,1,1,5
KAQYQ,0,0,0,1,1,5
AQYQQ,0,0,0,1,1,5
QYQQR,0,0,0,1,1,5
YQQRW,0,0,0,1,1,5
QQRWL,0,0,0,1,1,5
PDYRE,0,0,0,1,1,5
DYREV,0,0,0,1,1,5
YREVM,0,0,0,1,1,5
REVME,0,0,0,1,1,5
EVMET,0,0,0,1,1,5
VMETF,0,0,0,1,1,5
METFQ,0,0,0,1,1,5
ETFQE,0,0,0,1,1,5
PEALT,0,0,0,1,1,5
EALTV,0,0,0,1,1,5
ALTVA,0,0,0,1,1,5
LTVAA,0,0,0,1,1,5
TVAAT,0,0,0,1,1,5
VAATE,0,0,0,1,1,5
AATEV,0,0,0,1,1,5
ATEVR,0,0,0,1,1,5
TEVRR,0,0,0,1,1,5
EVRRI,0,0,0,1,1,5
VRRIR,0,0,0,1,1,5
RRIRD,0,0,0,1,1,5
RIRDR,0,0,0,1,1,5
IRDRA,0,0,0,1,1,5
RDRAI,0,0,0,1,1,5
DRAIQ,0,0,0,1,1,5
RAIQS,0,0,0,1,1,5
AIQSD,0,0,0,1,1,5
IQSDA,0,0,0,1,1,5
QSDAQ,0,0,0,1,1,5
SDAQV,0,0,0,1,1,5
DAQVA,0,0,0,1,1,5
AQVAP,0,0,0,1,1,5
QVAPM,0,0,0,1,1,5
VAPMT,0,0,0,1,1,5
APMTT,0,0,0,1,1,5
PEDFA,0,0,0,1,1,5
EDFAN,0,0,0,1,1,5
DFANH,0,0,0,1,1,5
FANHL,0,0,0,1,1,5
ANHLF,0,0,0,1,1,5
NHLFT,0,0,0,1,1,5
HLFTV,0,0,0,1,1,5
LFTVF,0,0,0,1,1,5
FTVFD,0,0,0,1,1,5
PEKEA,0,0,0,1,1,5
EKEAV,0,0,0,1,1,5
KEAVT,0,0,0,1,1,5
EAVTL,0,0,0,1,1,5
AVTLG,0,0,0,1,1,5
VTLGI,0,0,0,1,1,5
TLGIK,0,0,0,1,1,5
LGIKA,0,0,0,1,1,5
GIKAL,0,0,0,1,1,5
IKALK,0,0,0,1,1,5
KALKS,0,0,0,2,2,5
ALKSS,0,0,0,1,1,5
LKSSL,0,0,0,1,1,5
PEVQI,0,0,0,1,1,5
EVQIA,0,0,0,1,1,5
VQIAI,0,0,0,1,1,5
QIAIL,0,0,0,1,1,5
IAILT,0,0,0,1,1,5
AILTE,0,0,0,1,1,5
ILTEQ,0,0,0,1,1,5
LTEQI,0,0,0,1,1,5
TEQIN,0,0,0,1,1,5
EQINN,0,0,0,1,1,5
QINNL,0,0,0,1,1,5
INNLN,0,0,0,1,1,5
NNLNE,0,0,0,1,1,5
NLNEH,0,0,0,1,1,5
LNEHL,0,0,0,1,1,5
NEHLR,0,0,0,1,1,5
EHLRV,0,0,0,1,1,5
PEYEH,0,0,0,1,1,5
EYEHL,0,0,0,1,1,5
YEHLY,0,0,0,1,1,5
EHLYT,0,0,0,1,1,5
HLYTE,0,0,0,1,1,5
LYTEL,0,0,0,1,1,5
YTELT,0,0,0,1,1,5
TELTG,0,0,0,1,1,5
ELTGT,0,0,0,1,1,5
LTGTI,0,0,0,1,1,5
TGTIV,0,0,0,1,1,5
GTIVL,0,0,0,1,1,5
TIVLL,0,0,0,1,1,5
IVLLI,0,0,0,1,1,5
VLLIE,0,0,0,1,1,5
LLIES,0,0,0,1,1,5
PGLRR,0,0,0,1,1,5
GLRRA,0,0,0,1,1,5
LRRAW,0,0,0,1,1,5
RRAWK,0,0,0,1,1,5
RAWKR,0,0,0,1,1,5
AWKRL,0,0,0,1,1,5
WKRLQ,0,0,0,1,1,5
PGRIQ,0,0,0,1,1,5
GRIQR,0,0,0,1,1,5
RIQRV,0,0,0,1,1,5
IQRVA,0,0,0,1,1,5
QRVAR,0,0,0,1,1,5
RVARG,0,0,0,1,1,5
VARGS,0,0,0,1,1,5
PIAFI,0,0,0,1,1,5
IAFIH,0,0,0,1,1,5
AFIHK,0,0,0,1,1,5
FIHKA,0,0,0,1,1,5
IHKAI,0,0,0,1,1,5
PIDID,0,0,0,1,1,5
IDIDY,0,0,0,1,1,5
DIDYM,0,0,0,1,1,5
IDYMI,0,0,0,1,1,5
DYMIS,0,0,0,1,1,5
YMISD,0,0,0,1,1,5
MISDT,0,0,0,1,1,5
ISDTL,0,0,0,1,1,5
SDTLE,0,0,0,1,1,5
DTLEL,0,0,0,1,1,5
TLELL,0,0,0,1,1,5
LELLR,0,0,0,1,1,5
PIEAF,0,0,0,1,1,5
IEAFL,0,0,0,1,1,5
EAFLR,0,0,0,1,1,5
AFLRL,0,0,0,1,1,5
FLRLN,0,0,0,1,1,5
LRLNE,0,0,0,1,1,5
RLNEE,0,0,0,1,1,5
LNEEL,0,0,0,1,1,5
NEELE,0,0,0,1,1,5
ELEER,0,0,0,1,1,5
PIKFI,0,0,0,1,1,5
IKFIR,0,0,0,1,1,5
KFIRK,0,0,0,1,1,5
FIRKA,0,0,0,1,1,5
PKAYA,0,0,0,1,1,5
KAYAQ,0,0,0,1,1,5
AYAQH,0,0,0,1,1,5
YAQHV,0,0,0,1,1,5
AQHVF,0,0,0,1,1,5
QHVFR,0,0,0,1,1,5
HVFRS,0,0,0,1,1,5
PKPLV,0,0,0,1,1,5
KPLVS,0,0,0,1,1,5
PLVSF,0,0,0,1,1,5
LVSFF,0,0,0,1,1,5
VSFFQ,0,0,0,1,1,5
SFFQS,0,0,0,1,1,5
FFQSL,0,0,0,1,1,5
FQSLL,0,0,0,1,1,5
QSLLQ,0,0,0,1,1,5
SLLQL,0,0,0,1,1,5
LLQLV,0,0,0,2,2,5
LQLVN,0,0,0,1,1,5
QLVNH,0,0,0,1,1,5
LVNHD,0,0,0,1,1,5
VNHDL,0,0,0,1,1,5
NHDLL,0,0,0,1,1,5
HDLLE,0,0,0,1,1,5
DLLEQ,0,0,0,1,1,5
LLEQQ,0,0,0,1,1,5
LEQQN,0,0,0,1,1,5
PLEEL,0,0,0,1,1,5
LEELF,0,0,0,1,1,5
EELFL,0,0,0,1,1,5
ELFLE,0,0,0,1,1,5
LFLEQ,0,0,0,1,1,5
FLEQL,0,0,0,1,1,5
LEQLE,0,0,0,1,1,5
EQLEA,0,0,0,1,1,5
PLGRL,0,0,0,1,1,5
LGRLI,0,0,0,1,1,5
GRLIH,0,0,0,1,1,5
RLIHM,0,0,0,1,1,5
LIHMV,0,0,0,1,1,5
IHMVN,0,0,0,1,1,5
HMVNQ,0,0,0,1,1,5
MVNQK,0,0,0,1,1,5
VNQKK,0,0,0,1,1,5
NQKKD,0,0,0,1,1,5
QKKDR,0,0,0,1,1,5
KKDRL,0,0,0,1,1,5
KDRLL,0,0,0,1,1,5
DRLLN,0,0,0,1,1,5
RLLNE,0,0,0,1,1,5
LLNEY,0,0,0,1,1,5
LNEYL,0,0,0,1,1,5
NEYLS,0,0,0,1,1,5
PLTKG,0,0,0,1,1,5
LTKGI,0,0,0,1,1,5
TKGIL,0,0,0,1,1,5
KGILG,0,0,0,1,1,5
GILGF,0,0,0,1,1,5
ILGFV,0,0,0,1,1,5
LGFVF,0,0,0,1,1,5
GFVFT,0,0,0,1,1,5
FVFTL,0,0,0,1,1,5
VFTLT,0,0,0,1,1,5
PNDMS,0,0,0,1,1,5
NDMSR,0,0,0,1,1,5
DMSRI,0,0,0,1,1,5
MSRIF,0,0,0,1,1,5
SRIFN,0,0,0,1,1,5
RIFNI,0,0,0,1,1,5
IFNIV,0,0,0,1,1,5
FNIVK,0,0,0,1,1,5
NIVKE,0,0,0,1,1,5
IVKES,0,0,0,1,1,5
VKESL,0,0,0,1,1,5
PNGPT,0,0,0,1,1,5
NGPTH,0,0,0,1,1,5
GPTHA,0,0,0,1,1,5
PTHAP,0,0,0,1,1,5
THAPW,0,0,0,1,1,5
HAPWL,0,0,0,1,1,5
APWLL,0,0,0,1,1,5
PWLLA,0,0,0,1,1,5
WLLAH,0,0,0,1,1,5
LLAHK,0,0,0,1,1,5
LAHKI,0,0,0,1,1,5
AHKIQ,0,0,0,1,1,5
PQHER,0,0,0,1,1,5
QHERD,0,0,0,1,1,5
HERDV,0,0,0,1,1,5
ERDVI,0,0,0,1,1,5
RDVIY,0,0,0,1,1,5
DVIYE,0,0,0,1,1,5
VIYEE,0,0,0,1,1,5
IYEEE,0,0,0,1,1,5
YEEES,0,0,0,1,1,5
PQSYA,0,0,0,1,1,5
QSYAM,0,0,0,1,1,5
SYAMA,0,0,0,1,1,5
YAMAI,0,0,0,1,1,5
AMAIA,0,0,0,1,1,5
MAIAR,0,0,0,1,1,5
AIARQ,0,0,0,1,1,5
IARQE,0,0,0,1,1,5
ARQES,0,0,0,1,1,5
RQESA,0,0,0,1,1,5
PQYAL,0,0,0,1,1,5
QYALE,0,0,0,1,1,5
YALEL,0,0,0,1,1,5
ALELL,0,0,0,1,1,5
LELLT,0,0,0,1,1,5
ELLTV,0,0,0,1,1,5
LLTVY,0,0,0,1,1,5
LTVYA,0,0,0,1,1,5
TVYAW,0,0,0,1,1,5
VYAWE,0,0,0,1,1,5
YAWEQ,0,0,0,1,1,5
AWEQG,0,0,0,1,1,5
WEQGS,0,0,0,1,1,5
PQYSQ,0,0,0,1,1,5
QYSQA,0,0,0,1,1,5
YSQAR,0,0,0,1,1,5
SQARV,0,0,0,1,1,5
QARVM,0,0,0,1,1,5
ARVML,0,0,0,1,1,5
RVMLV,0,0,0,1,1,5
VMLVK,0,0,0,1,1,5
MLVKT,0,0,0,1,1,5
LVKTI,0,0,0,1,1,5
VKTIS,0,0,0,1,1,5
KTISM,0,0,0,1,1,5
TISMI,0,0,0,1,1,5
ISMIS,0,0,0,1,1,5
SMISI,0,0,0,1,1,5
MISIV,0,0,0,1,1,5
ISIVD,0,0,0,1,1,5
SIVDD,0,0,0,1,1,5
IVDDT,0,0,0,1,1,5
VDDTF,0,0,0,1,1,5
DDTFD,0,0,0,1,1,5
DTFDA,0,0,0,1,1,5
PRESF,0,0,0,1,1,5
RESFA,0,0,0,1,1,5
ESFAV,0,0,0,1,1,5
SFAVL,0,0,0,1,1,5
FAVLA,0,0,0,1,1,5
AVLAS,0,0,0,1,1,5
VLASA,0,0,0,1,1,5
LASAL,0,0,0,1,1,5
ASALA,0,0,0,1,1,5
SALAL,0,0,0,1,1,5
ALALM,0,0,0,1,1,5
LALMA,0,0,0,1,1,5
ALMAA,0,0,0,1,1,5
LMAAV,0,0,0,1,1,5
MAAVF,0,0,0,1,1,5
AAVFE,0,0,0,1,1,5
AVFER,0,0,0,1,1,5
VFERL,0,0,0,1,1,5
FERLA,0,0,0,1,1,5
ERLAV,0,0,0,1,1,5
RLAVE,0,0,0,1,1,5
LAVEI,0,0,0,1,1,5
AVEIR,0,0,0,1,1,5
VEIRE,0,0,0,1,1,5
EIREL,0,0,0,1,1,5
IRELS,0,0,0,1,1,5
PRRQQ,0,0,0,1,1,5
RRQQS,0,0,0,1,1,5
RQQSL,0,0,0,1,1,5
QQSLA,0,0,0,1,1,5
QSLAL,0,0,0,1,1,5
SLALR,0,0,0,1,1,5
LALRW,0,0,0,1,1,5
ALRWL,0,0,0,1,1,5
LRWLV,0,0,0,1,1,5
RWLVQ,0,0,0,1,1,5
WLVQA,0,0,0,1,1,5
LVQAA,0,0,0,1,1,5
VQAAN,0,0,0,1,1,5
QAANQ,0,0,0,1,1,5
PSALI,0,0,0,1,1,5
SALID,0,0,0,1,1,5
ALIDQ,0,0,0,1,1,5
LIDQE,0,0,0,1,1,5
IDQEI,0,0,0,1,1,5
DQEIN,0,0,0,1,1,5
QEINV,0,0,0,1,1,5
EINVL,0,0,0,1,1,5
INVLR,0,0,0,1,1,5
NVLRQ,0,0,0,1,1,5
VLRQQ,0,0,0,1,1,5
LRQQA,0,0,0,1,1,5
RQQAA,0,0,0,1,1,5
QQAAQ,0,0,0,1,1,5
QAAQR,0,0,0,1,1,5
AAQRF,0,0,0,1,1,5
PSDQQ,0,0,0,1,1,5
SDQQN,0,0,0,1,1,5
DQQNE,0,0,0,1,1,5
QQNEM,0,0,0,1,1,5
QNEMV,0,0,0,1,1,5
NEMVR,0,0,0,1,1,5
EMVRE,0,0,0,1,1,5
PSFFR,0,0,0,1,1,5
SFFRL,0,0,0,1,1,5
FFRLH,0,0,0,1,1,5
RLHKY,0,0,0,1,1,5
LHKYM,0,0,0,1,1,5
HKYMD,0,0,0,1,1,5
KYMDN,0,0,0,1,1,5
YMDNI,0,0,0,1,1,5
MDNIF,0,0,0,1,1,5
DNIFK,0,0,0,1,1,5
NIFKK,0,0,0,1,1,5
IFKKH,0,0,0,1,1,5
FKKHT,0,0,0,1,1,5
KKHTD,0,0,0,1,1,5
PSSQI,0,0,0,1,1,5
SSQIV,0,0,0,1,1,5
SQIVG,0,0,0,1,1,5
QIVGT,0,0,0,1,1,5
IVGTQ,0,0,0,1,1,5
VGTQA,0,0,0,1,1,5
GTQAV,0,0,0,1,1,5
TQAVF,0,0,0,1,1,5
QAVFN,0,0,0,1,1,5
AVFNV,0,0,0,1,1,5
VFNVM,0,0,0,1,1,5
FNVMM,0,0,0,1,1,5
NVMMG,0,0,0,1,1,5
PSVVA,0,0,0,1,1,5
SVVAN,0,0,0,1,1,5
VVANT,0,0,0,1,1,5
VANTV,0,0,0,1,1,5
ANTVK,0,0,0,1,1,5
NTVKG,0,0,0,1,1,5
TVKGG,0,0,0,1,1,5
PTKER,0,0,0,1,1,5
TKERE,0,0,0,1,1,5
KEREQ,0,0,0,1,1,5
EREQV,0,0,0,1,1,5
REQVI,0,0,0,1,1,5
EQVIA,0,0,0,1,1,5
QVIAH,0,0,0,1,1,5
VIAHL,0,0,0,1,1,5
IAHLG,0,0,0,1,1,5
AHLGL,0,0,0,1,1,5
PTLLD,0,0,0,1,1,5
TLLDL,0,0,0,1,1,5
LLDLF,0,0,0,1,1,5
LDLFA,0,0,0,1,1,5
DLFAE,0,0,0,1,1,5
LFAED,0,0,0,1,1,5
FAEDI,0,0,0,1,1,5
AEDIG,0,0,0,1,1,5
EDIGH,0,0,0,1,1,5
DIGHA,0,0,0,1,1,5
IGHAN,0,0,0,1,1,5
GHANQ,0,0,0,1,1,5
HANQL,0,0,0,1,1,5
ANQLL,0,0,0,1,1,5
NQLLQ,0,0,0,1,1,5
QLLQL,0,0,0,1,1,5
LQLVD,0,0,0,1,1,5
QLVDE,0,0,0,1,1,5
LVDEE,0,0,0,1,1,5
VDEEF,0,0,0,1,1,5
DEEFQ,0,0,0,1,1,5
EEFQA,0,0,0,1,1,5
EFQAL,0,0,0,1,1,5
FQALE,0,0,0,1,1,5
QALER,0,0,0,1,1,5
PVSDT,0,0,0,1,1,5
VSDTM,0,0,0,1,1,5
SDTMD,0,0,0,1,1,5
DTMDM,0,0,0,1,1,5
TMDML,0,0,0,1,1,5
MDMLT,0,0,0,1,1,5
DMLTK,0,0,0,1,1,5
MLTKL,0,0,0,1,1,5
PWTQR,0,0,0,1,1,5
WTQRF,0,0,0,1,1,5
TQRFF,0,0,0,1,1,5
QRFFE,0,0,0,1,1,5
RFFES,0,0,0,1,1,5
FFESF,0,0,0,1,1,5
FESFG,0,0,0,1,1,5
QAGNY,0,0,0,1,1,5
AGNYA,0,0,0,1,1,5
GNYAS,0,0,0,1,1,5
NYASM,0,0,0,1,1,5
YASMF,0,0,0,1,1,5
ASMFW,0,0,0,1,1,5
SMFWL,0,0,0,1,1,5
MFWLT,0,0,0,1,1,5
QAKEV,0,0,0,1,1,5
AKEVL,0,0,0,1,1,5
KEVLK,0,0,0,1,1,5
EVLKQ,0,0,0,1,1,5
VLKQH,0,0,0,1,1,5
LKQHF,0,0,0,1,1,5
KQHFE,0,0,0,1,1,5
QHFEK,0,0,0,1,1,5
HFEKS,0,0,0,1,1,5
QARVW,0,0,0,1,1,5
ARVWV,0,0,0,1,1,5
RVWVA,0,0,0,1,1,5
VWVAR,0,0,0,1,1,5
WVARA,0,0,0,1,1,5
VARAV,0,0,0,1,1,5
ARAVS,0,0,0,1,1,5
RAVSE,0,0,0,1,1,5
AVSEH,0,0,0,1,1,5
VSEHQ,0,0,0,1,1,5
SEHQR,0,0,0,1,1,5
EHQRF,0,0,0,1,1,5
HQRFT,0,0,0,1,1,5
QRFTA,0,0,0,1,1,5
QASTG,0,0,0,1,1,5
ASTGS,0,0,0,1,1,5
STGSL,0,0,0,1,1,5
TGSLL,0,0,0,1,1,5
GSLLN,0,0,0,1,1,5
SLLNI,0,0,0,1,1,5
LLNIL,0,0,0,1,1,5
LNILR,0,0,0,1,1,5
QDDVL,0,0,0,1,1,5
DDVLE,0,0,0,1,1,5
DVLEA,0,0,0,1,1,5
VLEAL,0,0,0,2,2,5
LEALS,0,0,0,1,1,5
EALSA,0,0,0,1,1,5
ALSAA,0,0,0,1,1,5
LSAAV,0,0,0,1,1,5
SAAVR,0,0,0,1,1,5
QDELV,0,0,0,1,1,5
DELVW,0,0,0,1,1,5
ELVWG,0,0,0,1,1,5
LVWGA,0,0,0,1,1,5
VWGAY,0,0,0,1,1,5
WGAYW,0,0,0,1,1,5
GAYWL,0,0,0,1,1,5
AYWLY,0,0,0,1,1,5
YWLYK,0,0,0,1,1,5
WLYKA,0,0,0,1,1,5
LYKAT,0,0,0,1,1,5
QDLLD,0,0,0,1,1,5
DLLDR,0,0,0,1,1,5
LLDRV,0,0,0,1,1,5
LDRVL,0,0,0,1,1,5
DRVLA,0,0,0,1,1,5
RVLAA,0,0,0,1,1,5
VLAAH,0,0,0,1,1,5
LAAHA,0,0,0,1,1,5
AAHAY,0,0,0,1,1,5
AHAYW,0,0,0,1,1,5
HAYWS,0,0,0,1,1,5
AYWSQ,0,0,0,1,1,5
QEWVE,0,0,0,1,1,5
EWVEL,0,0,0,1,1,5
WVELM,0,0,0,1,1,5
VELMV,0,0,0,1,1,5
ELMVE,0,0,0,1,1,5
LMVEA,0,0,0,1,1,5
MVEAK,0,0,0,1,1,5
VEAKE,0,0,0,1,1,5
QFRRG,0,0,0,1,1,5
FRRGA,0,0,0,1,1,5
RRGAN,0,0,0,1,1,5
RGANF,0,0,0,1,1,5
GANFK,0,0,0,1,1,5
ANFKF,0,0,0,1,1,5
NFKFE,0,0,0,1,1,5
FKFEL,0,0,0,1,1,5
KFELG,0,0,0,1,1,5
FELGE,0,0,0,1,1,5
ELGEI,0,0,0,1,1,5
LGEIL,0,0,0,1,1,5
GEILE,0,0,0,1,1,5
EILEN,0,0,0,1,1,5
ILEND,0,0,0,1,1,5
QFSRQ,0,0,0,1,1,5
FSRQM,0,0,0,1,1,5
SRQML,0,0,0,1,1,5
RQMLD,0,0,0,1,1,5
QMLDR,0,0,0,1,1,5
MLDRK,0,0,0,1,1,5
LDRKL,0,0,0,1,1,5
DRKLL,0,0,0,1,1,5
RKLLL,0,0,0,1,1,5
KLLLG,0,0,0,1,1,5
QGLAE,0,0,0,1,1,5
GLAEK,0,0,0,1,1,5
LAEKI,0,0,0,1,1,5
AEKIF,0,0,0,1,1,5
EKIFW,0,0,0,1,1,5
KIFWS,0,0,0,1,1,5
IFWSL,0,0,0,1,1,5
FWSLK,0,0,0,1,1,5
QHLAK,0,0,0,1,1,5
HLAKL,0,0,0,1,1,5
LAKLE,0,0,0,1,1,5
AKLEM,0,0,0,1,1,5
KLEMK,0,0,0,1,1,5
LEMKI,0,0,0,1,1,5
EMKIF,0,0,0,1,1,5
MKIFF,0,0,0,1,1,5
KIFFE,0,0,0,1,1,5
IFFEE,0,0,0,1,1,5
FFEEL,0,0,0,1,1,5
QIKQT,0,0,0,1,1,5
IKQTN,0,0,0,1,1,5
KQTNA,0,0,0,1,1,5
QTNAG,0,0,0,1,1,5
TNAGA,0,0,0,1,1,5
NAGAV,0,0,0,1,1,5
AGAVY,0,0,0,1,1,5
GAVYR,0,0,0,1,1,5
AVYRL,0,0,0,1,1,5
VYRLI,0,0,0,1,1,5
YRLID,0,0,0,1,1,5
RLIDQ,0,0,0,1,1,5
LIDQL,0,0,0,1,1,5
IDQLG,0,0,0,1,1,5
QINEM,0,0,0,1,1,5
INEMH,0,0,0,1,1,5
NEMHL,0,0,0,1,1,5
EMHLL,0,0,0,1,1,5
MHLLI,0,0,0,1,1,5
HLLIQ,0,0,0,1,1,5
LLIQQ,0,0,0,1,1,5
LIQQA,0,0,0,1,1,5
IQQAR,0,0,0,1,1,5
QIPRI,0,0,0,1,1,5
IPRIA,0,0,0,1,1,5
PRIAR,0,0,0,1,1,5
RIARE,0,0,0,1,1,5
IAREK,0,0,0,1,1,5
AREKI,0,0,0,1,1,5
REKIR,0,0,0,1,1,5
EKIRG,0,0,0,1,1,5
KIRGL,0,0,0,1,1,5
IRGLT,0,0,0,1,1,5
RGLTE,0,0,0,1,1,5
GLTEY,0,0,0,1,1,5
LTEYF,0,0,0,1,1,5
QLEES,0,0,0,1,1,5
LEESM,0,0,0,1,1,5
EESML,0,0,0,1,1,5
ESMLY,0,0,0,1,1,5
SMLYS,0,0,0,1,1,5
MLYSL,0,0,0,1,1,5
LYSLN,0,0,0,1,1,5
QLLRG,0,0,0,1,1,5
LLRGV,0,0,0,1,1,5
LRGVG,0,0,0,1,1,5
RGVGA,0,0,0,1,1,5
GVGAA,0,0,0,1,1,5
VGAAA,0,0,0,1,1,5
GAAAT,0,0,0,1,1,5
AAATA,0,0,0,1,1,5
AATAV,0,0,0,1,1,5
ATAVT,0,0,0,1,1,5
TAVTQ,0,0,0,1,1,5
AVTQA,0,0,0,1,1,5
VTQAL,0,0,0,1,1,5
TQALN,0,0,0,1,1,5
QALNE,0,0,0,1,1,5
ALNEL,0,0,0,1,1,5
LNELL,0,0,0,1,1,5
NELLQ,0,0,0,1,1,5
ELLQH,0,0,0,2,2,5
LLQHV,0,0,0,1,1,5
LQHVK,0,0,0,1,1,5
QHVKA,0,0,0,1,1,5
QLVDR,0,0,0,1,1,5
LVDRL,0,0,0,1,1,5
VDRLD,0,0,0,1,1,5
DRLDQ,0,0,0,1,1,5
RLDQS,0,0,0,1,1,5
LDQSW,0,0,0,1,1,5
DQSWQ,0,0,0,1,1,5
QSWQY,0,0,0,1,1,5
SWQYY,0,0,0,1,1,5
WQYYQ,0,0,0,1,1,5
QYYQD,0,0,0,1,1,5
YYQDR,0,0,0,1,1,5
YQDRL,0,0,0,1,1,5
QDRLM,0,0,0,1,1,5
DRLMA,0,0,0,1,1,5
QLVSF,0,0,0,1,1,5
LVSFL,0,0,0,1,1,5
VSFLI,0,0,0,1,1,5
SFLIR,0,0,0,1,1,5
FLIRL,0,0,0,1,1,5
LIRLL,0,0,0,1,1,5
IRLLK,0,0,0,1,1,5
RLLKV,0,0,0,1,1,5
LLKVW,0,0,0,1,1,5
LKVWI,0,0,0,1,1,5
KVWIR,0,0,0,1,1,5
VWIRV,0,0,0,1,1,5
WIRVV,0,0,0,1,1,5
IRVVI,0,0,0,1,1,5
QMSFW,0,0,0,1,1,5
MSFWG,0,0,0,1,1,5
SFWGA,0,0,0,1,1,5
FWGAT,0,0,0,1,1,5
WGATV,0,0,0,1,1,5
GATVI,0,0,0,1,1,5
ATVIT,0,0,0,1,1,5
TVITG,0,0,0,1,1,5
VITGL,0,0,0,1,1,5
ITGLF,0,0,0,1,1,5
TGLFG,0,0,0,1,1,5
QPNAI,0,0,0,1,1,5
PNAIL,0,0,0,1,1,5
NAILE,0,0,0,1,1,5
AILEK,0,0,0,1,1,5
ILEKV,0,0,0,2,2,5
LEKVF,0,0,0,1,1,5
EKVFT,0,0,0,1,1,5
KVFTA,0,0,0,1,1,5
QRAFL,0,0,0,1,1,5
RAFLK,0,0,0,1,1,5
FLKLY,0,0,0,1,1,5
LKLYM,0,0,0,1,1,5
KLYMI,0,0,0,1,1,5
LYMIT,0,0,0,1,1,5
YMITM,0,0,0,1,1,5
MITMT,0,0,0,1,1,5
ITMTE,0,0,0,1,1,5
QTREH,0,0,0,1,1,5
TREHL,0,0,0,1,1,5
REHLL,0,0,0,1,1,5
EHLLL,0,0,0,1,1,5
HLLLA,0,0,0,1,1,5
LLLAR,0,0,0,1,1,5
LLARQ,0,0,0,1,1,5
LARQI,0,0,0,1,1,5
QVIAK,0,0,0,1,1,5
VIAKW,0,0,0,1,1,5
IAKWG,0,0,0,1,1,5
AKWGA,0,0,0,1,1,5
KWGAW,0,0,0,1,1,5
WGAWV,0,0,0,1,1,5
GAWVK,0,0,0,1,1,5
AWVKR,0,0,0,1,1,5
WVKRI,0,0,0,1,1,5
VKRIE,0,0,0,1,1,5
KRIEA,0,0,0,1,1,5
RIEAK,0,0,0,1,1,5
IEAKF,0,0,0,1,1,5
EAKFR,0,0,0,1,1,5
AKFRS,0,0,0,1,1,5
KFRSL,0,0,0,1,1,5
QVIEV,0,0,0,1,1,5
VIEVL,0,0,0,1,1,5
IEVLN,0,0,0,1,1,5
EVLNK,0,0,0,1,1,5
VLNKQ,0,0,0,1,1,5
LNKQV,0,0,0,1,1,5
NKQVA,0,0,0,1,1,5
KQVAD,0,0,0,1,1,5
QVADW,0,0,0,1,1,5
VADWS,0,0,0,1,1,5
ADWSV,0,0,0,1,1,5
DWSVL,0,0,0,1,1,5
WSVLF,0,0,0,1,1,5
SVLFT,0,0,0,1,1,5
VLFTK,0,0,0,1,1,5
LFTKL,0,0,0,1,1,5
FTKLH,0,0,0,1,1,5
TKLHN,0,0,0,1,1,5
KLHNF,0,0,0,1,1,5
LHNFH,0,0,0,2,2,5
HNFHW,0,0,0,1,1,5
NFHWY,0,0,0,1,1,5
FHWYV,0,0,0,1,1,5
QVTQE,0,0,0,1,1,5
VTQEL,0,0,0,1,1,5
TQELR,0,0,0,1,1,5
QELRA,0,0,0,1,1,5
ELRAL,0,0,0,1,1,5
LRALM,0,0,0,1,1,5
RALMD,0,0,0,1,1,5
ALMDE,0,0,0,1,1,5
LMDET,0,0,0,1,1,5
MDETM,0,0,0,1,1,5
DETMK,0,0,0,1,1,5
ETMKE,0,0,0,1,1,5
TMKEL,0,0,0,1,1,5
MKELK,0,0,0,1,1,5
KELKA,0,0,0,1,1,5
ELKAY,0,0,0,1,1,5
LKAYK,0,0,0,1,1,5
KAYKS,0,0,0,1,1,5
AYKSE,0,0,0,1,1,5
YKSEL,0,0,0,1,1,5
KSELE,0,0,0,1,1,5
SELEE,0,0,0,1,1,5
RAAAI,0,0,0,1,1,5
AAAIE,0,0,0,1,1,5
AAIEQ,0,0,0,1,1,5
AIEQL,0,0,0,1,1,5
IEQLK,0,0,0,1,1,5
EQLKI,0,0,0,1,1,5
QLKIW,0,0,0,1,1,5
LKIWG,0,0,0,1,1,5
KIWGE,0,0,0,1,1,5
IWGER,0,0,0,1,1,5
WGERV,0,0,0,1,1,5
GERVG,0,0,0,1,1,5
RDIPE,0,0,0,1,1,5
DIPEL,0,0,0,1,1,5
IPELA,0,0,0,1,1,5
PELAQ,0,0,0,1,1,5
ELAQL,0,0,0,1,1,5
LAQLQ,0,0,0,1,1,5
AQLQS,0,0,0,1,1,5
QLQSE,0,0,0,1,1,5
LQSEI,0,0,0,1,1,5
QSEIL,0,0,0,2,2,5
SEILD,0,0,0,1,1,5
EILDA,0,0,0,1,1,5
ILDAI,0,0,0,1,1,5
LDAIW,0,0,0,1,1,5
REEEK,0,0,0,1,1,5
EEEKE,0,0,0,1,1,5
EEKEA,0,0,0,1,1,5
EKEAL,0,0,0,1,1,5
KEALR,0,0,0,1,1,5
EALRF,0,0,0,1,1,5
ALRFA,0,0,0,1,1,5
LRFAE,0,0,0,1,1,5
RFAEA,0,0,0,1,1,5
FAEAQ,0,0,0,1,1,5
REEIY,0,0,0,1,1,5
EEIYQ,0,0,0,1,1,5
EIYQA,0,0,0,1,1,5
IYQAF,0,0,0,1,1,5
YQAFE,0,0,0,1,1,5
QAFEA,0,0,0,1,1,5
AFEAI,0,0,0,1,1,5
FEAIY,0,0,0,1,1,5
EAIYP,0,0,0,1,1,5
AIYPV,0,0,0,1,1,5
IYPVL,0,0,0,1,1,5
YPVLS,0,0,0,1,1,5
PVLSE,0,0,0,1,1,5
VLSEF,0,0,0,1,1,5
REGFL,0,0,0,1,1,5
EGFLS,0,0,0,1,1,5
GFLSP,0,0,0,1,1,5
FLSPL,0,0,0,1,1,5
LSPLK,0,0,0,1,1,5
SPLKA,0,0,0,1,1,5
PLKAY,0,0,0,1,1,5
LKAYL,0,0,0,1,1,5
KAYLI,0,0,0,1,1,5
RFESA,0,0,0,1,1,5
FESAV,0,0,0,1,1,5
ESAVE,0,0,0,1,1,5
SAVET,0,0,0,1,1,5
AVETL,0,0,0,1,1,5
VETLL,0,0,0,1,1,5
ETLLD,0,0,0,1,1,5
TLLDI,0,0,0,1,1,5
LLDIE,0,0,0,1,1,5
LDIES,0,0,0,1,1,5
DIESQ,0,0,0,1,1,5
IESQL,0,0,0,1,1,5
ESQLE,0,0,0,1,1,5
SQLED,0,0,0,1,1,5
QLEDL,0,0,0,1,1,5
RFLIR,0,0,0,1,1,5
FLIRV,0,0,0,1,1,5
LIRVY,0,0,0,1,1,5
IRVYH,0,0,0,1,1,5
RVYHP,0,0,0,1,1,5
VYHPL,0,0,0,1,1,5
YHPLL,0,0,0,1,1,5
HPLLL,0,0,0,1,1,5
PLLLK,0,0,0,1,1,5
LLLKV,0,0,0,1,1,5
LLKVL,0,0,0,1,1,5
RFLKR,0,0,0,1,1,5
FLKRV,0,0,0,1,1,5
LKRVQ,0,0,0,1,1,5
KRVQP,0,0,0,1,1,5
RVQPL,0,0,0,1,1,5
VQPLV,0,0,0,1,1,5
QPLVN,0,0,0,1,1,5
PLVNR,0,0,0,1,1,5
LVNRW,0,0,0,1,1,5
VNRWL,0,0,0,1,1,5
NRWLL,0,0,0,1,1,5
RWLLL,0,0,0,1,1,5
WLLLI,0,0,0,1,1,5
RFSGK,0,0,0,1,1,5
FSGKV,0,0,0,1,1,5
SGKVR,0,0,0,1,1,5
GKVRE,0,0,0,1,1,5
KVRED,0,0,0,1,1,5
VREDL,0,0,0,1,1,5
REDLT,0,0,0,1,1,5
EDLTK,0,0,0,1,1,5
DLTKI,0,0,0,1,1,5
LTKIV,0,0,0,1,1,5
TKIVW,0,0,0,1,1,5
KIVWV,0,0,0,1,1,5
IVWVF,0,0,0,1,1,5
VWVFF,0,0,0,1,1,5
WVFFW,0,0,0,1,1,5
RFVPR,0,0,0,1,1,5
FVPRW,0,0,0,1,1,5
VPRWR,0,0,0,1,1,5
PRWRT,0,0,0,1,1,5
RWRTV,0,0,0,1,1,5
WRTVV,0,0,0,1,1,5
RTVVG,0,0,0,1,1,5
TVVGQ,0,0,0,1,1,5
VVGQF,0,0,0,1,1,5
VGQFK,0,0,0,1,1,5
GQFKR,0,0,0,1,1,5
QFKRD,0,0,0,1,1,5
FKRDI,0,0,0,1,1,5
KRDIL,0,0,0,1,1,5
RDILV,0,0,0,1,1,5
DILVI,0,0,0,1,1,5
ILVIF,0,0,0,1,1,5
LVIFL,0,0,0,1,1,5
VIFLW,0,0,0,1,1,5
RGEQM,0,0,0,1,1,5
GEQMK,0,0,0,1,1,5
EQMKG,0,0,0,1,1,5
QMKGH,0,0,0,1,1,5
MKGHA,0,0,0,1,1,5
KGHAA,0,0,0,1,1,5
GHAAT,0,0,0,1,1,5
HAATI,0,0,0,1,1,5
AATIE,0,0,0,1,1,5
ATIED,0,0,0,1,1,5
TIEDQ,0,0,0,1,1,5
IEDQV,0,0,0,1,1,5
EDQVR,0,0,0,1,1,5
DQVRR,0,0,0,1,1,5
QVRRM,0,0,0,1,1,5
VRRMI,0,0,0,1,1,5
RRMIA,0,0,0,1,1,5
RGFRG,0,0,0,1,1,5
GFRGW,0,0,0,1,1,5
FRGWW,0,0,0,1,1,5
RGWWL,0,0,0,1,1,5
GWWLA,0,0,0,1,1,5
WWLAS,0,0,0,1,1,5
WLAST,0,0,0,1,1,5
LASTI,0,0,0,1,1,5
ASTIL,0,0,0,1,1,5
STILL,0,0,0,1,1,5
TILLL,0,0,0,1,1,5
ILLLV,0,0,0,1,1,5
LLLVA,0,0,0,1,1,5
LLVAE,0,0,0,1,1,5
LVAEK,0,0,0,1,1,5
RGQLI,0,0,0,1,1,5
GQLIR,0,0,0,1,1,5
QLIRE,0,0,0,1,1,5
LIREA,0,0,0,1,1,5
IREAY,0,0,0,1,1,5
REAYE,0,0,0,1,1,5
EAYED,0,0,0,1,1,5
RHSDN,0,0,0,1,1,5
HSDNI,0,0,0,1,1,5
SDNIN,0,0,0,1,1,5
DNINK,0,0,0,1,1,5
NINKF,0,0,0,1,1,5
INKFL,0,0,0,1,1,5
NKFLD,0,0,0,1,1,5
KFLDF,0,0,0,1,1,5
FLDFI,0,0,0,1,1,5
LDFIH,0,0,0,1,1,5
DFIHG,0,0,0,1,1,5
FIHGI,0,0,0,1,1,5
RIENG,0,0,0,1,1,5
IENGL,0,0,0,1,1,5
ENGLR,0,0,0,1,1,5
NGLRK,0,0,0,1,1,5
GLRKR,0,0,0,1,1,5
LRKRL,0,0,0,1,1,5
RKRLQ,0,0,0,1,1,5
KRLQS,0,0,0,1,1,5
RLQSI,0,0,0,1,1,5
LQSIY,0,0,0,1,1,5
QSIYR,0,0,0,1,1,5
SIYRH,0,0,0,1,1,5
IYRHL,0,0,0,1,1,5
YRHLE,0,0,0,1,1,5
RHLEE,0,0,0,1,1,5
RILKN,0,0,0,1,1,5
ILKNF,0,0,0,1,1,5
LKNFD,0,0,0,1,1,5
KNFDS,0,0,0,1,1,5
NFDSW,0,0,0,1,1,5
FDSWW,0,0,0,1,1,5
DSWWG,0,0,0,1,1,5
SWWGK,0,0,0,1,1,5
WWGKV,0,0,0,1,1,5
WGKVI,0,0,0,1,1,5
GKVIV,0,0,0,1,1,5
KVIVI,0,0,0,1,1,5
VIVIL,0,0,0,1,1,5
RILQW,0,0,0,1,1,5
ILQWI,0,0,0,1,1,5
LQWII,0,0,0,1,1,5
QWIIR,0,0,0,1,1,5
WIIRL,0,0,0,1,1,5
IIRLL,0,0,0,1,1,5
IRLLL,0,0,0,1,1,5
RLLLI,0,0,0,1,1,5
LLLIV,0,0,0,1,1,5
LLIVW,0,0,0,1,1,5
LIVWW,0,0,0,1,1,5
RIWAR,0,0,0,1,1,5
IWARL,0,0,0,1,1,5
WARLQ,0,0,0,1,1,5
ARLQG,0,0,0,1,1,5
RLQGV,0,0,0,1,1,5
LQGVF,0,0,0,1,1,5
QGVFR,0,0,0,1,1,5
GVFRV,0,0,0,1,1,5
VFRVV,0,0,0,1,1,5
FRVVF,0,0,0,1,1,5
RVVFW,0,0,0,1,1,5
VVFWL,0,0,0,1,1,5
RKQSL,0,0,0,1,1,5
KQSLE,0,0,0,1,1,5
QSLEQ,0,0,0,1,1,5
SLEQD,0,0,0,1,1,5
LEQDL,0,0,0,1,1,5
EQDLQ,0,0,0,1,1,5
QDLQF,0,0,0,1,1,5
DLQFY,0,0,0,1,1,5
LQFYY,0,0,0,1,1,5
QFYYG,0,0,0,1,1,5
RLDEA,0,0,0,1,1,5
LDEAE,0,0,0,1,1,5
DEAEA,0,0,0,1,1,5
EAEAS,0,0,0,1,1,5
AEASA,0,0,0,1,1,5
EASAR,0,0,0,1,1,5
ASARS,0,0,0,1,1,5
SARSG,0,0,0,1,1,5
ARSGI,0,0,0,1,1,5
RSGIE,0,0,0,1,1,5
SGIEV,0,0,0,1,1,5
GIEVL,0,0,0,1,1,5
RLFEQ,0,0,0,1,1,5
LFEQA,0,0,0,1,1,5
FEQAS,0,0,0,1,1,5
EQASR,0,0,0,1,1,5
QASRL,0,0,0,1,1,5
SRLAE,0,0,0,1,1,5
RLAEH,0,0,0,1,1,5
LAEHY,0,0,0,1,1,5
RLKSG,0,0,0,1,1,5
LKSGW,0,0,0,1,1,5
KSGWR,0,0,0,1,1,5
SGWRD,0,0,0,1,1,5
GWRDA,0,0,0,1,1,5
WRDAL,0,0,0,1,1,5
RDALK,0,0,0,1,1,5
DALKQ,0,0,0,2,2,5
ALKQI,0,0,0,1,1,5
LKQIV,0,0,0,1,1,5
KQIVF,0,0,0,1,1,5
QIVFF,0,0,0,1,1,5
IVFFF,0,0,0,1,1,5
VFFFF,0,0,0,1,1,5
FFFFL,0,0,0,1,1,5
RLLGK,0,0,0,1,1,5
LLGKW,0,0,0,1,1,5
LGKWS,0,0,0,1,1,5
GKWSA,0,0,0,1,1,5
KWSAI,0,0,0,1,1,5
WSAIL,0,0,0,1,1,5
SAILK,0,0,0,1,1,5
AILKN,0,0,0,1,1,5
ILKNV,0,0,0,1,1,5
LKNVR,0,0,0,1,1,5
KNVRF,0,0,0,1,1,5
NVRFF,0,0,0,1,1,5
VRFFF,0,0,0,1,1,5
RFFFF,0,0,0,1,1,5
FFFFW,0,0,0,1,1,5
FFFWL,0,0,0,1,1,5
RLVVL,0,0,0,1,1,5
LVVLE,0,0,0,1,1,5
VVLEA,0,0,0,1,1,5
EALTN,0,0,0,1,1,5
ALTNF,0,0,0,1,1,5
LTNFL,0,0,0,1,1,5
TNFLN,0,0,0,1,1,5
NFLNH,0,0,0,1,1,5
RLWTQ,0,0,0,1,1,5
LWTQW,0,0,0,1,1,5
WTQWQ,0,0,0,1,1,5
TQWQA,0,0,0,1,1,5
QWQAI,0,0,0,1,1,5
WQAIV,0,0,0,1,1,5
QAIVQ,0,0,0,1,1,5
AIVQE,0,0,0,1,1,5
IVQEI,0,0,0,1,1,5
VQEIR,0,0,0,1,1,5
QEIRF,0,0,0,1,1,5
EIRFL,0,0,0,1,1,5
IRFLW,0,0,0,1,1,5
RFLWL,0,0,0,1,1,5
FLWLL,0,0,0,1,1,5
LWLLL,0,0,0,1,1,5
RMDEV,0,0,0,1,1,5
MDEVR,0,0,0,1,1,5
DEVRT,0,0,0,1,1,5
EVRTL,0,0,0,1,1,5
VRTLQ,0,0,0,1,1,5
RTLQE,0,0,0,1,1,5
TLQEN,0,0,0,1,1,5
LQENL,0,0,0,1,1,5
QENLR,0,0,0,1,1,5
ENLRQ,0,0,0,1,1,5
NLRQL,0,0,0,1,1,5
LRQLQ,0,0,0,1,1,5
RQLQD,0,0,0,1,1,5
QLQDE,0,0,0,1,1,5
LQDEY,0,0,0,1,1,5
QDEYD,0,0,0,1,1,5
DEYDQ,0,0,0,1,1,5
EYDQQ,0,0,0,1,1,5
YDQQQ,0,0,0,1,1,5
DQQQT,0,0,0,1,1,5
RNEVV,0,0,0,1,1,5
NEVVS,0,0,0,1,1,5
EVVSL,0,0,0,1,1,5
VVSLM,0,0,0,1,1,5
VSLMQ,0,0,0,1,1,5
SLMQA,0,0,0,1,1,5
LMQAN,0,0,0,1,1,5
MQANG,0,0,0,1,1,5
RPEDK,0,0,0,1,1,5
PEDKS,0,0,0,1,1,5
EDKSK,0,0,0,1,1,5
DKSKI,0,0,0,1,1,5
KSKIV,0,0,0,1,1,5
SKIVA,0,0,0,1,1,5
KIVAE,0,0,0,1,1,5
IVAEI,0,0,0,1,1,5
VAEIR,0,0,0,1,1,5
RPEVQ,0,0,0,1,1,5
PEVQD,0,0,0,1,1,5
EVQDA,0,0,0,1,1,5
VQDAL,0,0,0,1,1,5
QDALS,0,0,0,1,1,5
DALSA,0,0,0,1,1,5
ALSAE,0,0,0,1,1,5
RPQLR,0,0,0,1,1,5
PQLRN,0,0,0,1,1,5
QLRNL,0,0,0,1,1,5
LRNLL,0,0,0,1,1,5
RNLLH,0,0,0,1,1,5
NLLHE,0,0,0,1,1,5
LLHEK,0,0,0,1,1,5
RPRII,0,0,0,1,1,5
PRIIA,0,0,0,1,1,5
RIIAA,0,0,0,1,1,5
IIAAI,0,0,0,1,1,5
IAAIW,0,0,0,1,1,5
AAIWH,0,0,0,1,1,5
AIWHY,0,0,0,1,1,5
IWHYV,0,0,0,1,1,5
WHYVK,0,0,0,1,1,5
HYVKA,0,0,0,1,1,5
YVKAR,0,0,0,1,1,5
RRQEL,0,0,0,1,1,5
RQELE,0,0,0,1,1,5
QELEE,0,0,0,1,1,5
ELEEF,0,0,0,1,1,5
LEEFS,0,0,0,1,1,5
EEFSA,0,0,0,1,1,5
EFSAA,0,0,0,1,1,5
FSAAL,0,0,0,1,1,5
AALAR,0,0,0,1,1,5
ALARR,0,0,0,1,1,5
RVIEG,0,0,0,1,1,5
VIEGI,0,0,0,1,1,5
IEGIK,0,0,0,1,1,5
EGIKN,0,0,0,1,1,5
GIKNV,0,0,0,1,1,5
IKNVI,0,0,0,1,1,5
KNVIP,0,0,0,1,1,5
NVIPK,0,0,0,1,1,5
VIPKL,0,0,0,1,1,5
IPKLL,0,0,0,1,1,5
PKLLT,0,0,0,1,1,5
KLLTW,0,0,0,1,1,5
LLTWW,0,0,0,1,1,5
LTWWP,0,0,0,1,1,5
RVNAA,0,0,0,1,1,5
VNAAI,0,0,0,1,1,5
NAAIP,0,0,0,1,1,5
AAIPN,0,0,0,1,1,5
AIPNI,0,0,0,1,1,5
IPNII,0,0,0,1,1,5
PNIIV,0,0,0,1,1,5
RVWRW,0,0,0,2,2,5
VWRWI,0,0,0,1,1,5
WRWIV,0,0,0,1,1,5
RWIVK,0,0,0,1,1,5
WIVKW,0,0,0,1,1,5
IVKWW,0,0,0,1,1,5
VKWWL,0,0,0,1,1,5
KWWLF,0,0,0,1,1,5
WWLFV,0,0,0,1,1,5
RYGWR,0,0,0,1,1,5
YGWRT,0,0,0,1,1,5
GWRTA,0,0,0,1,1,5
WRTAV,0,0,0,1,1,5
RTAVD,0,0,0,1,1,5
TAVDY,0,0,0,1,1,5
AVDYS,0,0,0,1,1,5
VDYSW,0,0,0,1,1,5
DYSWF,0,0,0,1,1,5
YSWFG,0,0,0,1,1,5
SAATA,0,0,0,1,1,5
AATAD,0,0,0,1,1,5
ATADF,0,0,0,1,1,5
TADFV,0,0,0,1,1,5
ADFVA,0,0,0,1,1,5
DFVAM,0,0,0,1,1,5
FVAMT,0,0,0,1,1,5
VAMTA,0,0,0,1,1,5
AMTAM,0,0,0,1,1,5
MTAMA,0,0,0,1,1,5
TAMAA,0,0,0,1,1,5
AMAAR,0,0,0,1,1,5
MAARI,0,0,0,1,1,5
AARIF,0,0,0,1,1,5
SAAWA,0,0,0,1,1,5
AAWAE,0,0,0,1,1,5
AWAEW,0,0,0,1,1,5
WAEWQ,0,0,0,1,1,5
AEWQK,0,0,0,1,1,5
EWQKA,0,0,0,1,1,5
WQKAR,0,0,0,1,1,5
SAEEM,0,0,0,1,1,5
AEEMV,0,0,0,1,1,5
EEMVQ,0,0,0,1,1,5
EMVQT,0,0,0,1,1,5
MVQTL,0,0,0,1,1,5
VQTLV,0,0,0,1,1,5
QTLVN,0,0,0,1,1,5
TLVND,0,0,0,1,1,5
LVNDY,0,0,0,1,1,5
VNDYS,0,0,0,1,1,5
NDYSA,0,0,0,1,1,5
DYSAL,0,0,0,1,1,5
YSALI,0,0,0,1,1,5
SALIQ,0,0,0,1,1,5
ALIQE,0,0,0,1,1,5
LIQEL,0,0,0,1,1,5
IQELK,0,0,0,1,1,5
QELKE,0,0,0,1,1,5
ELKEG,0,0,0,1,1,5
LKEGM,0,0,0,1,1,5
KEGME,0,0,0,1,1,5
EGMEV,0,0,0,1,1,5
GMEVA,0,0,0,1,1,5
MEVAG,0,0,0,1,1,5
EVAGE,0,0,0,1,1,5
VAGEA,0,0,0,1,1,5
SANNI,0,0,0,1,1,5
ANNII,0,0,0,1,1,5
NNIIE,0,0,0,1,1,5
NIIEE,0,0,0,1,1,5
IIEEI,0,0,0,1,1,5
IEEIQ,0,0,0,1,1,5
EEIQM,0,0,0,1,1,5
EIQMQ,0,0,0,1,1,5
IQMQK,0,0,0,1,1,5
SASSQ,0,0,0,1,1,5
ASSQN,0,0,0,1,1,5
SSQNA,0,0,0,1,1,5
SQNAW,0,0,0,1,1,5
QNAWL,0,0,0,1,1,5
NAWLA,0,0,0,1,1,5
AWLAA,0,0,0,1,1,5
WLAAN,0,0,0,1,1,5
LAANR,0,0,0,1,1,5
AANRN,0,0,0,1,1,5
SAVKV,0,0,0,1,1,5
AVKVL,0,0,0,1,1,5
VKVLA,0,0,0,1,1,5
KVLAE,0,0,0,1,1,5
VLAEE,0,0,0,1,1,5
LAEES,0,0,0,1,1,5
AEESK,0,0,0,1,1,5
SDEFN,0,0,0,1,1,5
DEFNT,0,0,0,1,1,5
EFNTV,0,0,0,1,1,5
FNTVA,0,0,0,1,1,5
NTVAD,0,0,0,1,1,5
TVADN,0,0,0,1,1,5
VADNL,0,0,0,1,1,5
ADNLV,0,0,0,1,1,5
DNLVT,0,0,0,1,1,5
NLVTF,0,0,0,1,1,5
LVTFG,0,0,0,1,1,5
VTFGD,0,0,0,1,1,5
TFGDS,0,0,0,1,1,5
FGDSF,0,0,0,1,1,5
GDSFL,0,0,0,1,1,5
DSFLQ,0,0,0,1,1,5
SFLQV,0,0,0,1,1,5
FLQVI,0,0,0,1,1,5
LQVIL,0,0,0,1,1,5
QVILD,0,0,0,1,1,5
VILDH,0,0,0,1,1,5
ILDHI,0,0,0,1,1,5
SDELS,0,0,0,1,1,5
DELSR,0,0,0,1,1,5
ELSRA,0,0,0,1,1,5
LSRAW,0,0,0,1,1,5
SRAWE,0,0,0,1,1,5
RAWEV,0,0,0,1,1,5
AWEVA,0,0,0,1,1,5
WEVAY,0,0,0,1,1,5
EVAYD,0,0,0,1,1,5
VAYDE,0,0,0,1,1,5
AYDEL,0,0,0,2,2,5
YDELA,0,0,0,2,2,5
DELAA,0,0,0,1,1,5
ELAAA,0,0,0,1,1,5
LAAAI,0,0,0,1,1,5
AAAIK,0,0,0,1,1,5
SDIFN,0,0,0,1,1,5
DIFNK,0,0,0,1,1,5
IFNKN,0,0,0,1,1,5
FNKNM,0,0,0,1,1,5
NKNMR,0,0,0,1,1,5
KNMRA,0,0,0,1,1,5
NMRAH,0,0,0,1,1,5
MRAHA,0,0,0,1,1,5
RAHAL,0,0,0,1,1,5
AHALE,0,0,0,1,1,5
HALEK,0,0,0,1,1,5
SDIKK,0,0,0,1,1,5
DIKKL,0,0,0,1,1,5
IKKLG,0,0,0,2,2,5
KKLGS,0,0,0,1,1,5
KLGSS,0,0,0,1,1,5
LGSSW,0,0,0,1,1,5
GSSWI,0,0,0,1,1,5
SSWII,0,0,0,1,1,5
SWIIN,0,0,0,1,1,5
WIINW,0,0,0,1,1,5
IINWF,0,0,0,1,1,5
INWFF,0,0,0,1,1,5
NWFFG,0,0,0,1,1,5
SDSEI,0,0,0,1,1,5
DSEIS,0,0,0,1,1,5
SEIST,0,0,0,1,1,5
EISTI,0,0,0,1,1,5
ISTIL,0,0,0,1,1,5
STILS,0,0,0,1,1,5
TILSD,0,0,0,1,1,5
ILSDV,0,0,0,1,1,5
LSDVV,0,0,0,1,1,5
SDVVT,0,0,0,1,1,5
DVVTN,0,0,0,1,1,5
VVTNE,0,0,0,1,1,5
VTNER,0,0,0,1,1,5
SDWYL,0,0,0,1,1,5
DWYLK,0,0,0,1,1,5
WYLKG,0,0,0,1,1,5
YLKGR,0,0,0,1,1,5
LKGRL,0,0,0,1,1,5
KGRLT,0,0,0,1,1,5
GRLTS,0,0,0,1,1,5
RLTSL,0,0,0,1,1,5
LTSLE,0,0,0,1,1,5
TSLES,0,0,0,1,1,5
SLESQ,0,0,0,1,1,5
LESQF,0,0,0,1,1,5
ESQFI,0,0,0,1,1,5
SQFIN,0,0,0,1,1,5
QFINA,0,0,0,1,1,5
FINAL,0,0,0,1,1,5
INALG,0,0,0,1,1,5
NALGI,0,0,0,1,1,5
ALGIL,0,0,0,1,1,5
LGILE,0,0,0,1,1,5
GILET,0,0,0,1,1,5
SEAAK,0,0,0,1,1,5
EAAKA,0,0,0,1,1,5
AAKAY,0,0,0,1,1,5
AKAYM,0,0,0,1,1,5
KAYMK,0,0,0,1,1,5
AYMKG,0,0,0,1,1,5
YMKGL,0,0,0,1,1,5
MKGLE,0,0,0,1,1,5
KGLEY,0,0,0,1,1,5
GLEYQ,0,0,0,1,1,5
LEYQM,0,0,0,1,1,5
EYQMS,0,0,0,1,1,5
YQMSG,0,0,0,1,1,5
QMSGN,0,0,0,1,1,5
MSGNE,0,0,0,1,1,5
SGNEQ,0,0,0,1,1,5
GNEQW,0,0,0,1,1,5
NEQWS,0,0,0,1,1,5
EQWSK,0,0,0,1,1,5
QWSKT,0,0,0,1,1,5
SEEEE,0,0,0,1,1,5
EEEEN,0,0,0,1,1,5
EEENN,0,0,0,1,1,5
EENNV,0,0,0,1,1,5
ENNVI,0,0,0,1,1,5
NNVIE,0,0,0,1,1,5
NVIEQ,0,0,0,1,1,5
VIEQA,0,0,0,1,1,5
EQAKE,0,0,0,1,1,5
QAKEE,0,0,0,1,1,5
AKEEI,0,0,0,1,1,5
KEEIK,0,0,0,1,1,5
EEIKE,0,0,0,1,1,5
EIKEA,0,0,0,1,1,5
IKEAI,0,0,0,1,1,5
KEAIK,0,0,0,1,1,5
EAIKK,0,0,0,1,1,5
AIKKA,0,0,0,1,1,5
IKKAD,0,0,0,1,1,5
KKADE,0,0,0,1,1,5
KADET,0,0,0,1,1,5
SEELN,0,0,0,1,1,5
EELNS,0,0,0,1,1,5
ELNSA,0,0,0,1,1,5
LNSAW,0,0,0,1,1,5
NSAWT,0,0,0,1,1,5
SAWTI,0,0,0,1,1,5
AWTIA,0,0,0,1,1,5
WTIAY,0,0,0,1,1,5
TIAYD,0,0,0,1,1,5
IAYDE,0,0,0,1,1,5
DELAI,0,0,0,1,1,5
ELAIV,0,0,0,1,1,5
LAIVI,0,0,0,1,1,5
AIVIK,0,0,0,1,1,5
IVIKK,0,0,0,1,1,5
VIKKE,0,0,0,1,1,5
IKKEM,0,0,0,1,1,5
KKEMD,0,0,0,1,1,5
KEMDD,0,0,0,1,1,5
EMDDA,0,0,0,1,1,5
SEERI,0,0,0,1,1,5
EERIR,0,0,0,1,1,5
ERIRS,0,0,0,1,1,5
RIRSG,0,0,0,1,1,5
IRSGV,0,0,0,1,1,5
RSGVK,0,0,0,1,1,5
SGVKR,0,0,0,1,1,5
GVKRL,0,0,0,1,1,5
VKRLS,0,0,0,1,1,5
KRLSK,0,0,0,1,1,5
RLSKS,0,0,0,1,1,5
LSKSR,0,0,0,1,1,5
SKSRQ,0,0,0,1,1,5
SEEVL,0,0,0,1,1,5
EEVLA,0,0,0,1,1,5
EVLAM,0,0,0,1,1,5
VLAMV,0,0,0,1,1,5
LAMVS,0,0,0,1,1,5
AMVSR,0,0,0,1,1,5
MVSRK,0,0,0,1,1,5
VSRKM,0,0,0,1,1,5
SEEYI,0,0,0,1,1,5
EEYIQ,0,0,0,1,1,5
EYIQL,0,0,0,1,1,5
YIQLL,0,0,0,2,2,5
IQLLK,0,0,0,1,1,5
QLLKK,0,0,0,1,1,5
LKKLI,0,0,0,2,2,5
SEREA,0,0,0,1,1,5
EREAV,0,0,0,1,1,5
REAVE,0,0,0,1,1,5
AVEII,0,0,0,1,1,5
VEIIK,0,0,0,1,1,5
EIIKK,0,0,0,1,1,5
IIKKN,0,0,0,1,1,5
SESAV,0,0,0,1,1,5
ESAVS,0,0,0,1,1,5
SAVSH,0,0,0,1,1,5
AVSHQ,0,0,0,1,1,5
VSHQL,0,0,0,1,1,5
SHQLR,0,0,0,1,1,5
HQLRS,0,0,0,1,1,5
QLRSL,0,0,0,1,1,5
LRSLR,0,0,0,1,1,5
RSLRN,0,0,0,1,1,5
SLRNL,0,0,0,1,1,5
SESKL,0,0,0,1,1,5
ESKLI,0,0,0,1,1,5
SKLIE,0,0,0,1,1,5
KLIEQ,0,0,0,1,1,5
LIEQA,0,0,0,1,1,5
IEQAF,0,0,0,1,1,5
EQAFR,0,0,0,1,1,5
SFADF,0,0,0,1,1,5
FADFK,0,0,0,1,1,5
ADFKA,0,0,0,1,1,5
DFKAQ,0,0,0,1,1,5
FKAQF,0,0,0,1,1,5
KAQFT,0,0,0,1,1,5
AQFTD,0,0,0,1,1,5
QFTDA,0,0,0,1,1,5
FTDAA,0,0,0,1,1,5
TDAAI,0,0,0,1,1,5
DAAIK,0,0,0,1,1,5
AAIKN,0,0,0,1,1,5
SFDRV,0,0,0,1,1,5
FDRVM,0,0,0,1,1,5
DRVMN,0,0,0,1,1,5
RVMNA,0,0,0,1,1,5
VMNAI,0,0,0,1,1,5
MNAIE,0,0,0,1,1,5
NAIEE,0,0,0,1,1,5
AIEEN,0,0,0,1,1,5
SFSRI,0,0,0,1,1,5
FSRII,0,0,0,1,1,5
SRIIS,0,0,0,2,2,5
RIISE,0,0,0,1,1,5
IISEL,0,0,0,1,1,5
ISELG,0,0,0,1,1,5
SELGT,0,0,0,1,1,5
ELGTR,0,0,0,1,1,5
LGTRD,0,0,0,1,1,5
SGARR,0,0,0,1,1,5
GARRV,0,0,0,1,1,5
ARRVR,0,0,0,1,1,5
RRVRI,0,0,0,1,1,5
RVRIA,0,0,0,1,1,5
VRIAQ,0,0,0,1,1,5
RIAQT,0,0,0,1,1,5
IAQTL,0,0,0,1,1,5
AQTLT,0,0,0,1,1,5
QTLTE,0,0,0,1,1,5
TLTEN,0,0,0,1,1,5
SGDEL,0,0,0,1,1,5
GDELY,0,0,0,1,1,5
DELYE,0,0,0,1,1,5
ELYEL,0,0,0,1,1,5
LYELL,0,0,0,1,1,5
YELLQ,0,0,0,1,1,5
LLQHI,0,0,0,1,1,5
LQHIL,0,0,0,1,1,5
QHILK,0,0,0,1,1,5
HILKQ,0,0,0,1,1,5
ILKQR,0,0,0,1,1,5
LKQRD,0,0,0,1,1,5
KQRDH,0,0,0,1,1,5
QRDHH,0,0,0,1,1,5
RDHHH,0,0,0,1,1,5
DHHHH,0,0,0,1,1,5
HHHHH,0,0,0,1,1,5
SGPAY,0,0,0,1,1,5
GPAYV,0,0,0,1,1,5
PAYVF,0,0,0,1,1,5
AYVFY,0,0,0,1,1,5
YVFYL,0,0,0,2,2,5
VFYLL,0,0,0,1,1,5
FYLLD,0,0,0,1,1,5
YLLDA,0,0,0,1,1,5
LLDAL,0,0,0,1,1,5
LDALQ,0,0,0,1,1,5
DALQN,0,0,0,1,1,5
ALQNA,0,0,0,1,1,5
LQNAA,0,0,0,1,1,5
QNAAI,0,0,0,1,1,5
NAAIR,0,0,0,1,1,5
AAIRQ,0,0,0,1,1,5
SGRFW,0,0,0,1,1,5
GRFWK,0,0,0,1,1,5
RFWKL,0,0,0,1,1,5
FWKLY,0,0,0,1,1,5
WKLYI,0,0,0,1,1,5
KLYIE,0,0,0,1,1,5
LYIEA,0,0,0,1,1,5
YIEAE,0,0,0,1,1,5
IEAEI,0,0,0,1,1,5
EAEIK,0,0,0,1,1,5
AEIKA,0,0,0,1,1,5
SGTIK,0,0,0,1,1,5
GTIKA,0,0,0,1,1,5
IKAAH,0,0,0,1,1,5
KAAHE,0,0,0,1,1,5
AAHEV,0,0,0,1,1,5
AHEVL,0,0,0,1,1,5
HEVLM,0,0,0,1,1,5
EVLME,0,0,0,1,1,5
VLMEM,0,0,0,1,1,5
LMEMG,0,0,0,1,1,5
SHAQD,0,0,0,1,1,5
HAQDI,0,0,0,1,1,5
AQDIY,0,0,0,1,1,5
QDIYK,0,0,0,1,1,5
DIYKE,0,0,0,1,1,5
IYKEA,0,0,0,1,1,5
YKEAF,0,0,0,1,1,5
KEAFN,0,0,0,1,1,5
EAFNS,0,0,0,1,1,5
AFNSA,0,0,0,1,1,5
FNSAW,0,0,0,1,1,5
NSAWD,0,0,0,1,1,5
SAWDQ,0,0,0,1,1,5
AWDQY,0,0,0,1,1,5
SIDEK,0,0,0,1,1,5
IDEKY,0,0,0,1,1,5
DEKYE,0,0,0,1,1,5
EKYEA,0,0,0,1,1,5
KYEAE,0,0,0,1,1,5
YEAEV,0,0,0,1,1,5
EAEVK,0,0,0,1,1,5
EVKKS,0,0,0,1,1,5
VKKSE,0,0,0,1,1,5
KKSEI,0,0,0,1,1,5
KSEID,0,0,0,1,1,5
SEIDH,0,0,0,1,1,5
EIDHH,0,0,0,1,1,5
IDHHK,0,0,0,1,1,5
SIERL,0,0,0,1,1,5
IERLL,0,0,0,1,1,5
RLLEM,0,0,0,1,1,5
LLEME,0,0,0,1,1,5
LEMES,0,0,0,1,1,5
EMESL,0,0,0,1,1,5
SIPHL,0,0,0,1,1,5
IPHLA,0,0,0,1,1,5
PHLAN,0,0,0,1,1,5
HLANL,0,0,0,1,1,5
LANLL,0,0,0,1,1,5
ANLLI,0,0,0,1,1,5
NLLIE,0,0,0,1,1,5
LLIER,0,0,0,1,1,5
LIERS,0,0,0,1,1,5
IERSQ,0,0,0,1,1,5
SISRY,0,0,0,1,1,5
ISRYK,0,0,0,1,1,5
SRYKT,0,0,0,1,1,5
RYKTI,0,0,0,1,1,5
YKTIE,0,0,0,1,1,5
KTIEW,0,0,0,1,1,5
TIEWL,0,0,0,1,1,5
IEWLN,0,0,0,1,1,5
EWLNY,0,0,0,1,1,5
WLNYI,0,0,0,1,1,5
LNYIA,0,0,0,1,1,5
NYIAT,0,0,0,1,1,5
YIATE,0,0,0,1,1,5
IATEL,0,0,0,1,1,5
SKDAL,0,0,0,1,1,5
KDALM,0,0,0,1,1,5
DALML,0,0,0,1,1,5
ALMLE,0,0,0,1,1,5
LMLEA,0,0,0,1,1,5
MLEAF,0,0,0,1,1,5
LEAFE,0,0,0,1,1,5
EAFEQ,0,0,0,1,1,5
AFEQL,0,0,0,1,1,5
FEQLL,0,0,0,1,1,5
EQLLG,0,0,0,1,1,5
QLLGK,0,0,0,1,1,5
LLGKR,0,0,0,1,1,5
LGKRR,0,0,0,1,1,5
GKRRE,0,0,0,1,1,5
KRREL,0,0,0,1,1,5
RRELL,0,0,0,1,1,5
RELLG,0,0,0,1,1,5
ELLGE,0,0,0,1,1,5
SKDLA,0,0,0,1,1,5
KDLAQ,0,0,0,1,1,5
DLAQT,0,0,0,1,1,5
LAQTS,0,0,0,1,1,5
AQTSY,0,0,0,1,1,5
QTSYF,0,0,0,1,1,5
TSYFM,0,0,0,1,1,5
SYFMA,0,0,0,1,1,5
YFMAT,0,0,0,1,1,5
FMATN,0,0,0,1,1,5
MATNS,0,0,0,1,1,5
ATNSL,0,0,0,1,1,5
TNSLH,0,0,0,1,1,5
NSLHL,0,0,0,1,1,5
SLHLT,0,0,0,1,1,5
SKEDI,0,0,0,1,1,5
KEDID,0,0,0,1,1,5
EDIDT,0,0,0,1,1,5
DIDTA,0,0,0,1,1,5
IDTAM,0,0,0,1,1,5
DTAMK,0,0,0,1,1,5
TAMKL,0,0,0,1,1,5
AMKLG,0,0,0,1,1,5
MKLGA,0,0,0,1,1,5
KLGAG,0,0,0,1,1,5
SKEDV,0,0,0,1,1,5
KEDVE,0,0,0,1,1,5
EDVER,0,0,0,1,1,5
DVERV,0,0,0,1,1,5
VERVK,0,0,0,1,1,5
ERVKL,0,0,0,1,1,5
RVKLR,0,0,0,1,1,5
VKLRI,0,0,0,1,1,5
KLRIN,0,0,0,1,1,5
LRINL,0,0,0,1,1,5
RINLA,0,0,0,1,1,5
INLAR,0,0,0,1,1,5
NLARN,0,0,0,1,1,5
LARNW,0,0,0,1,1,5
ARNWV,0,0,0,1,1,5
RNWVK,0,0,0,1,1,5
NWVKK,0,0,0,1,1,5
WVKKY,0,0,0,1,1,5
SKEEQ,0,0,0,1,1,5
KEEQR,0,0,0,1,1,5
EEQRD,0,0,0,1,1,5
EQRDY,0,0,0,1,1,5
QRDYV,0,0,0,1,1,5
RDYVF,0,0,0,1,1,5
DYVFY,0,0,0,1,1,5
VFYLA,0,0,0,1,1,5
FYLAV,0,0,0,1,1,5
YLAVG,0,0,0,1,1,5
LAVGN,0,0,0,1,1,5
AVGNY,0,0,0,1,1,5
VGNYR,0,0,0,1,1,5
GNYRL,0,0,0,1,1,5
SKIQK,0,0,0,1,1,5
KIQKE,0,0,0,1,1,5
IQKEL,0,0,0,1,1,5
QKELV,0,0,0,1,1,5
KELVA,0,0,0,1,1,5
ELVAI,0,0,0,1,1,5
LVAIM,0,0,0,1,1,5
VAIMN,0,0,0,1,1,5
SKPIQ,0,0,0,1,1,5
KPIQN,0,0,0,1,1,5
PIQNV,0,0,0,1,1,5
IQNVE,0,0,0,1,1,5
QNVES,0,0,0,1,1,5
NVESG,0,0,0,1,1,5
VESGF,0,0,0,1,1,5
ESGFI,0,0,0,1,1,5
SGFIF,0,0,0,1,1,5
GFIFA,0,0,0,1,1,5
FIFAL,0,0,0,1,1,5
IFALV,0,0,0,1,1,5
FALVS,0,0,0,1,1,5
SKYLK,0,0,0,1,1,5
KYLKS,0,0,0,1,1,5
YLKSL,0,0,0,1,1,5
LKSLL,0,0,0,1,1,5
KSLLS,0,0,0,1,1,5
SLLSL,0,0,0,1,1,5
LLSLM,0,0,0,1,1,5
SKYRL,0,0,0,1,1,5
KYRLT,0,0,0,1,1,5
YRLTV,0,0,0,1,1,5
RLTVV,0,0,0,1,1,5
LTVVV,0,0,0,1,1,5
TVVVA,0,0,0,1,1,5
VVVAK,0,0,0,1,1,5
VVAKR,0,0,0,1,1,5
VAKRA,0,0,0,1,1,5
AKRAQ,0,0,0,1,1,5
KRAQQ,0,0,0,1,1,5
RAQQL,0,0,0,1,1,5
AQQLL,0,0,0,1,1,5
QQLLR,0,0,0,1,1,5
QLLRH,0,0,0,1,1,5
SLAEA,0,0,0,1,1,5
LAEAL,0,0,0,1,1,5
AEALG,0,0,0,2,2,5
EALGW,0,0,0,1,1,5
ALGWL,0,0,0,1,1,5
GWLFV,0,0,0,1,1,5
WLFVS,0,0,0,1,1,5
LFVSE,0,0,0,1,1,5
FVSEG,0,0,0,1,1,5
VSEGS,0,0,0,1,1,5
SLEQQ,0,0,0,1,1,5
LEQQF,0,0,0,1,1,5
EQQFS,0,0,0,1,1,5
QQFSI,0,0,0,1,1,5
QFSIR,0,0,0,1,1,5
FSIRS,0,0,0,1,1,5
SIRSF,0,0,0,1,1,5
IRSFA,0,0,0,1,1,5
RSFAT,0,0,0,1,1,5
SFATQ,0,0,0,1,1,5
FATQV,0,0,0,1,1,5
ATQVQ,0,0,0,1,1,5
TQVQN,0,0,0,1,1,5
QVQNM,0,0,0,1,1,5
SLESL,0,0,0,1,1,5
LESLI,0,0,0,1,1,5
ESLID,0,0,0,1,1,5
SLIDM,0,0,0,1,1,5
LIDMI,0,0,0,1,1,5
IDMIT,0,0,0,1,1,5
DMITS,0,0,0,1,1,5
MITSI,0,0,0,1,1,5
SLKDQ,0,0,0,1,1,5
LKDQL,0,0,0,1,1,5
KDQLA,0,0,0,1,1,5
DQLAL,0,0,0,1,1,5
QLALA,0,0,0,1,1,5
LALAI,0,0,0,1,1,5
ALAIG,0,0,0,1,1,5
LAIGK,0,0,0,1,1,5
AIGKL,0,0,0,1,1,5
IGKLG,0,0,0,1,1,5
SLLPT,0,0,0,1,1,5
LLPTL,0,0,0,1,1,5
LPTLS,0,0,0,1,1,5
PTLSA,0,0,0,1,1,5
TLSAI,0,0,0,1,1,5
LSAIA,0,0,0,1,1,5
SAIAE,0,0,0,1,1,5
AIAEL,0,0,0,1,1,5
SLPEM,0,0,0,1,1,5
LPEMF,0,0,0,1,1,5
PEMFD,0,0,0,1,1,5
EMFDK,0,0,0,1,1,5
MFDKM,0,0,0,1,1,5
FDKMR,0,0,0,1,1,5
DKMRP,0,0,0,1,1,5
KMRPY,0,0,0,1,1,5
MRPYY,0,0,0,1,1,5
RPYYE,0,0,0,1,1,5
PYYEE,0,0,0,1,1,5
YYEES,0,0,0,1,1,5
YEESK,0,0,0,1,1,5
EESKK,0,0,0,1,1,5
ESKKR,0,0,0,1,1,5
SKKRV,0,0,0,1,1,5
KKRVK,0,0,0,1,1,5
KRVKE,0,0,0,1,1,5
SMDHR,0,0,0,1,1,5
MDHRI,0,0,0,1,1,5
DHRIE,0,0,0,1,1,5
HRIER,0,0,0,1,1,5
RIERL,0,0,0,1,1,5
IERLE,0,0,0,1,1,5
ERLEY,0,0,0,1,1,5
RLEYY,0,0,0,1,1,5
LEYYI,0,0,0,1,1,5
EYYIQ,0,0,0,1,1,5
YYIQL,0,0,0,1,1,5
IQLLV,0,0,0,1,1,5
QLLVK,0,0,0,1,1,5
SNEQR,0,0,0,1,1,5
NEQRQ,0,0,0,1,1,5
EQRQD,0,0,0,1,1,5
QRQDI,0,0,0,1,1,5
RQDIA,0,0,0,1,1,5
QDIAF,0,0,0,1,1,5
DIAFA,0,0,0,1,1,5
IAFAY,0,0,0,1,1,5
AFAYQ,0,0,0,1,1,5
FAYQR,0,0,0,1,1,5
AYQRR,0,0,0,1,1,5
YQRRT,0,0,0,1,1,5
QRRTK,0,0,0,1,1,5
SNEVM,0,0,0,1,1,5
NEVMR,0,0,0,1,1,5
EVMRI,0,0,0,1,1,5
VMRIL,0,0,0,1,1,5
MRILI,0,0,0,1,1,5
RILIS,0,0,0,1,1,5
ILISR,0,0,0,1,1,5
LISRS,0,0,0,1,1,5
ISRSL,0,0,0,1,1,5
SRSLL,0,0,0,1,1,5
RSLLQ,0,0,0,1,1,5
SLLQE,0,0,0,1,1,5
SNTEL,0,0,0,1,1,5
NTELQ,0,0,0,1,1,5
TELQA,0,0,0,1,1,5
ELQAV,0,0,0,1,1,5
LQAVD,0,0,0,1,1,5
QAVDG,0,0,0,1,1,5
AVDGR,0,0,0,1,1,5
VDGRF,0,0,0,1,1,5
DGRFK,0,0,0,1,1,5
GRFKR,0,0,0,1,1,5
RFKRA,0,0,0,1,1,5
FKRAV,0,0,0,1,1,5
KRAVA,0,0,0,1,1,5
RAVAS,0,0,0,1,1,5
AVASM,0,0,0,1,1,5
VASME,0,0,0,1,1,5
ASMEA,0,0,0,1,1,5
SMEAA,0,0,0,1,1,5
MEAAR,0,0,0,1,1,5
EAARA,0,0,0,1,1,5
AARAL,0,0,0,1,1,5
ARALT,0,0,0,1,1,5
RALTN,0,0,0,1,1,5
ALTNN,0,0,0,1,1,5
SPAEV,0,0,0,1,1,5
PAEVR,0,0,0,1,1,5
AEVRD,0,0,0,1,1,5
EVRDL,0,0,0,1,1,5
VRDLD,0,0,0,1,1,5
RDLDF,0,0,0,1,1,5
DLDFA,0,0,0,1,1,5
LDFAN,0,0,0,1,1,5
DFAND,0,0,0,1,1,5
FANDA,0,0,0,1,1,5
ANDAS,0,0,0,1,1,5
NDASK,0,0,0,1,1,5
DASKV,0,0,0,1,1,5
ASKVL,0,0,0,1,1,5
SKVLG,0,0,0,1,1,5
KVLGS,0,0,0,1,1,5
VLGSI,0,0,0,1,1,5
LGSIA,0,0,0,1,1,5
GSIAG,0,0,0,1,1,5
SIAGK,0,0,0,1,1,5
IAGKL,0,0,0,1,1,5
AGKLE,0,0,0,1,1,5
GKLEK,0,0,0,1,1,5
SPAQA,0,0,0,1,1,5
PAQAE,0,0,0,1,1,5
AQAEA,0,0,0,1,1,5
QAEAL,0,0,0,1,1,5
EALGV,0,0,0,1,1,5
ALGVW,0,0,0,1,1,5
LGVWR,0,0,0,1,1,5
GVWRR,0,0,0,1,1,5
VWRRY,0,0,0,1,1,5
WRRYR,0,0,0,1,1,5
RRYRA,0,0,0,1,1,5
RYRAY,0,0,0,1,1,5
YRAYF,0,0,0,1,1,5
RAYFD,0,0,0,1,1,5
AYFDA,0,0,0,1,1,5
SPAVI,0,0,0,1,1,5
PAVID,0,0,0,1,1,5
AVIDY,0,0,0,1,1,5
VIDYV,0,0,0,1,1,5
IDYVN,0,0,0,1,1,5
DYVNR,0,0,0,1,1,5
YVNRL,0,0,0,1,1,5
VNRLE,0,0,0,1,1,5
NRLEE,0,0,0,1,1,5
RLEEI,0,0,0,1,1,5
LEEIR,0,0,0,1,1,5
EEIRD,0,0,0,1,1,5
EIRDN,0,0,0,1,1,5
IRDNV,0,0,0,1,1,5
SPAVQ,0,0,0,1,1,5
PAVQM,0,0,0,1,1,5
AVQMK,0,0,0,1,1,5
VQMKI,0,0,0,1,1,5
QMKIK,0,0,0,1,1,5
MKIKE,0,0,0,1,1,5
IKELY,0,0,0,1,1,5
KELYR,0,0,0,1,1,5
ELYRR,0,0,0,1,1,5
LYRRR,0,0,0,1,1,5
SPEEA,0,0,0,1,1,5
PEEAA,0,0,0,1,1,5
EEAAA,0,0,0,1,1,5
EAAAL,0,0,0,1,1,5
AAALV,0,0,0,1,1,5
AALVD,0,0,0,1,1,5
ALVDG,0,0,0,1,1,5
LVDGL,0,0,0,1,1,5
VDGLR,0,0,0,1,1,5
SPEEK,0,0,0,1,1,5
PEEKE,0,0,0,1,1,5
EEKEE,0,0,0,1,1,5
EKEEW,0,0,0,1,1,5
KEEWM,0,0,0,1,1,5
EEWMK,0,0,0,1,1,5
EWMKS,0,0,0,1,1,5
WMKSI,0,0,0,1,1,5
MKSIK,0,0,0,1,1,5
KSIKA,0,0,0,1,1,5
SIKAS,0,0,0,1,1,5
IKASI,0,0,0,1,1,5
KASIS,0,0,0,1,1,5
ASISR,0,0,0,1,1,5
SPEHR,0,0,0,1,1,5
PEHRQ,0,0,0,1,1,5
EHRQE,0,0,0,1,1,5
HRQEL,0,0,0,1,1,5
RQELI,0,0,0,1,1,5
QELIE,0,0,0,1,1,5
ELIER,0,0,0,1,1,5
SPEIA,0,0,0,1,1,5
PEIAS,0,0,0,1,1,5
EIASG,0,0,0,1,1,5
IASGL,0,0,0,1,1,5
ASGLK,0,0,0,1,1,5
SGLKK,0,0,0,1,1,5
GLKKL,0,0,0,1,1,5
KKLIR,0,0,0,1,1,5
KLIRE,0,0,0,1,1,5
SPEQM,0,0,0,1,1,5
PEQMQ,0,0,0,1,1,5
EQMQV,0,0,0,1,1,5
QMQVL,0,0,0,1,1,5
MQVLL,0,0,0,1,1,5
QVLLD,0,0,0,1,1,5
VLLDQ,0,0,0,1,1,5
LLDQA,0,0,0,1,1,5
LDQAG,0,0,0,1,1,5
SPEVV,0,0,0,1,1,5
PEVVV,0,0,0,1,1,5
EVVVA,0,0,0,1,1,5
VVVAR,0,0,0,1,1,5
VVARG,0,0,0,1,1,5
VARGE,0,0,0,1,1,5
ARGEQ,0,0,0,1,1,5
RGEQE,0,0,0,1,1,5
SPKEA,0,0,0,1,1,5
PKEAY,0,0,0,1,1,5
KEAYA,0,0,0,1,1,5
EAYAY,0,0,0,1,1,5
AYAYL,0,0,0,1,1,5
YAYLE,0,0,0,1,1,5
AYLEK,0,0,0,1,1,5
YLEKL,0,0,0,1,1,5
LEKLR,0,0,0,1,1,5
EKLRS,0,0,0,1,1,5
KLRSI,0,0,0,1,1,5
LRSII,0,0,0,1,1,5
RSIIQ,0,0,0,1,1,5
SIIQY,0,0,0,1,1,5
IIQYT,0,0,0,1,1,5
IQYTG,0,0,0,1,1,5
SPKES,0,0,0,1,1,5
PKESE,0,0,0,1,1,5
KESEV,0,0,0,1,1,5
ESEVL,0,0,0,1,1,5
SEVLR,0,0,0,1,1,5
EVLRL,0,0,0,1,1,5
VLRLF,0,0,0,1,1,5
LRLFA,0,0,0,1,1,5
RLFAE,0,0,0,1,1,5
LFAEG,0,0,0,1,1,5
SPKST,0,0,0,1,1,5
PKSTY,0,0,0,1,1,5
KSTYS,0,0,0,1,1,5
STYSY,0,0,0,1,1,5
TYSYW,0,0,0,1,1,5
YSYWA,0,0,0,1,1,5
SYWAS,0,0,0,1,1,5
YWASV,0,0,0,1,1,5
WASVL,0,0,0,1,1,5
ASVLN,0,0,0,1,1,5
SPSKS,0,0,0,1,1,5
PSKSL,0,0,0,1,1,5
SKSLQ,0,0,0,1,1,5
KSLQM,0,0,0,1,1,5
SLQMI,0,0,0,1,1,5
LQMIL,0,0,0,1,1,5
QMILR,0,0,0,1,1,5
MILRR,0,0,0,1,1,5
ILRRA,0,0,0,1,1,5
LRRAL,0,0,0,1,1,5
RRALG,0,0,0,1,1,5
RALGD,0,0,0,1,1,5
ALGDF,0,0,0,1,1,5
LGDFE,0,0,0,1,1,5
GDFEN,0,0,0,1,1,5
DFENM,0,0,0,1,1,5
FENML,0,0,0,1,1,5
ENMLA,0,0,0,1,1,5
NMLAD,0,0,0,1,1,5
SPVVI,0,0,0,1,1,5
PVVIK,0,0,0,1,1,5
VVIKK,0,0,0,1,1,5
VIKKR,0,0,0,1,1,5
IKKRI,0,0,0,1,1,5
KKRIE,0,0,0,1,1,5
KRIEG,0,0,0,1,1,5
RIEGL,0,0,0,1,1,5
IEGLI,0,0,0,1,1,5
EGLIE,0,0,0,1,1,5
GLIER,0,0,0,1,1,5
SQESI,0,0,0,1,1,5
QESIN,0,0,0,1,1,5
ESINQ,0,0,0,1,1,5
SINQL,0,0,0,1,1,5
INQLV,0,0,0,1,1,5
NQLVY,0,0,0,1,1,5
QLVYM,0,0,0,1,1,5
LVYMG,0,0,0,1,1,5
SQRQR,0,0,0,1,1,5
QRQRD,0,0,0,1,1,5
RQRDE,0,0,0,1,1,5
QRDEL,0,0,0,1,1,5
RDELN,0,0,0,1,1,5
DELNR,0,0,0,1,1,5
ELNRA,0,0,0,1,1,5
LNRAI,0,0,0,1,1,5
NRAIA,0,0,0,1,1,5
RAIAD,0,0,0,1,1,5
AIADY,0,0,0,1,1,5
IADYL,0,0,0,1,1,5
ADYLR,0,0,0,1,1,5
DYLRS,0,0,0,1,1,5
YLRSN,0,0,0,1,1,5
SRAIT,0,0,0,1,1,5
RAITQ,0,0,0,1,1,5
AITQY,0,0,0,1,1,5
ITQYI,0,0,0,1,1,5
TQYIA,0,0,0,1,1,5
QYIAH,0,0,0,1,1,5
YIAHR,0,0,0,1,1,5
SRAKA,0,0,0,1,1,5
RAKAS,0,0,0,1,1,5
AKASF,0,0,0,1,1,5
KASFD,0,0,0,1,1,5
ASFDT,0,0,0,1,1,5
SFDTR,0,0,0,1,1,5
FDTRV,0,0,0,1,1,5
DTRVA,0,0,0,1,1,5
TRVAA,0,0,0,1,1,5
RVAAA,0,0,0,1,1,5
VAAAE,0,0,0,1,1,5
AAAEL,0,0,0,1,1,5
AAELA,0,0,0,1,1,5
AELAL,0,0,0,1,1,5
ELALN,0,0,0,1,1,5
LALNR,0,0,0,1,1,5
SRDLQ,0,0,0,1,1,5
RDLQE,0,0,0,1,1,5
DLQEK,0,0,0,1,1,5
LQEKY,0,0,0,1,1,5
QEKYE,0,0,0,1,1,5
EKYER,0,0,0,1,1,5
KYERH,0,0,0,1,1,5
YERHM,0,0,0,1,1,5
ERHME,0,0,0,1,1,5
RHMEK,0,0,0,1,1,5
HMEKL,0,0,0,1,1,5
MEKLI,0,0,0,1,1,5
EKLIE,0,0,0,1,1,5
KLIEL,0,0,0,1,1,5
LIELA,0,0,0,1,1,5
IELAN,0,0,0,1,1,5
ELANK,0,0,0,1,1,5
LANKE,0,0,0,1,1,5
ANKEV,0,0,0,1,1,5
NKEVE,0,0,0,1,1,5
KEVER,0,0,0,1,1,5
EVERT,0,0,0,1,1,5
SRKAL,0,0,0,1,1,5
RKALT,0,0,0,1,1,5
KALTE,0,0,0,1,1,5
ALTEG,0,0,0,1,1,5
LTEGN,0,0,0,1,1,5
TEGNI,0,0,0,1,1,5
EGNIM,0,0,0,1,1,5
GNIMA,0,0,0,1,1,5
NIMAV,0,0,0,1,1,5
IMAVQ,0,0,0,1,1,5
MAVQA,0,0,0,1,1,5
AVQAM,0,0,0,1,1,5
VQAMA,0,0,0,1,1,5
QAMAY,0,0,0,1,1,5
AMAYF,0,0,0,1,1,5
MAYFK,0,0,0,1,1,5
AYFKE,0,0,0,1,1,5
YFKEL,0,0,0,1,1,5
FKELI,0,0,0,1,1,5
KELIQ,0,0,0,1,1,5
ELIQK,0,0,0,1,1,5
LIQKR,0,0,0,1,1,5
IQKRK,0,0,0,1,1,5
QKRKR,0,0,0,1,1,5
KRKRH,0,0,0,1,1,5
SRPLH,0,0,0,1,1,5
RPLHI,0,0,0,1,1,5
PLHIS,0,0,0,1,1,5
LHIST,0,0,0,1,1,5
HISTF,0,0,0,1,1,5
ISTFI,0,0,0,1,1,5
STFIN,0,0,0,1,1,5
TFINE,0,0,0,1,1,5
FINEL,0,0,0,1,1,5
INELD,0,0,0,1,1,5
NELDS,0,0,0,1,1,5
ELDSG,0,0,0,1,1,5
LDSGF,0,0,0,1,1,5
DSGFR,0,0,0,1,1,5
SGFRL,0,0,0,1,1,5
GFRLL,0,0,0,1,1,5
SRWGV,0,0,0,1,1,5
RWGVL,0,0,0,1,1,5
WGVLI,0,0,0,1,1,5
GVLIL,0,0,0,1,1,5
VLILV,0,0,0,1,1,5
LILVA,0,0,0,1,1,5
ILVAL,0,0,0,1,1,5
SSAVS,0,0,0,1,1,5
SAVSR,0,0,0,1,1,5
AVSRI,0,0,0,1,1,5
VSRII,0,0,0,1,1,5
RIISK,0,0,0,1,1,5
IISKL,0,0,0,1,1,5
ISKLK,0,0,0,1,1,5
SKLKQ,0,0,0,1,1,5
SSQNW,0,0,0,1,1,5
SQNWQ,0,0,0,1,1,5
QNWQR,0,0,0,1,1,5
NWQRF,0,0,0,1,1,5
WQRFY,0,0,0,1,1,5
QRFYQ,0,0,0,1,1,5
RFYQL,0,0,0,1,1,5
FYQLT,0,0,0,1,1,5
YQLTK,0,0,0,1,1,5
QLTKL,0,0,0,1,1,5
LTKLL,0,0,0,1,1,5
TKLLD,0,0,0,1,1,5
KLLDS,0,0,0,1,1,5
LLDSM,0,0,0,1,1,5
LDSMH,0,0,0,1,1,5
DSMHE,0,0,0,1,1,5
SMHEV,0,0,0,1,1,5
MHEVV,0,0,0,1,1,5
HEVVE,0,0,0,1,1,5
EVVEN,0,0,0,1,1,5
VVENL,0,0,0,1,1,5
VENLL,0,0,0,1,1,5
SSREW,0,0,0,1,1,5
SREWF,0,0,0,1,1,5
REWFS,0,0,0,1,1,5
EWFST,0,0,0,1,1,5
WFSTL,0,0,0,1,1,5
STLYR,0,0,0,1,1,5
TLYRL,0,0,0,1,1,5
LYRLF,0,0,0,1,1,5
YRLFI,0,0,0,1,1,5
RLFIG,0,0,0,1,1,5
STATF,0,0,0,1,1,5
TATFY,0,0,0,1,1,5
ATFYD,0,0,0,1,1,5
TFYDA,0,0,0,1,1,5
FYDAK,0,0,0,1,1,5
YDAKK,0,0,0,1,1,5
DAKKF,0,0,0,1,1,5
AKKFL,0,0,0,1,1,5
KKFLI,0,0,0,1,1,5
KFLIQ,0,0,0,1,1,5
FLIQE,0,0,0,1,1,5
STEVV,0,0,0,1,1,5
TEVVA,0,0,0,1,1,5
EVVAL,0,0,0,1,1,5
VVALS,0,0,0,1,1,5
VALSR,0,0,0,1,1,5
ALSRL,0,0,0,1,1,5
LSRLQ,0,0,0,1,1,5
SRLQG,0,0,0,1,1,5
RLQGS,0,0,0,1,1,5
LQGSL,0,0,0,1,1,5
QGSLQ,0,0,0,1,1,5
GSLQD,0,0,0,1,1,5
SLQDM,0,0,0,1,1,5
LQDML,0,0,0,1,1,5
QDMLW,0,0,0,1,1,5
DMLWQ,0,0,0,1,1,5
MLWQL,0,0,0,1,1,5
LWQLD,0,0,0,1,1,5
WQLDL,0,0,0,1,1,5
QLDLS,0,0,0,1,1,5
STLVQ,0,0,0,1,1,5
TLVQT,0,0,0,1,1,5
LVQTP,0,0,0,1,1,5
VQTPA,0,0,0,1,1,5
QTPAL,0,0,0,1,1,5
TPALR,0,0,0,1,1,5
PALRA,0,0,0,1,1,5
ALRAV,0,0,0,1,1,5
LRAVG,0,0,0,1,1,5
RAVGN,0,0,0,1,1,5
AVGNI,0,0,0,1,1,5
VGNIV,0,0,0,1,1,5
STLVS,0,0,0,1,1,5
TLVSV,0,0,0,1,1,5
LVSVA,0,0,0,1,1,5
VSVAV,0,0,0,1,1,5
SVAVA,0,0,0,1,1,5
VAVAL,0,0,0,1,1,5
AVALA,0,0,0,1,1,5
VALAA,0,0,0,1,1,5
ALAAY,0,0,0,2,2,5
LAAYK,0,0,0,1,1,5
AAYKT,0,0,0,1,1,5
AYKTG,0,0,0,1,1,5
SVADH,0,0,0,1,1,5
VADHS,0,0,0,1,1,5
ADHSY,0,0,0,1,1,5
DHSYR,0,0,0,1,1,5
HSYRV,0,0,0,1,1,5
SYRVA,0,0,0,1,1,5
YRVAF,0,0,0,1,1,5
RVAFI,0,0,0,1,1,5
VAFIT,0,0,0,1,1,5
AFITL,0,0,0,1,1,5
FITLL,0,0,0,1,1,5
ITLLL,0,0,0,1,1,5
TLLLA,0,0,0,1,1,5
LLLAE,0,0,0,1,1,5
LLAEE,0,0,0,1,1,5
LAEEL,0,0,0,1,1,5
EELKK,0,0,0,1,1,5
SVEGL,0,0,0,1,1,5
VEGLQ,0,0,0,1,1,5
EGLQE,0,0,0,1,1,5
GLQEF,0,0,0,1,1,5
LQEFV,0,0,0,1,1,5
QEFVK,0,0,0,1,1,5
EFVKN,0,0,0,1,1,5
FVKNL,0,0,0,1,1,5
VKNLV,0,0,0,1,1,5
KNLVG,0,0,0,1,1,5
NLVGY,0,0,0,1,1,5
LVGYY,0,0,0,1,1,5
VGYYI,0,0,0,1,1,5
SVEKK,0,0,0,1,1,5
VEKKV,0,0,0,1,1,5
EKKVP,0,0,0,1,1,5
KKVPL,0,0,0,1,1,5
KVPLL,0,0,0,1,1,5
VPLLH,0,0,0,1,1,5
PLLHN,0,0,0,1,1,5
LLHNF,0,0,0,1,1,5
HNFHS,0,0,0,1,1,5
NFHSF,0,0,0,1,1,5
FHSFL,0,0,0,1,1,5
SVEVA,0,0,0,1,1,5
VEVAE,0,0,0,1,1,5
EVAEL,0,0,0,1,1,5
VAELW,0,0,0,1,1,5
AELWS,0,0,0,1,1,5
ELWST,0,0,0,1,1,5
LWSTF,0,0,0,1,1,5
WSTFM,0,0,0,1,1,5
STFMQ,0,0,0,1,1,5
TFMQK,0,0,0,1,1,5
FMQKW,0,0,0,1,1,5
MQKWI,0,0,0,1,1,5
QKWIA,0,0,0,1,1,5
KWIAY,0,0,0,1,1,5
WIAYT,0,0,0,1,1,5
IAYTA,0,0,0,1,1,5
AYTAA,0,0,0,1,1,5
YTAAV,0,0,0,1,1,5
TAAVI,0,0,0,1,1,5
AAVID,0,0,0,1,1,5
AVIDA,0,0,0,1,1,5
VIDAE,0,0,0,1,1,5
IDAER,0,0,0,1,1,5
DAERD,0,0,0,1,1,5
AERDR,0,0,0,1,1,5
SVLEN,0,0,0,1,1,5
VLENH,0,0,0,1,1,5
LENHH,0,0,0,1,1,5
ENHHL,0,0,0,1,1,5
NHHLA,0,0,0,1,1,5
HHLAV,0,0,0,1,1,5
HLAVG,0,0,0,1,1,5
LAVGF,0,0,0,1,1,5
AVGFK,0,0,0,1,1,5
VGFKL,0,0,0,1,1,5
SVNSE,0,0,0,1,1,5
VNSEI,0,0,0,1,1,5
NSEIY,0,0,0,1,1,5
SEIYQ,0,0,0,1,1,5
EIYQR,0,0,0,1,1,5
IYQRV,0,0,0,1,1,5
YQRVM,0,0,0,1,1,5
QRVME,0,0,0,1,1,5
RVMES,0,0,0,1,1,5
VMESF,0,0,0,1,1,5
MESFK,0,0,0,1,1,5
ESFKK,0,0,0,1,1,5
SFKKE,0,0,0,1,1,5
FKKEG,0,0,0,1,1,5
SVPYF,0,0,0,1,1,5
VPYFI,0,0,0,1,1,5
PYFIE,0,0,0,1,1,5
YFIEN,0,0,0,1,1,5
FIENL,0,0,0,1,1,5
IENLK,0,0,0,1,1,5
ENLKQ,0,0,0,1,1,5
NLKQH,0,0,0,1,1,5
LKQHI,0,0,0,1,1,5
KQHIE,0,0,0,1,1,5
QHIEM,0,0,0,1,1,5
HIEMN,0,0,0,1,1,5
SVRKV,0,0,0,1,1,5
VRKVF,0,0,0,1,1,5
RKVFH,0,0,0,1,1,5
KVFHL,0,0,0,1,1,5
VFHLV,0,0,0,1,1,5
FHLVR,0,0,0,1,1,5
HLVRI,0,0,0,1,1,5
LVRIK,0,0,0,1,1,5
VRIKQ,0,0,0,1,1,5
RIKQV,0,0,0,1,1,5
IKQVA,0,0,0,1,1,5
KQVAW,0,0,0,1,1,5
QVAWA,0,0,0,1,1,5
VAWAN,0,0,0,1,1,5
AWANE,0,0,0,1,1,5
WANEG,0,0,0,1,1,5
SVSRA,0,0,0,1,1,5
VSRAA,0,0,0,1,1,5
SRAAI,0,0,0,1,1,5
RAAIT,0,0,0,1,1,5
AAITA,0,0,0,1,1,5
AITAA,0,0,0,1,1,5
ITAAY,0,0,0,1,1,5
SVSSI,0,0,0,1,1,5
VSSIK,0,0,0,1,1,5
SSIKQ,0,0,0,1,1,5
SIKQA,0,0,0,1,1,5
IKQAV,0,0,0,1,1,5
KQAVD,0,0,0,1,1,5
QAVDF,0,0,0,1,1,5
AVDFL,0,0,0,1,1,5
DFLSN,0,0,0,1,1,5
FLSNE,0,0,0,1,1,5
SVTEL,0,0,0,1,1,5
VTELI,0,0,0,1,1,5
TELIT,0,0,0,1,1,5
ELITK,0,0,0,1,1,5
LITKA,0,0,0,1,1,5
ITKAV,0,0,0,1,1,5
TKAVS,0,0,0,1,1,5
KAVSA,0,0,0,1,1,5
SVTKI,0,0,0,1,1,5
VTKIL,0,0,0,1,1,5
TKILQ,0,0,0,1,1,5
KILQR,0,0,0,1,1,5
ILQRF,0,0,0,1,1,5
LQRFE,0,0,0,1,1,5
QRFED,0,0,0,1,1,5
RFEDA,0,0,0,1,1,5
FEDAG,0,0,0,1,1,5
EDAGG,0,0,0,1,1,5
SVWAS,0,0,0,1,1,5
VWASI,0,0,0,1,1,5
WASIS,0,0,0,1,1,5
ASISS,0,0,0,1,1,5
SISSY,0,0,0,1,1,5
ISSYL,0,0,0,1,1,5
SSYLD,0,0,0,1,1,5
SYLDE,0,0,0,1,1,5
YLDEL,0,0,0,1,1,5
LDELT,0,0,0,1,1,5
DELTE,0,0,0,1,1,5
ELTEG,0,0,0,1,1,5
LTEGL,0,0,0,1,1,5
SWQSL,0,0,0,1,1,5
WQSLK,0,0,0,1,1,5
QSLKD,0,0,0,1,1,5
SLKDR,0,0,0,1,1,5
LKDRY,0,0,0,1,1,5
KDRYL,0,0,0,1,1,5
DRYLK,0,0,0,1,1,5
RYLKH,0,0,0,1,1,5
YLKHL,0,0,0,1,1,5
SYKDL,0,0,0,1,1,5
YKDLF,0,0,0,1,1,5
KDLFL,0,0,0,1,1,5
DLFLE,0,0,0,1,1,5
LFLEL,0,0,0,1,1,5
FLELY,0,0,0,1,1,5
LELYG,0,0,0,1,1,5
LYGKI,0,0,0,1,1,5
YGKIK,0,0,0,1,1,5
GKIKD,0,0,0,1,1,5
TAAQE,0,0,0,1,1,5
AAQEL,0,0,0,1,1,5
AQELM,0,0,0,1,1,5
QELMI,0,0,0,1,1,5
ELMIQ,0,0,0,1,1,5
LMIQQ,0,0,0,1,1,5
MIQQL,0,0,0,1,1,5
IQQLV,0,0,0,1,1,5
QQLVA,0,0,0,1,1,5
QLVAA,0,0,0,1,1,5
LVAAQ,0,0,0,1,1,5
VAAQL,0,0,0,1,1,5
AAQLQ,0,0,0,1,1,5
TAEQR,0,0,0,1,1,5
AEQRR,0,0,0,1,1,5
EQRRE,0,0,0,1,1,5
QRREM,0,0,0,1,1,5
RREML,0,0,0,1,1,5
REMLE,0,0,0,1,1,5
EMLEA,0,0,0,1,1,5
MLEAK,0,0,0,1,1,5
LEAKR,0,0,0,1,1,5
EAKRK,0,0,0,1,1,5
AKRKQ,0,0,0,1,1,5
KRKQI,0,0,0,1,1,5
RKQII,0,0,0,1,1,5
KQIIN,0,0,0,1,1,5
QIINF,0,0,0,1,1,5
IINFI,0,0,0,1,1,5
INFIS,0,0,0,1,1,5
NFISR,0,0,0,1,1,5
FISRN,0,0,0,1,1,5
TAESF,0,0,0,1,1,5
AESFY,0,0,0,1,1,5
ESFYN,0,0,0,1,1,5
SFYNQ,0,0,0,1,1,5
FYNQG,0,0,0,1,1,5
YNQGI,0,0,0,1,1,5
NQGIR,0,0,0,1,1,5
QGIRL,0,0,0,1,1,5
GIRLS,0,0,0,1,1,5
IRLSF,0,0,0,1,1,5
RLSFE,0,0,0,1,1,5
LSFEQ,0,0,0,1,1,5
SFEQW,0,0,0,1,1,5
FEQWG,0,0,0,1,1,5
TAHEA,0,0,0,1,1,5
AHEAV,0,0,0,1,1,5
HEAVL,0,0,0,1,1,5
EAVLD,0,0,0,1,1,5
AVLDF,0,0,0,1,1,5
VLDFL,0,0,0,1,1,5
LDFLT,0,0,0,1,1,5
DFLTG,0,0,0,1,1,5
FLTGR,0,0,0,1,1,5
LTGRV,0,0,0,1,1,5
TGRVE,0,0,0,1,1,5
GRVEV,0,0,0,1,1,5
RVEVF,0,0,0,1,1,5
VEVFT,0,0,0,1,1,5
TAKQI,0,0,0,1,1,5
AKQIQ,0,0,0,2,2,5
KQIQA,0,0,0,1,1,5
QIQAA,0,0,0,1,1,5
IQAAY,0,0,0,1,1,5
QAAYL,0,0,0,1,1,5
AAYLL,0,0,0,1,1,5
AYLLV,0,0,0,1,1,5
YLLVE,0,0,0,1,1,5
LLVEN,0,0,0,1,1,5
LVENE,0,0,0,1,1,5
VENEL,0,0,0,1,1,5
ENELM,0,0,0,1,1,5
TAPEM,0,0,0,1,1,5
APEMT,0,0,0,1,1,5
PEMTA,0,0,0,1,1,5
EMTAL,0,0,0,1,1,5
MTALV,0,0,0,1,1,5
TALVG,0,0,0,1,1,5
ALVGG,0,0,0,1,1,5
LVGGM,0,0,0,1,1,5
VGGMR,0,0,0,1,1,5
GGMRV,0,0,0,1,1,5
GMRVL,0,0,0,1,1,5
MRVLG,0,0,0,1,1,5
TDAEA,0,0,0,1,1,5
DAEAK,0,0,0,1,1,5
AEAKQ,0,0,0,1,1,5
EAKQL,0,0,0,1,1,5
AKQLA,0,0,0,1,1,5
KQLAQ,0,0,0,1,1,5
QLAQW,0,0,0,1,1,5
LAQWI,0,0,0,1,1,5
AQWIL,0,0,0,1,1,5
QWILS,0,0,0,1,1,5
TDKQF,0,0,0,1,1,5
DKQFE,0,0,0,1,1,5
KQFEN,0,0,0,1,1,5
QFENR,0,0,0,1,1,5
FENRL,0,0,0,1,1,5
ENRLN,0,0,0,1,1,5
NRLND,0,0,0,1,1,5
RLNDN,0,0,0,1,1,5
LNDNL,0,0,0,1,1,5
NDNLE,0,0,0,1,1,5
DNLEE,0,0,0,1,1,5
NLEEL,0,0,0,1,1,5
LEELI,0,0,0,1,1,5
EELIQ,0,0,0,1,1,5
TDLEI,0,0,0,1,1,5
DLEIL,0,0,0,1,1,5
LEILA,0,0,0,1,1,5
EILAL,0,0,0,1,1,5
ILALL,0,0,0,1,1,5
LALLI,0,0,0,1,1,5
ALLIA,0,0,0,1,1,5
LLIAA,0,0,0,1,1,5
LIAAL,0,0,0,1,1,5
IAALS,0,0,0,1,1,5
AALSH,0,0,0,1,1,5
TDQQK,0,0,0,1,1,5
DQQKV,0,0,0,1,1,5
QQKVS,0,0,0,1,1,5
QKVSE,0,0,0,1,1,5
KVSEI,0,0,0,1,1,5
VSEIF,0,0,0,1,1,5
SEIFQ,0,0,0,1,1,5
EIFQS,0,0,0,1,1,5
IFQSS,0,0,0,1,1,5
FQSSK,0,0,0,1,1,5
QSSKE,0,0,0,1,1,5
SSKEK,0,0,0,1,1,5
SKEKL,0,0,0,1,1,5
KEKLQ,0,0,0,1,1,5
EKLQG,0,0,0,1,1,5
KLQGD,0,0,0,1,1,5
LQGDA,0,0,0,1,1,5
QGDAK,0,0,0,1,1,5
GDAKV,0,0,0,1,1,5
DAKVV,0,0,0,1,1,5
AKVVS,0,0,0,1,1,5
KVVSD,0,0,0,1,1,5
VVSDA,0,0,0,1,1,5
VSDAF,0,0,0,1,1,5
SDAFK,0,0,0,1,1,5
TEAKK,0,0,0,1,1,5
EAKKE,0,0,0,1,1,5
AKKEE,0,0,0,1,1,5
KEELL,0,0,0,1,1,5
EELLR,0,0,0,1,1,5
ELLRK,0,0,0,1,1,5
LLRKL,0,0,0,1,1,5
LRKLN,0,0,0,1,1,5
RKLNI,0,0,0,1,1,5
KLNIL,0,0,0,1,1,5
LNILE,0,0,0,1,1,5
NILEV,0,0,0,1,1,5
ILEVF,0,0,0,1,1,5
TEEEM,0,0,0,1,1,5
EEEML,0,0,0,1,1,5
EEMLQ,0,0,0,1,1,5
EMLQA,0,0,0,1,1,5
MLQAA,0,0,0,1,1,5
LQAAH,0,0,0,1,1,5
QAAHI,0,0,0,1,1,5
AAHIT,0,0,0,1,1,5
AHITA,0,0,0,1,1,5
HITAK,0,0,0,1,1,5
ITAKL,0,0,0,1,1,5
TAKLA,0,0,0,1,1,5
AKLAQ,0,0,0,1,1,5
KLAQA,0,0,0,1,1,5
LAQAA,0,0,0,1,1,5
AQAAE,0,0,0,1,1,5
QAAET,0,0,0,1,1,5
TEKGK,0,0,0,1,1,5
EKGKE,0,0,0,1,1,5
KGKEI,0,0,0,1,1,5
GKEIF,0,0,0,1,1,5
KEIFG,0,0,0,1,1,5
EIFGE,0,0,0,1,1,5
IFGEI,0,0,0,1,1,5
FGEIL,0,0,0,1,1,5
GEILS,0,0,0,1,1,5
EILSN,0,0,0,1,1,5
ILSNF,0,0,0,1,1,5
LSNFE,0,0,0,1,1,5
SNFES,0,0,0,1,1,5
NFESL,0,0,0,1,1,5
FESLL,0,0,0,1,1,5
ESLLK,0,0,0,1,1,5
LLKSV,0,0,0,1,1,5
LKSVL,0,0,0,1,1,5
KSVLE,0,0,0,1,1,5
SVLEK,0,0,0,1,1,5
TEQDI,0,0,0,1,1,5
EQDII,0,0,0,1,1,5
QDIID,0,0,0,1,1,5
DIIDL,0,0,0,1,1,5
IIDLK,0,0,0,1,1,5
IDLKF,0,0,0,1,1,5
DLKFA,0,0,0,1,1,5
LKFAI,0,0,0,1,1,5
KFAIA,0,0,0,1,1,5
FAIAD,0,0,0,1,1,5
TEQNF,0,0,0,1,1,5
EQNFQ,0,0,0,1,1,5
QNFQL,0,0,0,1,1,5
NFQLA,0,0,0,1,1,5
FQLAK,0,0,0,1,1,5
QLAKQ,0,0,0,1,1,5
LAKQI,0,0,0,1,1,5
KQIQS,0,0,0,1,1,5
QIQSQ,0,0,0,1,1,5
IQSQW,0,0,0,1,1,5
QSQWK,0,0,0,1,1,5
SQWKE,0,0,0,1,1,5
QWKEF,0,0,0,1,1,5
WKEFG,0,0,0,1,1,5
TEREQ,0,0,0,1,1,5
EREQA,0,0,0,1,1,5
REQAL,0,0,0,1,1,5
EQALA,0,0,0,1,1,5
QALAA,0,0,0,1,1,5
LAAYA,0,0,0,1,1,5
AAYAE,0,0,0,1,1,5
AYAEK,0,0,0,1,1,5
YAEKL,0,0,0,1,1,5
AEKLT,0,0,0,1,1,5
EKLTR,0,0,0,1,1,5
KLTRH,0,0,0,1,1,5
TESMK,0,0,0,1,1,5
ESMKT,0,0,0,1,1,5
SMKTV,0,0,0,1,1,5
MKTVR,0,0,0,1,1,5
KTVRI,0,0,0,1,1,5
TVRIR,0,0,0,1,1,5
VRIRE,0,0,0,1,1,5
RIREK,0,0,0,1,1,5
IREKI,0,0,0,1,1,5
REKIK,0,0,0,1,1,5
EKIKK,0,0,0,1,1,5
KIKKF,0,0,0,1,1,5
IKKFL,0,0,0,1,1,5
TETQI,0,0,0,1,1,5
ETQIR,0,0,0,1,1,5
TQIRE,0,0,0,1,1,5
QIREL,0,0,0,1,1,5
IRELL,0,0,0,1,1,5
RELLF,0,0,0,1,1,5
ELLFD,0,0,0,1,1,5
LLFDL,0,0,0,1,1,5
LFDLE,0,0,0,1,1,5
FDLEL,0,0,0,1,1,5
DLELA,0,0,0,1,1,5
LELAY,0,0,0,1,1,5
ELAYK,0,0,0,1,1,5
LAYKS,0,0,0,1,1,5
AYKSF,0,0,0,1,1,5
YKSFY,0,0,0,1,1,5
KSFYA,0,0,0,1,1,5
SFYAL,0,0,0,1,1,5
FYALL,0,0,0,1,1,5
TEVYQ,0,0,0,1,1,5
EVYQI,0,0,0,1,1,5
VYQIL,0,0,0,1,1,5
YQILN,0,0,0,1,1,5
QILNR,0,0,0,1,1,5
ILNRV,0,0,0,1,1,5
LNRVS,0,0,0,1,1,5
TFPDK,0,0,0,1,1,5
FPDKA,0,0,0,1,1,5
PDKAL,0,0,0,1,1,5
DKALK,0,0,0,1,1,5
KALKG,0,0,0,1,1,5
ALKGK,0,0,0,1,1,5
LKGKK,0,0,0,1,1,5
KGKKS,0,0,0,1,1,5
GKKSI,0,0,0,1,1,5
KKSIE,0,0,0,1,1,5
KSIEN,0,0,0,1,1,5
SIENI,0,0,0,1,1,5
IENIV,0,0,0,1,1,5
ENIVV,0,0,0,1,1,5
TFPEW,0,0,0,1,1,5
FPEWH,0,0,0,1,1,5
PEWHR,0,0,0,1,1,5
EWHRL,0,0,0,1,1,5
WHRLY,0,0,0,1,1,5
HRLYT,0,0,0,1,1,5
RLYTV,0,0,0,1,1,5
LYTVQ,0,0,0,1,1,5
YTVQF,0,0,0,1,1,5
TVQFE,0,0,0,1,1,5
VQFED,0,0,0,1,1,5
QFEDA,0,0,0,1,1,5
FEDAL,0,0,0,1,1,5
EDALR,0,0,0,1,1,5
DALRR,0,0,0,1,1,5
ALRRH,0,0,0,1,1,5
TFPNW,0,0,0,1,1,5
FPNWH,0,0,0,1,1,5
PNWHR,0,0,0,1,1,5
NWHRL,0,0,0,1,1,5
WHRLL,0,0,0,1,1,5
HRLLT,0,0,0,1,1,5
RLLTK,0,0,0,1,1,5
LLTKQ,0,0,0,1,1,5
LTKQM,0,0,0,1,1,5
TKQME,0,0,0,1,1,5
KQMED,0,0,0,1,1,5
QMEDA,0,0,0,1,1,5
MEDAL,0,0,0,1,1,5
EDALV,0,0,0,1,1,5
DALVA,0,0,0,1,1,5
ALVAK,0,0,0,1,1,5
TFSQV,0,0,0,1,1,5
FSQVL,0,0,0,1,1,5
SQVLD,0,0,0,1,1,5
QVLDD,0,0,0,1,1,5
VLDDL,0,0,0,1,1,5
LDDLS,0,0,0,1,1,5
DDLSA,0,0,0,1,1,5
DLSAR,0,0,0,1,1,5
LSARF,0,0,0,1,1,5
SARFI,0,0,0,1,1,5
TGALR,0,0,0,1,1,5
GALRT,0,0,0,1,1,5
ALRTQ,0,0,0,1,1,5
LRTQY,0,0,0,1,1,5
RTQYD,0,0,0,1,1,5
TQYDV,0,0,0,1,1,5
QYDVS,0,0,0,1,1,5
YDVSL,0,0,0,1,1,5
DVSLM,0,0,0,1,1,5
VSLMT,0,0,0,1,1,5
SLMTV,0,0,0,1,1,5
LMTVK,0,0,0,1,1,5
MTVKS,0,0,0,1,1,5
THAEM,0,0,0,1,1,5
HAEML,0,0,0,1,1,5
AEMLH,0,0,0,1,1,5
EMLHA,0,0,0,1,1,5
MLHAL,0,0,0,1,1,5
LHALK,0,0,0,1,1,5
HALKE,0,0,0,1,1,5
ALKER,0,0,0,1,1,5
LKERY,0,0,0,1,1,5
THNKL,0,0,0,1,1,5
HNKLL,0,0,0,1,1,5
NKLLK,0,0,0,1,1,5
KLLKN,0,0,0,1,1,5
LLKNV,0,0,0,1,1,5
LKNVA,0,0,0,1,1,5
KNVAF,0,0,0,1,1,5
NVAFM,0,0,0,1,1,5
VAFMK,0,0,0,1,1,5
AFMKS,0,0,0,1,1,5
FMKSY,0,0,0,1,1,5
MKSYI,0,0,0,1,1,5
KSYIL,0,0,0,1,1,5
SYILE,0,0,0,1,1,5
YILEK,0,0,0,1,1,5
LEKVK,0,0,0,1,1,5
EKVKE,0,0,0,1,1,5
KVKEH,0,0,0,1,1,5
VKEHQ,0,0,0,1,1,5
KEHQE,0,0,0,1,1,5
EHQES,0,0,0,1,1,5
TIEEF,0,0,0,1,1,5
IEEFH,0,0,0,1,1,5
EEFHS,0,0,0,1,1,5
EFHSK,0,0,0,1,1,5
FHSKL,0,0,0,1,1,5
HSKLQ,0,0,0,1,1,5
SKLQE,0,0,0,1,1,5
KLQEA,0,0,0,1,1,5
LQEAT,0,0,0,1,1,5
QEATN,0,0,0,1,1,5
TIQSR,0,0,0,1,1,5
IQSRF,0,0,0,1,1,5
QSRFN,0,0,0,1,1,5
SRFNY,0,0,0,1,1,5
RFNYA,0,0,0,1,1,5
FNYAW,0,0,0,1,1,5
NYAWG,0,0,0,1,1,5
YAWGL,0,0,0,1,1,5
AWGLI,0,0,0,1,1,5
WGLIK,0,0,0,1,1,5
GLIKS,0,0,0,1,1,5
TISLG,0,0,0,1,1,5
ISLGV,0,0,0,1,1,5
SLGVS,0,0,0,1,1,5
LGVSI,0,0,0,1,1,5
GVSIA,0,0,0,1,1,5
VSIAH,0,0,0,1,1,5
SIAHV,0,0,0,1,1,5
IAHVM,0,0,0,1,1,5
AHVME,0,0,0,1,1,5
HVMEA,0,0,0,1,1,5
VMEAV,0,0,0,1,1,5
MEAVE,0,0,0,1,1,5
TITEM,0,0,0,1,1,5
ITEMV,0,0,0,1,1,5
TEMVF,0,0,0,1,1,5
EMVFL,0,0,0,1,1,5
MVFLA,0,0,0,1,1,5
VFLAE,0,0,0,1,1,5
FLAEV,0,0,0,1,1,5
LAEVY,0,0,0,1,1,5
AEVYK,0,0,0,1,1,5
EVYKS,0,0,0,1,1,5
VYKSG,0,0,0,1,1,5
YKSGG,0,0,0,1,1,5
TIVEL,0,0,0,1,1,5
IVELV,0,0,0,1,1,5
VELVV,0,0,0,1,1,5
ELVVR,0,0,0,1,1,5
LVVRV,0,0,0,1,1,5
VVRVW,0,0,0,1,1,5
VRVWR,0,0,0,1,1,5
VWRWF,0,0,0,1,1,5
WRWFL,0,0,0,1,1,5
RWFLV,0,0,0,1,1,5
WFLVI,0,0,0,1,1,5
FLVIW,0,0,0,1,1,5
LVIWV,0,0,0,1,1,5
VIWVL,0,0,0,1,1,5
IWVLW,0,0,0,1,1,5
TKDEF,0,0,0,1,1,5
KDEFM,0,0,0,1,1,5
DEFMS,0,0,0,1,1,5
EFMSG,0,0,0,1,1,5
FMSGE,0,0,0,1,1,5
MSGEP,0,0,0,1,1,5
SGEPI,0,0,0,1,1,5
GEPIF,0,0,0,1,1,5
EPIFT,0,0,0,1,1,5
PIFTK,0,0,0,1,1,5
IFTKY,0,0,0,1,1,5
FTKYF,0,0,0,1,1,5
TKYFQ,0,0,0,1,1,5
KYFQN,0,0,0,1,1,5
YFQNL,0,0,0,1,1,5
FQNLV,0,0,0,1,1,5
TKDEQ,0,0,0,1,1,5
KDEQV,0,0,0,1,1,5
DEQVE,0,0,0,1,1,5
EQVEG,0,0,0,1,1,5
QVEGL,0,0,0,1,1,5
VEGLL,0,0,0,1,1,5
EGLLA,0,0,0,1,1,5
TKGER,0,0,0,1,1,5
KGERE,0,0,0,1,1,5
GEREM,0,0,0,1,1,5
EREMI,0,0,0,1,1,5
REMIV,0,0,0,1,1,5
EMIVV,0,0,0,1,1,5
MIVVA,0,0,0,1,1,5
IVVAT,0,0,0,1,1,5
VVATS,0,0,0,1,1,5
VATSA,0,0,0,1,1,5
ATSAA,0,0,0,1,1,5
TSAAN,0,0,0,1,1,5
TKIWL,0,0,0,1,1,5
KIWLN,0,0,0,1,1,5
IWLNA,0,0,0,1,1,5
WLNAA,0,0,0,1,1,5
LNAAR,0,0,0,1,1,5
NAARR,0,0,0,1,1,5
AARRT,0,0,0,1,1,5
ARRTG,0,0,0,1,1,5
RRTGK,0,0,0,1,1,5
RTGKV,0,0,0,1,1,5
TGKVP,0,0,0,1,1,5
GKVPA,0,0,0,1,1,5
KVPAR,0,0,0,1,1,5
VPARI,0,0,0,1,1,5
PARIR,0,0,0,1,1,5
ARIRK,0,0,0,1,1,5
RIRKL,0,0,0,1,1,5
TLDQM,0,0,0,1,1,5
LDQMR,0,0,0,1,1,5
DQMRS,0,0,0,1,1,5
QMRSR,0,0,0,1,1,5
MRSRL,0,0,0,1,1,5
RSRLA,0,0,0,1,1,5
SRLAY,0,0,0,1,1,5
RLAYD,0,0,0,1,1,5
LAYDG,0,0,0,1,1,5
TLEDY,0,0,0,1,1,5
LEDYV,0,0,0,1,1,5
EDYVR,0,0,0,1,1,5
DYVRY,0,0,0,1,1,5
YVRYV,0,0,0,1,1,5
VRYVT,0,0,0,1,1,5
RYVTL,0,0,0,1,1,5
YVTLD,0,0,0,1,1,5
VTLDM,0,0,0,1,1,5
TLIRE,0,0,0,1,1,5
LIREW,0,0,0,1,1,5
IREWG,0,0,0,1,1,5
REWGD,0,0,0,1,1,5
EWGDA,0,0,0,1,1,5
WGDAV,0,0,0,1,1,5
GDAVF,0,0,0,1,1,5
DAVFD,0,0,0,1,1,5
AVFDI,0,0,0,1,1,5
VFDIF,0,0,0,1,1,5
TMEGK,0,0,0,1,1,5
MEGKF,0,0,0,1,1,5
EGKFK,0,0,0,1,1,5
GKFKA,0,0,0,1,1,5
KFKAV,0,0,0,1,1,5
FKAVA,0,0,0,1,1,5
KAVAE,0,0,0,1,1,5
AVAED,0,0,0,1,1,5
VAEDV,0,0,0,1,1,5
AEDVA,0,0,0,1,1,5
DVAQR,0,0,0,1,1,5
VAQRY,0,0,0,1,1,5
AQRYM,0,0,0,1,1,5
QRYMT,0,0,0,1,1,5
TMVQA,0,0,0,1,1,5
MVQAI,0,0,0,1,1,5
VQAIT,0,0,0,1,1,5
QAITD,0,0,0,1,1,5
AITDA,0,0,0,1,1,5
ITDAL,0,0,0,1,1,5
TDALR,0,0,0,1,1,5
DALRI,0,0,0,1,1,5
ALRIE,0,0,0,1,1,5
LRIEL,0,0,0,1,1,5
RIELK,0,0,0,1,1,5
IELKN,0,0,0,1,1,5
ELKND,0,0,0,1,1,5
TNDEI,0,0,0,1,1,5
NDEIF,0,0,0,1,1,5
DEIFS,0,0,0,1,1,5
EIFSI,0,0,0,1,1,5
IFSIL,0,0,0,1,1,5
FSILK,0,0,0,1,1,5
SILKD,0,0,0,1,1,5
TPAKA,0,0,0,1,1,5
PAKAL,0,0,0,1,1,5
ALKSA,0,0,0,1,1,5
LKSAI,0,0,0,1,1,5
KSAIH,0,0,0,1,1,5
SAIHV,0,0,0,1,1,5
AIHVA,0,0,0,1,1,5
IHVAY,0,0,0,1,1,5
HVAYI,0,0,0,1,1,5
VAYIL,0,0,0,1,1,5
AYILK,0,0,0,1,1,5
YILKK,0,0,0,1,1,5
TPDQQ,0,0,0,1,1,5
PDQQT,0,0,0,1,1,5
DQQTL,0,0,0,1,1,5
QQTLL,0,0,0,1,1,5
QTLLH,0,0,0,1,1,5
TLLHF,0,0,0,1,1,5
LLHFI,0,0,0,1,1,5
LHFIM,0,0,0,1,1,5
HFIMD,0,0,0,1,1,5
FIMDS,0,0,0,1,1,5
IMDSY,0,0,0,1,1,5
MDSYN,0,0,0,1,1,5
TPEEV,0,0,0,1,1,5
PEEVK,0,0,0,1,1,5
VKKHY,0,0,0,1,1,5
KKHYE,0,0,0,1,1,5
KHYEI,0,0,0,1,1,5
HYEIL,0,0,0,1,1,5
YEILV,0,0,0,1,1,5
EILVE,0,0,0,1,1,5
ILVED,0,0,0,1,1,5
LVEDI,0,0,0,1,1,5
VEDIK,0,0,0,1,1,5
EDIKY,0,0,0,1,1,5
DIKYI,0,0,0,1,1,5
IKYIE,0,0,0,1,1,5
KYIES,0,0,0,1,1,5
YIESG,0,0,0,1,1,5
TPEEY,0,0,0,1,1,5
PEEYQ,0,0,0,1,1,5
EEYQT,0,0,0,1,1,5
EYQTY,0,0,0,1,1,5
YQTYV,0,0,0,1,1,5
QTYVA,0,0,0,1,1,5
TYVAQ,0,0,0,1,1,5
YVAQV,0,0,0,1,1,5
VAQVD,0,0,0,1,1,5
AQVDK,0,0,0,1,1,5
TPEKM,0,0,0,1,1,5
PEKMG,0,0,0,1,1,5
EKMGE,0,0,0,1,1,5
KMGEM,0,0,0,1,1,5
MGEMA,0,0,0,1,1,5
GEMAQ,0,0,0,1,1,5
EMAQK,0,0,0,1,1,5
MAQKF,0,0,0,1,1,5
AQKFR,0,0,0,1,1,5
QKFRE,0,0,0,1,1,5
TPEKR,0,0,0,1,1,5
PEKRV,0,0,0,1,1,5
EKRVD,0,0,0,1,1,5
KRVDR,0,0,0,1,1,5
RVDRI,0,0,0,1,1,5
VDRIF,0,0,0,1,1,5
DRIFA,0,0,0,1,1,5
RIFAM,0,0,0,1,1,5
IFAMM,0,0,0,1,1,5
FAMMD,0,0,0,1,1,5
TPERL,0,0,0,1,1,5
PERLE,0,0,0,1,1,5
ERLEK,0,0,0,1,1,5
RLEKL,0,0,0,1,1,5
LEKLV,0,0,0,1,1,5
EKLVK,0,0,0,1,1,5
KLVKE,0,0,0,1,1,5
LVKEV,0,0,0,1,1,5
VKEVL,0,0,0,1,1,5
TPETI,0,0,0,1,1,5
PETIT,0,0,0,1,1,5
ETITH,0,0,0,1,1,5
TITHY,0,0,0,1,1,5
ITHYL,0,0,0,1,1,5
THYLE,0,0,0,1,1,5
HYLET,0,0,0,1,1,5
YLETV,0,0,0,1,1,5
LETVN,0,0,0,1,1,5
ETVNH,0,0,0,1,1,5
TVNHA,0,0,0,1,1,5
VNHAM,0,0,0,1,1,5
TPEVV,0,0,0,1,1,5
PEVVK,0,0,0,1,1,5
EVVKE,0,0,0,1,1,5
VVKER,0,0,0,1,1,5
VKERL,0,0,0,1,1,5
ERLLS,0,0,0,1,1,5
TPLGI,0,0,0,1,1,5
PLGIG,0,0,0,1,1,5
LGIGI,0,0,0,1,1,5
GIGIT,0,0,0,1,1,5
IGITD,0,0,0,1,1,5
GITDY,0,0,0,1,1,5
ITDYY,0,0,0,1,1,5
TDYYI,0,0,0,1,1,5
DYYIR,0,0,0,1,1,5
TPQDI,0,0,0,1,1,5
PQDIA,0,0,0,1,1,5
QDIAD,0,0,0,1,1,5
DIADR,0,0,0,1,1,5
IADRE,0,0,0,1,1,5
ADRER,0,0,0,1,1,5
DRERI,0,0,0,1,1,5
RERIF,0,0,0,1,1,5
ERIFK,0,0,0,1,1,5
RIFKR,0,0,0,1,1,5
IFKRF,0,0,0,1,1,5
FKRFD,0,0,0,1,1,5
TPSDI,0,0,0,1,1,5
PSDIK,0,0,0,1,1,5
SDIKE,0,0,0,1,1,5
DIKEL,0,0,0,1,1,5
IKELR,0,0,0,1,1,5
KELRD,0,0,0,1,1,5
ELRDA,0,0,0,1,1,5
LRDAM,0,0,0,1,1,5
RDAMA,0,0,0,1,1,5
DAMAK,0,0,0,1,1,5
AMAKV,0,0,0,1,1,5
MAKVQ,0,0,0,1,1,5
AKVQA,0,0,0,1,1,5
KVQAD,0,0,0,1,1,5
TPVYR,0,0,0,1,1,5
PVYRT,0,0,0,1,1,5
VYRTA,0,0,0,1,1,5
YRTAI,0,0,0,1,1,5
RTAIR,0,0,0,1,1,5
TAIRY,0,0,0,1,1,5
AIRYY,0,0,0,1,1,5
IRYYL,0,0,0,1,1,5
RYYLQ,0,0,0,1,1,5
YYLQM,0,0,0,1,1,5
YLQML,0,0,0,1,1,5
LQMLF,0,0,0,1,1,5
TPWSK,0,0,0,1,1,5
PWSKG,0,0,0,1,1,5
WSKGF,0,0,0,1,1,5
SKGFL,0,0,0,1,1,5
KGFLA,0,0,0,1,1,5
GFLAS,0,0,0,1,1,5
FLASS,0,0,0,1,1,5
LASSY,0,0,0,1,1,5
ASSYA,0,0,0,1,1,5
SSYAS,0,0,0,1,1,5
SYASR,0,0,0,1,1,5
TPYDA,0,0,0,1,1,5
PYDAK,0,0,0,1,1,5
YDAKG,0,0,0,1,1,5
DAKGL,0,0,0,1,1,5
AKGLL,0,0,0,1,1,5
KGLLI,0,0,0,1,1,5
GLLIS,0,0,0,1,1,5
LLISA,0,0,0,1,1,5
LISAI,0,0,0,1,1,5
ISAIR,0,0,0,1,1,5
SAIRD,0,0,0,1,1,5
TQAQE,0,0,0,1,1,5
QAQET,0,0,0,1,1,5
AQETQ,0,0,0,1,1,5
QETQG,0,0,0,1,1,5
ETQGQ,0,0,0,1,1,5
TQGQA,0,0,0,1,1,5
QGQAA,0,0,0,1,1,5
GQAAA,0,0,0,1,1,5
QAAAR,0,0,0,1,1,5
AAARA,0,0,0,1,1,5
AARAA,0,0,0,1,1,5
ARAAA,0,0,0,1,1,5
RAAAA,0,0,0,1,1,5
AAAAD,0,0,0,1,1,5
AAADL,0,0,0,1,1,5
AADLA,0,0,0,1,1,5
ADLAA,0,0,0,1,1,5
DLAAG,0,0,0,1,1,5
TQDLR,0,0,0,1,1,5
QDLRS,0,0,0,1,1,5
DLRSH,0,0,0,1,1,5
LRSHL,0,0,0,1,1,5
RSHLV,0,0,0,1,1,5
SHLVH,0,0,0,1,1,5
HLVHK,0,0,0,1,1,5
VHKLV,0,0,0,1,1,5
HKLVQ,0,0,0,1,1,5
KLVQA,0,0,0,1,1,5
LVQAI,0,0,0,1,1,5
VQAIF,0,0,0,1,1,5
TQGLL,0,0,0,1,1,5
QGLLS,0,0,0,1,1,5
GLLSE,0,0,0,1,1,5
LLSEI,0,0,0,1,1,5
LSEIL,0,0,0,1,1,5
SEILR,0,0,0,1,1,5
EILRK,0,0,0,1,1,5
TQGMQ,0,0,0,1,1,5
QGMQN,0,0,0,1,1,5
GMQNA,0,0,0,1,1,5
MQNAM,0,0,0,1,1,5
QNAMG,0,0,0,1,1,5
NAMGE,0,0,0,1,1,5
AMGER,0,0,0,1,1,5
MGERF,0,0,0,1,1,5
GERFA,0,0,0,1,1,5
ERFAQ,0,0,0,1,1,5
RFAQY,0,0,0,1,1,5
FAQYA,0,0,0,1,1,5
AQYAL,0,0,0,1,1,5
QYALS,0,0,0,1,1,5
YALSS,0,0,0,1,1,5
ALSSE,0,0,0,1,1,5
LSSEK,0,0,0,1,1,5
SSEKL,0,0,0,1,1,5
SEKLY,0,0,0,1,1,5
TQSDV,0,0,0,1,1,5
QSDVY,0,0,0,1,1,5
SDVYA,0,0,0,1,1,5
DVYAM,0,0,0,1,1,5
VYAMV,0,0,0,1,1,5
YAMVG,0,0,0,1,1,5
AMVGY,0,0,0,1,1,5
MVGYI,0,0,0,1,1,5
VGYIH,0,0,0,1,1,5
GYIHE,0,0,0,1,1,5
YIHEL,0,0,0,1,1,5
IHELW,0,0,0,1,1,5
TRELA,0,0,0,1,1,5
RELAY,0,0,0,1,1,5
ELAYM,0,0,0,1,1,5
LAYMI,0,0,0,1,1,5
AYMIK,0,0,0,1,1,5
YMIKK,0,0,0,1,1,5
MIKKA,0,0,0,1,1,5
TRTQR,0,0,0,1,1,5
RTQRR,0,0,0,1,1,5
TQRRI,0,0,0,1,1,5
QRRIA,0,0,0,1,1,5
RRIAV,0,0,0,1,1,5
RIAVV,0,0,0,1,1,5
IAVVE,0,0,0,1,1,5
AVVEF,0,0,0,1,1,5
VVEFI,0,0,0,1,1,5
VEFIF,0,0,0,1,1,5
EFIFS,0,0,0,1,1,5
FIFSL,0,0,0,1,1,5
IFSLL,0,0,0,1,1,5
TSAQT,0,0,0,1,1,5
SAQTK,0,0,0,1,1,5
AQTKV,0,0,0,1,1,5
QTKVV,0,0,0,1,1,5
TKVVV,0,0,0,1,1,5
KVVVD,0,0,0,1,1,5
VVVDA,0,0,0,1,1,5
TSFDE,0,0,0,1,1,5
SFDEY,0,0,0,1,1,5
FDEYV,0,0,0,1,1,5
DEYVA,0,0,0,1,1,5
EYVAE,0,0,0,1,1,5
YVAEL,0,0,0,1,1,5
VAELD,0,0,0,1,1,5
AELDS,0,0,0,1,1,5
ELDSK,0,0,0,1,1,5
TSHLM,0,0,0,1,1,5
SHLMG,0,0,0,1,1,5
HLMGM,0,0,0,1,1,5
LMGMF,0,0,0,1,1,5
MGMFY,0,0,0,1,1,5
GMFYR,0,0,0,1,1,5
MFYRT,0,0,0,1,1,5
FYRTI,0,0,0,1,1,5
YRTIR,0,0,0,1,1,5
RTIRM,0,0,0,1,1,5
TIRMM,0,0,0,1,1,5
IRMME,0,0,0,1,1,5
RMMEN,0,0,0,1,1,5
TTDEI,0,0,0,1,1,5
TDEIN,0,0,0,1,1,5
DEINA,0,0,0,1,1,5
EINAM,0,0,0,1,1,5
INAMD,0,0,0,1,1,5
NAMDK,0,0,0,1,1,5
AMDKA,0,0,0,1,1,5
MDKAL,0,0,0,1,1,5
DKALI,0,0,0,1,1,5
KALIL,0,0,0,1,1,5
ALILY,0,0,0,1,1,5
LILYT,0,0,0,1,1,5
TTGNF,0,0,0,1,1,5
TGNFE,0,0,0,1,1,5
GNFEK,0,0,0,1,1,5
NFEKL,0,0,0,1,1,5
FEKLF,0,0,0,1,1,5
EKLFV,0,0,0,1,1,5
KLFVA,0,0,0,1,1,5
LFVAL,0,0,0,1,1,5
FVALV,0,0,0,1,1,5
VALVE,0,0,0,1,1,5
ALVEY,0,0,0,1,1,5
LVEYM,0,0,0,1,1,5
VEYMR,0,0,0,1,1,5
EYMRA,0,0,0,1,1,5
YMRAS,0,0,0,1,1,5
TVEEV,0,0,0,1,1,5
VEEVN,0,0,0,1,1,5
EEVNA,0,0,0,1,1,5
EVNAL,0,0,0,1,1,5
VNALK,0,0,0,1,1,5
NALKN,0,0,0,1,1,5
ALKNE,0,0,0,1,1,5
LKNEI,0,0,0,1,1,5
KNEIL,0,0,0,1,1,5
NEILK,0,0,0,1,1,5
EILKA,0,0,0,1,1,5
ILKAH,0,0,0,1,1,5
LKAHA,0,0,0,1,1,5
TVFGT,0,0,0,1,1,5
VFGTA,0,0,0,1,1,5
FGTAL,0,0,0,1,1,5
GTALN,0,0,0,1,1,5
TALNY,0,0,0,1,1,5
ALNYV,0,0,0,1,1,5
LNYVS,0,0,0,1,1,5
NYVSL,0,0,0,1,1,5
YVSLR,0,0,0,1,1,5
VSLRI,0,0,0,1,1,5
SLRIL,0,0,0,1,1,5
TVLAA,0,0,0,1,1,5
VLAAL,0,0,0,1,1,5
LAALF,0,0,0,1,1,5
AALFL,0,0,0,1,1,5
ALFLA,0,0,0,1,1,5
FLAGS,0,0,0,1,1,5
TYYAK,0,0,0,1,1,5
YYAKD,0,0,0,1,1,5
YAKDI,0,0,0,1,1,5
AKDIA,0,0,0,1,1,5
KDIAF,0,0,0,1,1,5
DIAFQ,0,0,0,1,1,5
IAFQF,0,0,0,1,1,5
AFQFW,0,0,0,1,1,5
FQFWK,0,0,0,1,1,5
QFWKM,0,0,0,1,1,5
VADIA,0,0,0,1,1,5
ADIAK,0,0,0,1,1,5
DIAKL,0,0,0,1,1,5
IAKLK,0,0,0,1,1,5
AKLKV,0,0,0,1,1,5
KLKVN,0,0,0,1,1,5
LKVNI,0,0,0,1,1,5
KVNII,0,0,0,1,1,5
VNIIK,0,0,0,1,1,5
NIIKN,0,0,0,1,1,5
IIKNV,0,0,0,1,1,5
IKNVR,0,0,0,1,1,5
KNVRI,0,0,0,1,1,5
NVRII,0,0,0,1,1,5
VADPV,0,0,0,1,1,5
ADPVA,0,0,0,1,1,5
DPVAA,0,0,0,1,1,5
PVAAF,0,0,0,1,1,5
VAAFK,0,0,0,1,1,5
AAFKW,0,0,0,1,1,5
AFKWR,0,0,0,1,1,5
FKWRA,0,0,0,1,1,5
KWRAQ,0,0,0,1,1,5
VDDNL,0,0,0,1,1,5
DDNLY,0,0,0,1,1,5
DNLYP,0,0,0,1,1,5
NLYPQ,0,0,0,1,1,5
LYPQL,0,0,0,1,1,5
YPQLE,0,0,0,1,1,5
PQLER,0,0,0,1,1,5
QLERA,0,0,0,1,1,5
LERAS,0,0,0,1,1,5
ERASR,0,0,0,1,1,5
RASRK,0,0,0,1,1,5
ASRKI,0,0,0,1,1,5
RKIFE,0,0,0,1,1,5
KIFEF,0,0,0,1,1,5
IFEFL,0,0,0,1,1,5
FEFLE,0,0,0,1,1,5
EFLER,0,0,0,1,1,5
VEAIE,0,0,0,1,1,5
IEALL,0,0,0,1,1,5
EALLK,0,0,0,1,1,5
ALLKG,0,0,0,1,1,5
LLKGN,0,0,0,1,1,5
VFWPT,0,0,0,1,1,5
FWPTM,0,0,0,1,1,5
WPTML,0,0,0,1,1,5
PTMLK,0,0,0,1,1,5
TMLKA,0,0,0,1,1,5
MLKAA,0,0,0,1,1,5
LKAAG,0,0,0,1,1,5
VGVLL,0,0,0,1,1,5
GVLLQ,0,0,0,1,1,5
LLQLL,0,0,0,1,1,5
LQLLV,0,0,0,1,1,5
QLLVQ,0,0,0,1,1,5
LLVQA,0,0,0,1,1,5
VGYET,0,0,0,1,1,5
GYETA,0,0,0,1,1,5
YETAA,0,0,0,1,1,5
ETAAK,0,0,0,1,1,5
TAAKL,0,0,0,1,1,5
AKLAR,0,0,0,1,1,5
KLARE,0,0,0,1,1,5
LAREA,0,0,0,1,1,5
AREAY,0,0,0,1,1,5
REAYL,0,0,0,1,1,5
EAYLT,0,0,0,1,1,5
VHVLA,0,0,0,1,1,5
HVLAD,0,0,0,1,1,5
VLADA,0,0,0,1,1,5
LADAF,0,0,0,1,1,5
ADAFK,0,0,0,1,1,5
DAFKR,0,0,0,1,1,5
AFKRY,0,0,0,1,1,5
FKRYL,0,0,0,1,1,5
KRYLL,0,0,0,1,1,5
RYLLD,0,0,0,1,1,5
VIDPL,0,0,0,1,1,5
IDPLH,0,0,0,1,1,5
DPLHT,0,0,0,1,1,5
PLHTH,0,0,0,1,1,5
LHTHL,0,0,0,1,1,5
HTHLT,0,0,0,1,1,5
THLTR,0,0,0,1,1,5
HLTRL,0,0,0,1,1,5
LTRLV,0,0,0,1,1,5
TRLVA,0,0,0,1,1,5
RLVAA,0,0,0,1,1,5
LVAAY,0,0,0,1,1,5
VAAYT,0,0,0,1,1,5
AAYTG,0,0,0,1,1,5
VKYAV,0,0,0,1,1,5
KYAVF,0,0,0,1,1,5
YAVFE,0,0,0,1,1,5
AVFEA,0,0,0,1,1,5
VFEAA,0,0,0,1,1,5
FEAAL,0,0,0,1,1,5
EAALT,0,0,0,1,1,5
AALTK,0,0,0,1,1,5
ALTKA,0,0,0,1,1,5
LTKAI,0,0,0,1,1,5
TKAIT,0,0,0,1,1,5
KAITA,0,0,0,1,1,5
AITAM,0,0,0,1,1,5
ITAMS,0,0,0,1,1,5
TAMSE,0,0,0,1,1,5
AMSEV,0,0,0,1,1,5
MSEVQ,0,0,0,1,1,5
SEVQK,0,0,0,1,1,5
VQKVS,0,0,0,1,1,5
QKVSQ,0,0,0,1,1,5
VLSFK,0,0,0,1,1,5
LSFKT,0,0,0,1,1,5
SFKTG,0,0,0,1,1,5
FKTGI,0,0,0,1,1,5
KTGII,0,0,0,1,1,5
TGIIS,0,0,0,1,1,5
GIISL,0,0,0,1,1,5
VMELL,0,0,0,1,1,5
MELLT,0,0,0,1,1,5
ELLTK,0,0,0,1,1,5
LLTKT,0,0,0,1,1,5
LTKTL,0,0,0,1,1,5
TKTLG,0,0,0,1,1,5
KTLGW,0,0,0,1,1,5
TLGWD,0,0,0,1,1,5
LGWDI,0,0,0,1,1,5
GWDIQ,0,0,0,1,1,5
WDIQE,0,0,0,1,1,5
DIQEE,0,0,0,1,1,5
QEELN,0,0,0,1,1,5
EELNK,0,0,0,1,1,5
ELNKL,0,0,0,1,1,5
LNKLT,0,0,0,1,1,5
VMGQN,0,0,0,1,1,5
MGQNL,0,0,0,1,1,5
GQNLI,0,0,0,1,1,5
QNLIL,0,0,0,1,1,5
NLILN,0,0,0,1,1,5
LILNM,0,0,0,1,1,5
ILNMN,0,0,0,1,1,5
LNMND,0,0,0,1,1,5
VMPSL,0,0,0,1,1,5
MPSLL,0,0,0,1,1,5
PSLLQ,0,0,0,1,1,5
SLLQA,0,0,0,1,1,5
LLQAF,0,0,0,1,1,5
LQAFD,0,0,0,1,1,5
QAFDL,0,0,0,1,1,5
AFDLT,0,0,0,1,1,5
FDLTA,0,0,0,1,1,5
VMQWV,0,0,0,1,1,5
MQWVI,0,0,0,1,1,5
QWVIR,0,0,0,1,1,5
WVIRI,0,0,0,1,1,5
VIRIL,0,0,0,1,1,5
IRILG,0,0,0,1,1,5
RILGG,0,0,0,1,1,5
ILGGG,0,0,0,1,1,5
LGGGL,0,0,0,1,1,5
GGGLQ,0,0,0,1,1,5
GGLQK,0,0,0,1,1,5
GLQKA,0,0,0,1,1,5
LQKAL,0,0,0,1,1,5
VNFLV,0,0,0,1,1,5
NFLVA,0,0,0,1,1,5
FLVAD,0,0,0,1,1,5
LVADA,0,0,0,1,1,5
VADAL,0,0,0,1,1,5
ADALK,0,0,0,1,1,5
ALKQH,0,0,0,1,1,5
LKQHR,0,0,0,1,1,5
KQHRH,0,0,0,1,1,5
QHRHR,0,0,0,1,1,5
HRHRR,0,0,0,1,1,5
RHRRD,0,0,0,1,1,5
HRRDD,0,0,0,1,1,5
RRDDV,0,0,0,1,1,5
RDDVI,0,0,0,1,1,5
DDVIV,0,0,0,1,1,5
DVIVM,0,0,0,1,1,5
VIVML,0,0,0,1,1,5
IVMLS,0,0,0,1,1,5
VMLSA,0,0,0,1,1,5
MLSAR,0,0,0,1,1,5
VNQFL,0,0,0,1,1,5
NQFLD,0,0,0,1,1,5
QFLDY,0,0,0,1,1,5
FLDYL,0,0,0,1,1,5
LDYLQ,0,0,0,1,1,5
DYLQE,0,0,0,1,1,5
YLQEF,0,0,0,1,1,5
LQEFL,0,0,0,1,1,5
QEFLG,0,0,0,1,1,5
EFLGV,0,0,0,1,1,5
FLGVM,0,0,0,1,1,5
LGVMN,0,0,0,1,1,5
GVMNT,0,0,0,1,1,5
VPMQR,0,0,0,1,1,5
PMQRV,0,0,0,1,1,5
MQRVL,0,0,0,1,1,5
QRVLK,0,0,0,1,1,5
RVLKY,0,0,0,1,1,5
VLKYH,0,0,0,1,1,5
LKYHL,0,0,0,1,1,5
KYHLL,0,0,0,1,1,5
YHLLL,0,0,0,1,1,5
HLLLQ,0,0,0,1,1,5
LLLQE,0,0,0,1,1,5
LLQEL,0,0,0,1,1,5
LQELV,0,0,0,1,1,5
QELVK,0,0,0,1,1,5
VQEVN,0,0,0,1,1,5
QEVNR,0,0,0,1,1,5
EVNRF,0,0,0,1,1,5
VNRFI,0,0,0,1,1,5
NRFIK,0,0,0,1,1,5
RFIKA,0,0,0,1,1,5
FIKAF,0,0,0,1,1,5
IKAFE,0,0,0,1,1,5
AFEEM,0,0,0,1,1,5
FEEMK,0,0,0,1,1,5
EEMKA,0,0,0,1,1,5
EMKAL,0,0,0,1,1,5
MKALM,0,0,0,1,1,5
KALMK,0,0,0,1,1,5
ALMKS,0,0,0,1,1,5
LMKSL,0,0,0,1,1,5
VSDAR,0,0,0,1,1,5
SDARS,0,0,0,1,1,5
DARSA,0,0,0,1,1,5
ARSAI,0,0,0,1,1,5
RSAIT,0,0,0,1,1,5
SAITS,0,0,0,1,1,5
AITSA,0,0,0,1,1,5
ITSAQ,0,0,0,1,1,5
TSAQE,0,0,0,1,1,5
SAQEL,0,0,0,1,1,5
AQELL,0,0,0,1,1,5
QELLD,0,0,0,1,1,5
ELLDS,0,0,0,1,1,5
VWHYA,0,0,0,1,1,5
WHYAL,0,0,0,1,1,5
HYALW,0,0,0,1,1,5
YALWS,0,0,0,1,1,5
ALWSL,0,0,0,1,1,5
LWSLI,0,0,0,1,1,5
WSLIQ,0,0,0,1,1,5
SLIQQ,0,0,0,1,1,5
LIQQS,0,0,0,1,1,5
IQQSE,0,0,0,1,1,5
QQSEI,0,0,0,1,1,5
SEILF,0,0,0,1,1,5
EILFA,0,0,0,1,1,5
ILFAQ,0,0,0,1,1,5
VYGPF,0,0,0,1,1,5
YGPFW,0,0,0,1,1,5
GPFWK,0,0,0,1,1,5
PFWKN,0,0,0,1,1,5
FWKNW,0,0,0,1,1,5
WKNWQ,0,0,0,1,1,5
KNWQA,0,0,0,1,1,5
NWQAQ,0,0,0,1,1,5
WATLL,0,0,0,1,1,5
ATLLA,0,0,0,1,1,5
TLLAQ,0,0,0,1,1,5
LLAQW,0,0,0,1,1,5
LAQWA,0,0,0,1,1,5
AQWAD,0,0,0,1,1,5
QWADR,0,0,0,1,1,5
WADRA,0,0,0,1,1,5
ADRAL,0,0,0,1,1,5
WDDIR,0,0,0,1,1,5
DDIRN,0,0,0,1,1,5
DIRND,0,0,0,1,1,5
IRNDL,0,0,0,1,1,5
RNDLF,0,0,0,1,1,5
NDLFR,0,0,0,1,1,5
DLFRI,0,0,0,1,1,5
LFRIQ,0,0,0,1,1,5
FRIQN,0,0,0,1,1,5
RIQND,0,0,0,1,1,5
IQNDL,0,0,0,1,1,5
QNDLF,0,0,0,1,1,5
NDLFV,0,0,0,1,1,5
DLFVL,0,0,0,1,1,5
LFVLG,0,0,0,1,1,5
FVLGE,0,0,0,1,1,5
VLGED,0,0,0,1,1,5
LGEDV,0,0,0,1,1,5
GEDVS,0,0,0,1,1,5
EDVST,0,0,0,1,1,5
YAKGA,0,0,0,1,1,5
AKGAL,0,0,0,1,1,5
KGALQ,0,0,0,1,1,5
GALQY,0,0,0,1,1,5
ALQYL,0,0,0,1,1,5
LQYLV,0,0,0,1,1,5
QYLVP,0,0,0,1,1,5
YLVPI,0,0,0,1,1,5
LVPIL,0,0,0,1,1,5
VPILT,0,0,0,1,1,5
PILTQ,0,0,0,1,1,5
ILTQT,0,0,0,1,1,5
LTQTL,0,0,0,1,1,5
TQTLT,0,0,0,1,1,5
YDDII,0,0,0,1,1,5
DDIIE,0,0,0,1,1,5
IIEAA,0,0,0,1,1,5
IEAAG,0,0,0,1,1,5
EAAGE,0,0,0,1,1,5
AAGEL,0,0,0,1,1,5
AGELG,0,0,0,1,1,5
YDLLK,0,0,0,1,1,5
DLLKD,0,0,0,1,1,5
LLKDL,0,0,0,1,1,5
LKDLE,0,0,0,1,1,5
KDLEE,0,0,0,1,1,5
DLEEG,0,0,0,1,1,5
LEEGI,0,0,0,1,1,5
EEGIQ,0,0,0,1,1,5
EGIQT,0,0,0,1,1,5
GIQTL,0,0,0,1,1,5
IQTLM,0,0,0,1,1,5
QTLMG,0,0,0,1,1,5
TLMGR,0,0,0,1,1,5
LMGRL,0,0,0,1,1,5
YEDKA,0,0,0,1,1,5
EDKAV,0,0,0,1,1,5
DKAVE,0,0,0,1,1,5
KAVEL,0,0,0,1,1,5
AVELY,0,0,0,1,1,5
VELYS,0,0,0,1,1,5
ELYSR,0,0,0,1,1,5
LYSRT,0,0,0,1,1,5
YSRTA,0,0,0,1,1,5
SRTAR,0,0,0,1,1,5
YETLE,0,0,0,1,1,5
ETLEF,0,0,0,1,1,5
TLEFL,0,0,0,1,1,5
LEFLG,0,0,0,1,1,5
EFLGD,0,0,0,1,1,5
FLGDA,0,0,0,1,1,5
LGDAL,0,0,0,1,1,5
GDALV,0,0,0,1,1,5
DALVN,0,0,0,1,1,5
ALVNF,0,0,0,1,1,5
LVNFF,0,0,0,1,1,5
VNFFI,0,0,0,1,1,5
NFFIV,0,0,0,1,1,5
FFIVD,0,0,0,1,1,5
FIVDL,0,0,0,1,1,5
IVDLL,0,0,0,1,1,5
VDLLV,0,0,0,1,1,5
DLLVQ,0,0,0,1,1,5
LLVQY,0,0,0,1,1,5
LVQYS,0,0,0,1,1,5
YFSKG,0,0,0,1,1,5
FSKGI,0,0,0,1,1,5
SKGIP,0,0,0,1,1,5
KGIPN,0,0,0,1,1,5
GIPNV,0,0,0,1,1,5
IPNVL,0,0,0,1,1,5
PNVLR,0,0,0,1,1,5
NVLRR,0,0,0,1,1,5
YGSIG,0,0,0,1,1,5
GSIGL,0,0,0,1,1,5
SIGLT,0,0,0,1,1,5
IGLTN,0,0,0,1,1,5
GLTNF,0,0,0,1,1,5
LTNFG,0,0,0,1,1,5
TNFGY,0,0,0,1,1,5
NFGYL,0,0,0,1,1,5
FGYLD,0,0,0,1,1,5
GYLDK,0,0,0,1,1,5
YLDKE,0,0,0,2,2,5
YKEPL,0,0,0,1,1,5
KEPLK,0,0,0,1,1,5
EPLKA,0,0,0,1,1,5
PLKAV,0,0,0,1,1,5
LKAVV,0,0,0,1,1,5
KAVVK,0,0,0,1,1,5
AVVKK,0,0,0,1,1,5
VVKKL,0,0,0,1,1,5
VKKLL,0,0,0,1,1,5
KKLLE,0,0,0,1,1,5
KLLEK,0,0,0,1,1,5
LLEKE,0,0,0,1,1,5
YKKFR,0,0,0,1,1,5
KKFRQ,0,0,0,1,1,5
KFRQL,0,0,0,1,1,5
FRQLI,0,0,0,1,1,5
RQLIQ,0,0,0,1,1,5
QLIQV,0,0,0,1,1,5
LIQVN,0,0,0,1,1,5
YLADL,0,0,0,1,1,5
LADLF,0,0,0,1,1,5
ADLFL,0,0,0,1,1,5
LFLAP,0,0,0,1,1,5
FLAPQ,0,0,0,1,1,5
LAPQI,0,0,0,1,1,5
APQIH,0,0,0,1,1,5
PQIHG,0,0,0,1,1,5
QIHGA,0,0,0,1,1,5
IHGAI,0,0,0,1,1,5
HGAIN,0,0,0,1,1,5
GAINR,0,0,0,1,1,5
AINRF,0,0,0,1,1,5
INRFQ,0,0,0,1,1,5
LDKEV,0,0,0,1,1,5
DKEVK,0,0,0,1,1,5
KEVKL,0,0,0,1,1,5
EVKLI,0,0,0,1,1,5
VKLIK,0,0,0,1,1,5
LIKKM,0,0,0,1,1,5
IKKMG,0,0,0,1,1,5
KKMGN,0,0,0,1,1,5
KMGNH,0,0,0,1,1,5
MGNHL,0,0,0,1,1,5
GNHLT,0,0,0,1,1,5
NHLTN,0,0,0,1,1,5
HLTNL,0,0,0,1,1,5
LTNLR,0,0,0,1,1,5
TNLRR,0,0,0,1,1,5
NLRRV,0,0,0,1,1,5
LRRVA,0,0,0,1,1,5
YLSES,0,0,0,1,1,5
LSESV,0,0,0,1,1,5
SESVE,0,0,0,1,1,5
ESVET,0,0,0,1,1,5
SVETI,0,0,0,1,1,5
VETIK,0,0,0,1,1,5
ETIKK,0,0,0,1,1,5
TIKKL,0,0,0,1,1,5
KKLGD,0,0,0,1,1,5
KLGDH,0,0,0,1,1,5
LGDHI,0,0,0,1,1,5
GDHIT,0,0,0,1,1,5
DHITS,0,0,0,1,1,5
HITSL,0,0,0,1,1,5
ITSLK,0,0,0,1,1,5
TSLKK,0,0,0,1,1,5
SLKKL,0,0,0,1,1,5
LKKLW,0,0,0,1,1,5
YPIVD,0,0,0,1,1,5
PIVDA,0,0,0,1,1,5
IVDAA,0,0,0,1,1,5
VDAAM,0,0,0,1,1,5
DAAMR,0,0,0,1,1,5
AAMRQ,0,0,0,1,1,5
AMRQL,0,0,0,1,1,5
MRQLT,0,0,0,1,1,5
RQLTE,0,0,0,1,1,5
QLTET,0,0,0,1,1,5
LTETG,0,0,0,1,1,5
YQNIV,0,0,0,1,1,5
QNIVK,0,0,0,1,1,5
NIVKA,0,0,0,1,1,5
IVKAV,0,0,0,1,1,5
VKAVQ,0,0,0,1,1,5
KAVQY,0,0,0,1,1,5
AVQYA,0,0,0,1,1,5
VQYAA,0,0,0,1,1,5
QYAAR,0,0,0,1,1,5
YAARK,0,0,0,1,1,5
AARKL,0,0,0,1,1,5
ARKLQ,0,0,0,1,1,5
YQQQK,0,0,0,1,1,5
QQQKK,0,0,0,1,1,5
QQKKY,0,0,0,1,1,5
QKKYL,0,0,0,1,1,5
KKYLG,0,0,0,1,1,5
KYLGR,0,0,0,1,1,5
YLGRM,0,0,0,1,1,5
LGRMT,0,0,0,1,1,5
GRMTE,0,0,0,1,1,5
AIGKFL,0,1,0,0,1,6
IGKFLH,3,6,0,0,9,6
GKFLHS,0,5,0,0,5,6
KFLHSA,0,6,1,0,7,6
FLHSAK,0,6,1,0,7,6
LHSAKK,0,6,1,0,7,6
HSAKKF,0,6,1,0,7,6
SAKKFG,0,2,0,0,2,6
AKKFGK,0,2,1,0,3,6
KKFGKA,0,2,1,0,3,6
KFGKAF,0,2,1,0,3,6
FGKAFV,0,2,1,0,3,6
GKAFVG,0,2,0,0,2,6
KAFVGE,0,2,0,0,2,6
AFVGEI,0,2,0,0,2,6
FVGEIM,0,2,0,0,2,6
VGEIMN,0,2,0,0,2,6
GEIMNS,0,2,0,0,2,6
FAKALA,0,1,0,0,1,6
AKALAK,0,1,0,0,1,6
KALAKL,0,1,1,0,2,6
ALAKLA,0,2,0,0,2,6
LAKLAK,2,9,14,0,25,6
AKLAKK,2,7,15,0,24,6
KLAKKL,2,17,16,0,35,6
LAKKLL,1,3,1,0,5,6
FAKALK,0,1,0,0,1,6
AKALKA,0,1,0,0,1,6
KALKAL,0,4,0,0,4,6
ALKALL,0,1,0,0,1,6
LKALLK,0,1,1,0,2,6
KALLKA,0,1,0,0,1,6
ALLKAL,0,1,2,0,3,6
LLKALK,0,1,1,0,2,6
LKALKA,0,1,1,0,2,6
FAKFLA,0,1,0,0,1,6
AKFLAK,0,1,0,0,1,6
KFLAKF,0,1,0,0,1,6
FLAKFL,0,1,0,0,1,6
LAKFLK,0,2,0,0,2,6
AKFLKK,0,2,0,0,2,6
KFLKKA,1,2,1,0,4,6
FLKKAL,0,2,0,0,2,6
FAKIIA,0,0,1,0,1,6
AKIIAK,0,0,1,0,1,6
KIIAKI,0,0,1,0,1,6
IIAKIA,0,0,1,0,1,6
IAKIAK,0,0,2,0,2,6
AKIAKI,0,0,1,0,1,6
KIAKIA,0,0,1,0,1,6
AKIAKK,0,0,1,0,1,6
KIAKKI,0,0,1,0,1,6
IAKKIL,0,0,1,0,1,6
FAKKFA,0,2,0,0,2,6
AKKFAK,1,4,0,0,5,6
KKFAKK,0,4,0,0,4,6
KFAKKF,0,2,0,0,2,6
FAKKFK,0,1,0,0,1,6
AKKFKK,0,1,0,0,1,6
KKFKKF,0,1,0,0,1,6
KFKKFA,0,1,0,0,1,6
FKKFAK,0,3,0,0,3,6
KKFAKF,0,1,0,0,1,6
KFAKFA,0,1,0,0,1,6
FAKFAF,0,1,0,0,1,6
AKFAFA,0,1,0,0,1,6
KFAFAF,0,1,0,0,1,6
FAKKLA,0,9,11,0,20,6
AKKLAK,2,14,17,0,33,6
KKLAKK,0,15,11,0,26,6
LAKKLA,1,5,6,0,12,6
KKLAKA,0,0,2,0,2,6
KLAKAA,0,0,1,0,1,6
LAKAAL,0,0,1,0,1,6
KLAKAL,0,1,1,0,2,6
KKLAKL,2,8,9,0,19,6
KLAKLA,2,9,7,0,18,6
LAKLAL,1,4,3,0,8,6
KLAKLL,0,0,2,0,2,6
LAKKLK,0,6,4,0,10,6
AKKLKK,0,6,5,0,11,6
KKLKKL,0,7,5,0,12,6
KLKKLA,0,7,5,0,12,6
LKKLAK,0,9,6,0,15,6
KLAKKW,0,1,0,0,1,6
LAKKWK,0,1,0,0,1,6
AKKWKL,0,1,0,0,1,6
AKLALA,0,2,2,0,4,6
KLALAL,0,2,1,0,3,6
LALALK,0,1,0,0,1,6
ALALKA,0,6,4,0,10,6
LALKAL,0,6,5,0,11,6
ALKALA,0,1,0,0,1,6
LKALAL,0,1,0,0,1,6
KALALK,0,1,0,0,1,6
LAKKLI,0,1,0,0,1,6
AKKLIG,0,1,0,0,1,6
KKLIGA,0,1,0,0,1,6
KLIGAV,0,1,0,0,1,6
LIGAVL,0,1,0,0,1,6
IGAVLK,1,4,0,0,5,6
GAVLKV,1,4,0,0,5,6
KLALAK,0,0,1,0,1,6
KLAKKA,0,4,7,0,11,6
LAKKAL,0,3,5,0,8,6
AKKALA,0,0,3,0,3,6
KKALAL,0,0,2,0,2,6
AKKLLA,0,1,1,0,2,6
KKLLAL,0,1,0,0,1,6
AKLALK,0,1,0,0,1,6
KLALKL,0,1,1,0,2,6
LALKLA,0,1,2,0,3,6
ALKLAK,0,1,1,0,2,6
LKLAKL,0,1,0,0,1,6
FAKKLK,0,0,1,0,1,6
FAKKLL,0,0,1,0,1,6
KKLLAK,0,0,1,0,1,6
KLLAKA,1,3,3,0,7,6
LLAKAL,1,3,3,0,7,6
LAKALK,1,3,3,0,7,6
AKALKL,0,0,2,0,2,6
FAKLAK,0,0,2,0,2,6
KKALAK,0,0,1,0,1,6
ALAKLL,0,0,1,0,1,6
FAKLFA,0,0,1,0,1,6
AKLFAK,0,0,1,0,1,6
KLFAKL,0,0,1,0,1,6
LFAKLA,0,0,1,0,1,6
KLAKKF,1,0,2,0,3,6
LAKKFA,0,0,2,0,2,6
AKKFAL,0,0,2,0,2,6
FAKLLA,2,5,11,0,18,6
AKLLAK,2,6,12,0,20,6
AKALKK,1,4,1,0,6,6
KALKKA,0,5,7,0,12,6
ALKKAL,0,6,7,0,13,6
KALKKF,0,2,0,0,2,6
ALKKFA,0,1,0,0,1,6
LKKFAL,0,1,0,0,1,6
ALKKFL,0,1,0,0,1,6
KALKKL,1,7,4,0,12,6
ALKKLL,1,1,0,0,2,6
KALKLK,0,0,1,0,1,6
ALKLKL,0,0,1,0,1,6
KLLAKF,0,1,0,0,1,6
LLAKFL,0,1,0,0,1,6
KLLAKL,1,2,10,0,13,6
LLAKLA,1,2,10,0,13,6
AKLAKA,0,1,1,0,2,6
KLAKAK,0,0,1,0,1,6
LAKAKL,0,0,1,0,1,6
LAKKAA,0,0,1,0,1,6
KLAKKG,0,0,1,0,1,6
LAKKGL,0,0,1,0,1,6
KLAKKI,0,0,1,0,1,6
LAKKIL,0,0,1,0,1,6
KLAKKS,0,0,1,0,1,6
LAKKSL,0,0,1,0,1,6
KLAKKV,0,1,1,0,2,6
LAKKVL,0,1,1,0,2,6
AKLAKL,0,1,1,0,2,6
KLAKLK,0,0,1,0,1,6
LAKLKL,0,0,1,0,1,6
FAKLLF,0,0,1,0,1,6
AKLLFK,0,0,1,0,1,6
KLLFKA,0,0,1,0,1,6
LLFKAL,0,0,1,0,1,6
LFKALK,0,0,1,0,1,6
FKALKK,0,0,1,0,1,6
FAKLLK,0,0,1,0,1,6
AKLLKL,0,0,1,0,1,6
KLLKLA,0,0,1,0,1,6
LLKLAA,0,0,1,0,1,6
LKLAAK,0,0,1,0,1,6
KLAAKK,0,0,1,0,1,6
LAAKKL,0,0,1,0,1,6
AAKKLL,0,0,1,0,1,6
FAKLWA,0,1,1,0,2,6
AKLWAK,0,1,1,0,2,6
KLWAKL,0,1,1,0,2,6
LWAKLA,0,1,1,0,2,6
WAKLAF,0,1,0,0,1,6
AKLAFG,0,1,0,0,1,6
KLAFGK,0,1,0,0,1,6
LAFGKG,0,1,0,0,1,6
AFGKGI,0,1,0,0,1,6
FGKGIG,0,1,0,0,1,6
GKGIGK,0,1,0,0,1,6
KGIGKV,0,1,0,0,1,6
GIGKVG,0,1,0,0,1,6
IGKVGK,0,1,0,0,1,6
GKVGKK,0,1,0,0,1,6
KVGKKL,0,1,0,0,1,6
VGKKLL,0,1,0,0,1,6
WAKLAK,0,0,1,0,1,6
FALAAK,0,1,0,0,1,6
ALAAKA,0,1,0,0,1,6
LAAKAL,0,1,0,0,1,6
AAKALK,0,1,0,0,1,6
ALKKLA,0,2,1,0,3,6
FALAKL,0,1,0,0,1,6
LAKKAK,0,1,0,0,1,6
AKKAKA,0,1,0,0,1,6
KKAKAK,0,1,0,0,1,6
KAKAKL,0,1,0,0,1,6
AKAKLK,0,1,0,0,1,6
KAKLKK,0,1,0,0,1,6
AKLKKA,0,1,0,0,1,6
KLKKAL,0,4,2,0,6,6
LKKALK,0,5,4,0,9,6
KKALKA,0,2,0,0,2,6
FALALK,0,5,4,0,9,6
ALKALK,0,6,5,0,11,6
LKALKK,0,6,5,0,11,6
KKALKK,0,4,5,0,9,6
ALKKLK,0,3,2,0,5,6
LKKLKK,0,4,2,1,7,6
KKLKKA,0,3,2,0,5,6
LKKLLK,0,1,0,0,1,6
KKLLKK,0,1,0,0,1,6
KLLKKL,1,2,0,0,3,6
LLKKLK,0,1,0,1,2,6
ALALKK,0,1,0,0,1,6
LALKKA,0,1,0,0,1,6
ALALKL,0,0,1,0,1,6
LKLAKK,0,0,1,0,1,6
FALKAL,0,1,0,0,1,6
FALLKA,0,0,2,0,2,6
LLKALL,0,0,1,0,1,6
KALLKK,0,0,1,0,1,6
ALLKKA,0,0,1,0,1,6
LLKKAL,0,0,1,0,1,6
FAVGLR,0,0,1,0,1,6
AVGLRA,0,0,1,0,1,6
VGLRAI,0,0,1,0,1,6
GLRAIK,0,0,1,0,1,6
LRAIKR,0,0,1,0,1,6
RAIKRA,0,0,1,0,1,6
AIKRAL,0,0,1,0,1,6
IKRALK,0,0,1,0,1,6
KRALKK,0,0,1,0,1,6
RALKKL,0,0,1,0,1,6
ALKKLR,0,0,1,0,1,6
LKKLRR,0,0,1,0,1,6
KKLRRG,0,0,1,0,1,6
KLRRGV,0,0,1,0,1,6
LRRGVR,0,0,1,0,1,6
RRGVRK,0,0,1,0,1,6
RGVRKV,0,0,1,0,1,6
GVRKVA,0,0,1,0,1,6
VRKVAK,0,0,1,0,1,6
RKVAKD,0,0,1,0,1,6
KVAKDL,0,0,1,0,1,6
FKLAFK,0,0,1,0,1,6
KLAFKL,0,0,1,0,1,6
LAFKLA,0,0,1,0,1,6
AFKLAK,0,0,1,0,1,6
FKLAKK,1,0,1,0,2,6
LAKKAF,0,0,1,0,1,6
AKKAFL,0,0,1,0,1,6
FKRLAK,0,1,0,0,1,6
KRLAKI,0,1,0,0,1,6
RLAKIK,0,2,0,0,2,6
LAKIKV,0,1,0,0,1,6
AKIKVL,0,1,0,0,1,6
KIKVLR,0,1,0,0,1,6
IKVLRL,0,1,0,0,1,6
KVLRLA,0,1,0,0,1,6
VLRLAK,0,1,0,0,1,6
LRLAKI,0,1,0,0,1,6
LAKIKR,0,1,0,0,1,6
FKVKFK,0,0,2,0,2,6
KVKFKV,0,0,1,0,1,6
VKFKVK,0,0,1,0,1,6
KFKVKV,0,0,1,0,1,6
FKVKVK,0,0,1,0,1,6
FLGALF,0,3,0,0,3,6
LGALFH,0,1,0,0,1,6
GALFHA,0,1,0,0,1,6
ALFHAL,0,1,0,0,1,6
LFHALS,0,1,0,0,1,6
FHALSK,0,1,0,0,1,6
HALSKL,0,1,0,0,1,6
ALSKLL,0,2,0,0,2,6
LGALFK,0,2,0,0,2,6
GALFKA,0,2,0,0,2,6
ALFKAL,0,2,0,0,2,6
LFKALS,0,2,0,0,2,6
FKALSH,0,1,0,0,1,6
KALSHL,0,1,0,0,1,6
ALSHLL,0,1,0,0,1,6
FKALSK,0,1,0,0,1,6
KALSKL,0,1,0,0,1,6
FLGMIP,2,0,0,0,2,6
LGMIPG,1,0,0,0,1,6
GMIPGL,1,0,0,0,1,6
MIPGLI,1,0,0,0,1,6
IPGLIG,1,0,0,0,1,6
PGLIGG,1,0,0,0,1,6
GLIGGL,1,0,0,0,1,6
LIGGLI,1,0,0,0,1,6
IGGLIS,1,0,0,0,1,6
GGLISA,1,0,0,0,1,6
GLISAF,1,0,0,0,1,6
LISAFK,1,0,0,0,1,6
LGMIPK,1,0,0,0,1,6
GMIPKL,1,0,0,0,1,6
MIPKLI,1,0,0,0,1,6
IPKLIK,1,0,0,0,1,6
PKLIKK,1,0,0,0,1,6
KLIKKL,1,0,0,0,1,6
LIKKLI,1,0,0,0,1,6
IKKLIK,1,0,0,0,1,6
KKLIKA,1,0,0,0,1,6
KLIKAF,1,0,0,0,1,6
LIKAFK,1,0,0,0,1,6
FLGWLF,0,2,0,0,2,6
LGWLFK,0,2,0,0,2,6
GWLFKW,0,2,0,0,2,6
WLFKWA,0,4,0,0,4,6
LFKWAK,0,2,0,0,2,6
FKWAKK,0,2,0,0,2,6
LFKWAW,0,2,0,0,2,6
FKWAWK,0,2,0,0,2,6
FLKLLA,0,1,0,0,1,6
LKLLAG,0,1,0,0,1,6
KLLAGL,0,1,0,0,1,6
LLAGLL,0,1,0,0,1,6
LAGLLK,0,1,0,0,1,6
AGLLKN,0,1,0,0,1,6
GLLKNF,0,1,0,0,1,6
LLKNFA,0,1,0,0,1,6
FLKLLK,1,1,0,0,2,6
LKLLKK,1,1,0,0,2,6
LLKKLA,1,1,0,0,2,6
LKKLAA,1,1,0,0,2,6
KKLAAK,1,1,0,0,2,6
KLAAKF,1,0,0,0,1,6
LAAKFL,1,0,0,0,1,6
AAKFLP,1,0,0,0,1,6
AKFLPT,1,0,0,0,1,6
KFLPTI,1,0,0,0,1,6
FLPTII,1,0,0,0,1,6
LPTIIC,1,0,0,0,1,6
PTIICK,1,0,0,0,1,6
TIICKI,1,0,0,0,1,6
IICKIS,1,0,0,0,1,6
ICKISY,1,0,0,0,1,6
CKISYK,1,0,0,0,1,6
KISYKC,1,0,0,0,1,6
KLAAKL,0,1,0,0,1,6
LAAKLF,0,1,0,0,1,6
FLKWLF,0,1,0,0,1,6
LKWLFK,0,1,0,0,1,6
KWLFKW,0,1,0,0,1,6
FLSLIP,1,0,1,0,2,6
LSLIPK,1,0,0,0,1,6
SLIPKL,1,0,0,0,1,6
LIPKLV,1,0,0,0,1,6
IPKLVK,1,0,0,0,1,6
PKLVKK,1,0,0,0,1,6
KLVKKI,1,0,0,0,1,6
LVKKII,1,0,0,0,1,6
VKKIIK,1,0,0,0,1,6
KKIIKA,1,0,0,0,1,6
KIIKAF,1,0,0,0,1,6
IIKAFK,1,0,0,0,1,6
LSLIPS,0,0,1,0,1,6
SLIPSL,0,0,1,0,1,6
LIPSLV,0,0,1,0,1,6
IPSLVG,0,0,1,0,1,6
PSLVGG,0,0,1,0,1,6
SLVGGS,0,0,1,0,1,6
LVGGSI,0,0,1,0,1,6
VGGSIS,0,0,1,0,1,6
GGSISA,0,0,1,0,1,6
GSISAF,0,0,1,0,1,6
SISAFK,0,0,1,0,1,6
FLWWLF,0,1,0,0,1,6
LWWLFK,0,1,0,0,1,6
WWLFKW,0,1,0,0,1,6
GIGAVL,1,2,0,0,3,6
AVLKVL,1,3,0,0,4,6
VLKVLT,0,2,0,0,2,6
LKVLTT,0,2,0,0,2,6
KVLTTG,0,2,0,0,2,6
VLTTGL,0,1,0,0,1,6
LTTGLP,0,1,0,0,1,6
TTGLPA,0,1,0,0,1,6
TGLPAL,0,1,0,0,1,6
GLPALI,0,1,0,0,1,6
LPALIS,0,1,0,0,1,6
PALISW,0,1,0,0,1,6
ALISWI,0,1,0,0,1,6
LISWIK,0,1,0,0,1,6
ISWIKR,0,1,0,0,1,6
SWIKRK,0,1,0,0,1,6
WIKRKR,0,1,0,0,1,6
IKRKRQ,0,1,0,0,1,6
KRKRQQ,0,1,0,0,1,6
GIGKFL,4,5,1,0,10,6
GKFLHA,0,1,0,0,1,6
KFLHAA,0,1,0,0,1,6
FLHAAK,0,1,0,0,1,6
LHAAKK,0,1,0,0,1,6
HAAKKF,0,1,0,0,1,6
AAKKFA,0,1,0,0,1,6
KKFAKA,1,2,0,0,3,6
KFAKAF,1,2,0,0,3,6
FAKAFV,1,2,0,0,3,6
AKAFVA,0,2,0,0,2,6
KAFVAE,0,2,0,0,2,6
AFVAEI,0,2,0,0,2,6
FVAEIM,0,2,0,0,2,6
VAEIMN,0,2,0,0,2,6
AEIMNS,0,2,0,0,2,6
SAKKFA,0,1,0,0,1,6
IGKFLK,1,0,1,0,2,6
GKFLKK,1,0,1,0,2,6
FLKKAK,1,0,1,0,2,6
LKKAKK,1,0,1,0,2,6
KKAKKF,1,0,1,0,2,6
KAKKFA,1,0,0,0,1,6
AKAFVK,1,0,0,0,1,6
KAFVKI,1,0,1,0,2,6
AFVKII,1,0,0,0,1,6
FVKIIN,1,0,0,0,1,6
VKIINN,1,0,0,0,1,6
KAKKFG,0,0,1,0,1,6
GKAFVK,0,0,1,0,1,6
AFVKIL,0,0,1,0,1,6
FVKILK,0,0,1,0,1,6
VKILKK,0,0,1,0,1,6
GLFAVI,2,4,0,0,6,6
LFAVIK,2,4,0,0,6,6
FAVIKK,2,4,0,0,6,6
AVIKKV,2,4,0,0,6,6
VIKKVA,2,10,0,0,12,6
IKKVAA,0,3,0,0,3,6
KKVAAV,0,3,0,0,3,6
KVAAVI,0,3,0,0,3,6
VAAVIK,0,1,0,0,1,6
AAVIKK,0,1,0,0,1,6
AVIKKL,0,1,0,0,1,6
VAAVIR,0,1,0,0,1,6
AAVIRR,0,1,0,0,1,6
AVIRRL,0,1,0,0,1,6
IKKVAK,1,1,0,0,2,6
KKVAKV,1,1,0,0,2,6
KVAKVI,1,1,0,0,2,6
VAKVIK,1,1,0,0,2,6
AKVIKK,1,1,0,0,2,6
KVIKKL,1,1,0,0,2,6
IKKVAS,1,6,0,0,7,6
KKVASV,1,6,0,0,7,6
KVASVI,1,7,0,0,8,6
VASVIG,1,3,0,0,4,6
ASVIGG,1,3,0,0,4,6
SVIGGL,1,3,0,0,4,6
VASVIK,0,5,0,0,5,6
ASVIKG,0,2,0,0,2,6
SVIKGL,0,2,0,0,2,6
ASVIKK,0,3,0,0,3,6
SVIKKL,0,3,0,0,3,6
GLFDIA,0,1,0,0,1,6
LFDIAK,0,1,0,0,1,6
FDIAKK,0,1,0,0,1,6
DIAKKV,0,1,0,0,1,6
IAKKVI,0,1,0,0,1,6
AKKVIG,0,1,0,0,1,6
KKVIGV,0,1,0,0,1,6
KVIGVI,0,1,0,0,1,6
VIGVIG,0,1,0,0,1,6
IGVIGS,0,1,0,0,1,6
GVIGSL,0,1,0,0,1,6
GLFDII,0,1,0,0,1,6
LFDIIK,0,1,0,0,1,6
FDIIKK,0,1,0,0,1,6
DIIKKI,0,1,0,0,1,6
IIKKIA,0,1,0,0,1,6
IKKIAE,0,1,0,0,1,6
KKIAES,0,1,0,0,1,6
KIAESF,0,1,0,0,1,6
GLFDIV,0,4,0,0,4,6
LFDIVK,0,4,0,0,4,6
FDIVKK,0,4,0,0,4,6
DIVKKI,0,3,0,0,3,6
IVKKIA,0,3,0,0,3,6
VKKIAG,0,3,0,0,3,6
KKIAGH,0,3,0,0,3,6
KIAGHI,0,3,0,0,3,6
IAGHIA,0,2,0,0,2,6
AGHIAG,0,1,0,0,1,6
GHIAGS,0,1,0,0,1,6
HIAGSI,0,1,0,0,1,6
AGHIAS,0,1,0,0,1,6
GHIASS,0,1,0,0,1,6
HIASSI,0,1,0,0,1,6
IAGHIV,0,1,0,0,1,6
AGHIVS,0,1,0,0,1,6
GHIVSS,0,1,0,0,1,6
HIVSSI,0,1,0,0,1,6
DIVKKV,0,1,0,0,1,6
IVKKVV,0,1,0,0,1,6
VKKVVG,0,1,0,0,1,6
KKVVGA,0,1,0,0,1,6
KVVGAF,0,1,0,0,1,6
VVGAFG,0,1,0,0,1,6
VGAFGS,0,1,0,0,1,6
GAFGSL,0,1,0,0,1,6
GLFDVI,0,6,0,1,7,6
LFDVIA,0,1,0,0,1,6
FDVIAK,0,1,0,0,1,6
DVIAKV,0,1,0,0,1,6
VIAKVA,0,1,0,0,1,6
IAKVAS,0,1,0,0,1,6
AKVASV,0,1,0,0,1,6
LFDVIK,0,5,0,0,5,6
FDVIKA,0,1,0,0,1,6
DVIKAV,0,1,0,0,1,6
VIKAVA,0,1,0,0,1,6
IKAVAS,0,1,0,0,1,6
KAVASV,0,1,0,0,1,6
AVASVI,0,1,0,0,1,6
FDVIKK,0,4,0,0,4,6
DVIKKV,0,4,0,0,4,6
VAAVIG,0,1,0,0,1,6
AAVIGG,0,1,0,0,1,6
AVIGGL,0,1,0,0,1,6
GLFKVI,0,2,0,0,2,6
LFKVIK,0,2,0,0,2,6
FKVIKK,0,2,0,0,2,6
KVIKKV,0,2,0,0,2,6
ILPWKW,0,0,1,0,1,6
LPWKWP,0,0,1,0,1,6
PWKWPW,0,0,1,0,1,6
WKWPWW,0,0,1,0,1,6
KWPWWP,0,0,1,0,1,6
WPWWPW,0,0,1,0,1,6
PWWPWR,0,0,1,0,1,6
WWPWRR,0,0,1,0,1,6
KKKFPW,4,1,0,0,5,6
KKFPWW,4,1,0,0,5,6
KFPWWW,4,1,0,0,5,6
FPWWWP,4,1,0,0,5,6
PWWWPF,4,1,0,0,5,6
WWWPFK,4,1,0,0,5,6
WWPFKK,4,1,0,0,5,6
WPFKKK,4,1,0,0,5,6
PFKKKC,2,0,0,0,2,6
FKKKCK,1,0,0,0,1,6
KKKCKK,1,0,0,0,1,6
KKCKKK,1,0,0,0,1,6
KCKKKF,1,0,0,0,1,6
CKKKFP,1,0,0,0,1,6
PFKKKK,2,0,0,0,2,6
FKKKKK,1,0,0,0,1,6
KKKKKK,1,0,0,0,1,6
KKKKKF,1,0,0,0,1,6
KKKKFP,1,0,0,0,1,6
KKVVFK,0,0,1,0,1,6
KVVFKV,0,0,1,0,1,6
VVFKVK,0,0,1,0,1,6
VFKVKF,0,0,1,0,1,6
ALKLAL,0,0,1,0,1,6
LKLALK,0,0,1,0,1,6
KLALKA,0,0,1,0,1,6
KALKAA,0,0,1,0,1,6
ALKAAK,0,0,1,0,1,6
LKAAKL,0,0,1,0,1,6
KAAKLA,0,0,1,0,1,6
KTKLFK,0,2,0,0,2,6
TKLFKK,0,2,0,0,2,6
KLFKKF,0,2,0,0,2,6
LFKKFA,0,2,0,0,2,6
KFAKKL,0,2,0,0,2,6
KWKKFL,1,0,0,0,1,6
WKKFLK,1,0,0,0,1,6
KKFLKI,1,0,0,0,1,6
KFLKIG,1,0,0,0,1,6
FLKIGI,1,0,0,0,1,6
LKIGIG,1,0,0,0,1,6
KIGIGK,4,2,0,0,6,6
IGIGKF,4,2,0,0,6,6
GKFLHL,3,0,0,0,3,6
KFLHLA,3,0,0,0,3,6
FLHLAK,4,0,0,0,4,6
LHLAKK,4,0,0,0,4,6
HLAKKF,4,0,0,0,4,6
KWKLAK,0,0,1,0,1,6
WKLAKK,0,0,1,0,1,6
KALALL,0,0,1,0,1,6
KWKLFA,1,0,0,0,1,6
WKLFAK,1,0,0,0,1,6
KLFAKI,1,0,0,0,1,6
LFAKIG,1,0,0,0,1,6
FAKIGI,1,0,0,0,1,6
AKIGIG,1,0,0,0,1,6
KWKLFK,4,8,1,0,13,6
WKLFKK,4,8,1,0,13,6
KLFKKA,0,1,0,0,1,6
LFKKAL,0,1,0,0,1,6
FKKALK,0,1,0,0,1,6
KLFKKI,4,6,1,0,11,6
LFKKIG,4,5,0,0,9,6
FKKIGA,0,1,0,0,1,6
KKIGAV,0,1,0,0,1,6
KIGAVL,0,1,0,0,1,6
FKKIGI,4,4,0,0,8,6
KKIGIG,4,4,0,0,8,6
KIGIGA,2,2,0,0,4,6
IGIGAF,1,1,0,0,2,6
GIGAFL,1,1,0,0,2,6
IGAFLH,1,1,0,0,2,6
GAFLHL,1,0,0,0,1,6
AFLHLA,1,0,0,0,1,6
GAFLHS,0,1,0,0,1,6
AFLHSA,0,1,0,0,1,6
IGIGAV,1,1,0,0,2,6
VLKVLK,1,0,0,0,1,6
LKVLKK,1,0,0,0,1,6
KVLKKG,1,0,0,0,1,6
GIGKFK,1,0,0,0,1,6
IGKFKL,1,0,0,0,1,6
GKFKLA,1,0,0,0,1,6
KFKLAK,1,0,0,0,1,6
FLHSAT,0,1,0,0,1,6
LHSATT,0,1,0,0,1,6
HSATTF,0,1,0,0,1,6
LFKKIK,0,0,1,0,1,6
FKKIKF,0,0,1,0,1,6
KKIKFL,0,0,1,0,1,6
KIKFLH,0,0,1,0,1,6
IKFLHS,0,0,1,0,1,6
LFKKIP,0,1,0,0,1,6
FKKIPK,0,1,0,0,1,6
KKIPKF,0,1,0,0,1,6
KIPKFL,0,1,0,0,1,6
IPKFLH,0,1,0,0,1,6
PKFLHS,0,1,0,0,1,6
KLFKKK,0,1,0,0,1,6
LFKKKT,0,1,0,0,1,6
FKKKTK,0,1,0,0,1,6
KKKTKL,0,1,0,0,1,6
KKTKLF,0,1,0,0,1,6
KWKSFA,0,1,0,0,1,6
WKSFAK,0,1,0,0,1,6
KSFAKT,0,1,0,0,1,6
SFAKTF,0,1,0,0,1,6
FAKTFK,0,1,0,0,1,6
AKTFKS,0,1,0,0,1,6
KTFKSA,2,3,0,0,5,6
TFKSAK,2,3,0,0,5,6
FKSAKK,2,3,0,0,5,6
KSAKKT,2,3,0,0,5,6
SAKKTV,2,3,0,0,5,6
AKKTVL,2,1,0,0,3,6
KKTVLH,5,1,0,0,6,6
KTVLHT,5,1,0,0,6,6
TVLHTA,2,1,0,0,3,6
VLHTAL,2,1,0,0,3,6
LHTALK,2,1,0,0,3,6
HTALKA,2,2,0,0,4,6
TALKAI,2,2,0,0,4,6
ALKAIS,2,2,0,0,4,6
LKAISS,4,2,0,0,6,6
KWKSFL,5,2,0,0,7,6
WKSFLK,5,2,0,0,7,6
KSFLKT,5,2,0,0,7,6
SFLKTF,5,2,0,0,7,6
FLKTFK,5,2,0,0,7,6
LKTFKS,5,2,0,0,7,6
AKKTVA,0,2,0,0,2,6
KKTVAH,0,2,0,0,2,6
KTVAHT,0,2,0,0,2,6
TVAHTA,0,2,0,0,2,6
VAHTAA,0,1,0,0,1,6
AHTAAK,0,1,0,0,1,6
HTAAKA,0,1,0,0,1,6
TAAKAI,0,1,0,0,1,6
AAKAIS,0,1,0,0,1,6
AKAISS,0,1,0,0,1,6
VAHTAL,0,1,0,0,1,6
AHTALK,0,1,0,0,1,6
TVLHTL,3,0,0,0,3,6
VLHTLL,3,0,0,0,3,6
LHTLLK,3,0,0,0,3,6
HTLLKA,2,0,0,0,2,6
TLLKAI,2,0,0,0,2,6
LLKAIS,2,0,0,0,2,6
KTFKSL,3,0,0,0,3,6
TFKSLK,3,0,0,0,3,6
FKSLKK,3,0,0,0,3,6
KSLKKT,3,0,0,0,3,6
SLKKTV,3,0,0,0,3,6
LKKTVL,3,0,0,0,3,6
HTLLKL,1,0,0,0,1,6
TLLKLI,1,0,0,0,1,6
LLKLIS,1,0,0,0,1,6
LKLISS,1,0,0,0,1,6
KYKKAL,0,0,1,0,1,6
YKKALK,0,0,1,0,1,6
LGGIVS,0,1,0,0,1,6
GGIVSA,0,1,0,0,1,6
GIVSAV,0,1,0,0,1,6
IVSAVK,0,1,0,0,1,6
VSAVKK,0,1,0,0,1,6
SAVKKI,0,1,0,0,1,6
AVKKIV,0,1,0,0,1,6
VKKIVD,0,1,0,0,1,6
KKIVDF,0,1,0,0,1,6
KIVDFL,0,1,0,0,1,6
IVDFLG,0,1,0,0,1,6
LPKWKV,0,1,0,0,1,6
PKWKVF,0,1,1,0,2,6
KWKVFK,0,1,1,0,2,6
WKVFKK,0,1,1,0,2,6
KVFKKI,0,1,1,0,2,6
VFKKIE,0,1,1,0,2,6
FKKIEK,0,1,1,0,2,6
KKIEKV,0,1,1,0,2,6
KIEKVG,0,1,1,0,2,6
IEKVGR,0,1,1,0,2,6
EKVGRN,0,1,1,0,2,6
KVGRNI,0,1,1,0,2,6
VGRNIR,0,1,1,0,2,6
GRNIRN,0,1,1,0,2,6
RNIRNG,0,1,1,0,2,6
NIRNGI,0,1,1,0,2,6
IRNGIV,0,1,1,0,2,6
RNGIVK,0,1,1,0,2,6
NGIVKA,0,1,1,0,2,6
GIVKAG,0,1,1,0,2,6
IVKAGP,0,1,1,0,2,6
VKAGPA,0,1,1,0,2,6
KAGPAI,0,1,1,0,2,6
AGPAIA,0,1,1,0,2,6
GPAIAV,0,1,1,0,2,6
PAIAVL,0,1,1,0,2,6
AIAVLG,0,1,1,0,2,6
IAVLGE,0,1,1,0,2,6
AVLGEA,0,1,1,0,2,6
VLGEAK,0,1,1,0,2,6
LGEAKA,0,1,1,0,2,6
GEAKAL,0,1,1,0,2,6
EAKALG,0,1,1,0,2,6
MPKWKV,0,0,1,0,1,6
RAGLQF,1,0,0,0,1,6
AGLQFP,1,0,0,0,1,6
GLQFPV,1,0,0,0,1,6
LQFPVG,1,0,0,0,1,6
QFPVGR,1,0,0,0,1,6
FPVGRL,1,0,0,0,1,6
PVGRLL,1,0,0,0,1,6
VGRLLR,1,0,0,0,1,6
GRLLRR,1,0,0,0,1,6
RLLRRL,2,0,0,0,2,6
LLRRLL,2,0,0,0,2,6
LRRLLR,2,0,0,0,2,6
RRLLRR,1,0,0,0,1,6
VAKKLA,1,0,0,0,1,6
VAKLLA,0,1,1,0,2,6
VALALK,0,0,1,0,1,6
AADIFS,0,0,0,1,1,6
ADIFSK,0,0,0,1,1,6
DIFSKF,0,0,0,1,1,6
IFSKFK,0,0,0,1,1,6
FSKFKK,0,0,0,1,1,6
SKFKKD,0,0,0,1,1,6
KFKKDM,0,0,0,1,1,6
FKKDME,0,0,0,1,1,6
KKDMEV,0,0,0,1,1,6
KDMEVK,0,0,0,1,1,6
DMEVKF,0,0,0,1,1,6
MEVKFA,0,0,0,1,1,6
AAQKDN,0,0,0,1,1,6
AQKDNV,0,0,0,1,1,6
QKDNVK,0,0,0,1,1,6
KDNVKS,0,0,0,1,1,6
DNVKSS,0,0,0,1,1,6
NVKSSW,0,0,0,1,1,6
VKSSWA,0,0,0,1,1,6
KSSWAK,0,0,0,1,1,6
SSWAKA,0,0,0,1,1,6
SWAKAS,0,0,0,1,1,6
WAKASA,0,0,0,1,1,6
AASQRK,0,0,0,1,1,6
ASQRKL,0,0,0,1,1,6
SQRKLI,0,0,0,1,1,6
QRKLIA,0,0,0,1,1,6
RKLIAE,0,0,0,1,1,6
KLIAEK,0,0,0,1,1,6
LIAEKF,0,0,0,1,1,6
IAEKFA,0,0,0,1,1,6
AEKFAQ,0,0,0,1,1,6
EKFAQA,0,0,0,1,1,6
KFAQAL,0,0,0,1,1,6
FAQALM,0,0,0,1,1,6
AQALMS,0,0,0,1,1,6
QALMSS,0,0,0,1,1,6
ALMSSL,0,0,0,1,1,6
AAYATL,0,0,0,1,1,6
AYATLY,0,0,0,1,1,6
YATLYE,0,0,0,1,1,6
ATLYEA,0,0,0,1,1,6
TLYEAL,0,0,0,1,1,6
LYEALV,0,0,0,1,1,6
YEALVL,0,0,0,1,1,6
EALVLV,0,0,0,1,1,6
ALVLVA,0,0,0,1,1,6
LVLVAT,0,0,0,1,1,6
VLVATL,0,0,0,1,1,6
LVATLA,0,0,0,1,1,6
VATLAA,0,0,0,1,1,6
ATLAAP,0,0,0,1,1,6
AEAHES,0,0,0,1,1,6
EAHESI,0,0,0,1,1,6
AHESIR,0,0,0,1,1,6
HESIRL,0,0,0,1,1,6
ESIRLV,0,0,0,1,1,6
SIRLVF,0,0,0,1,1,6
IRLVFH,0,0,0,1,1,6
RLVFHD,0,0,0,1,1,6
LVFHDS,0,0,0,1,1,6
AEGERE,0,0,0,1,1,6
EGEREA,0,0,0,1,1,6
GEREAR,0,0,0,1,1,6
EREARV,0,0,0,1,1,6
REARVF,0,0,0,1,1,6
EARVFT,0,0,0,1,1,6
ARVFTL,0,0,0,1,1,6
RVFTLW,0,0,0,1,1,6
VFTLWL,0,0,0,1,1,6
FTLWLN,0,0,0,1,1,6
TLWLNS,0,0,0,1,1,6
LWLNSL,0,0,0,1,1,6
AEGVAT,0,0,0,1,1,6
EGVATA,0,0,0,1,1,6
GVATAD,0,0,0,1,1,6
VATADP,0,0,0,1,1,6
ATADPL,0,0,0,1,1,6
TADPLM,0,0,0,1,1,6
ADPLMR,0,0,0,1,1,6
DPLMRL,0,0,0,1,1,6
PLMRLA,0,0,0,1,1,6
LMRLAK,0,0,0,1,1,6
MRLAKQ,0,0,0,1,1,6
RLAKQL,0,0,0,1,1,6
LAKQLK,0,0,0,1,1,6
AEHAKV,0,0,0,1,1,6
EHAKVL,0,0,0,1,1,6
HAKVLM,0,0,0,1,1,6
AKVLMD,0,0,0,1,1,6
KVLMDS,0,0,0,1,1,6
VLMDSL,0,0,0,1,1,6
LMDSLT,0,0,0,1,1,6
MDSLTG,0,0,0,1,1,6
DSLTGV,0,0,0,1,1,6
SLTGVW,0,0,0,1,1,6
LTGVWD,0,0,0,1,1,6
TGVWDN,0,0,0,1,1,6
GVWDNF,0,0,0,1,1,6
VWDNFL,0,0,0,1,1,6
WDNFLT,0,0,0,1,1,6
AEHLAK,0,0,0,1,1,6
EHLAKA,0,0,0,1,1,6
HLAKAE,0,0,0,1,1,6
LAKAEL,0,0,0,1,1,6
AKAELT,0,0,0,1,1,6
KAELTT,0,0,0,1,1,6
AELTTV,0,0,0,1,1,6
ELTTVF,0,0,0,1,1,6
LTTVFS,0,0,0,1,1,6
TTVFST,0,0,0,1,1,6
TVFSTL,0,0,0,1,1,6
VFSTLY,0,0,0,1,1,6
FSTLYQ,0,0,0,1,1,6
STLYQK,0,0,0,1,1,6
TLYQKF,0,0,0,1,1,6
AEKAKY,0,0,0,1,1,6
EKAKYD,0,0,0,1,1,6
KAKYDE,0,0,0,1,1,6
AKYDEI,0,0,0,1,1,6
KYDEIF,0,0,0,1,1,6
YDEIFL,0,0,0,1,1,6
DEIFLK,0,0,0,1,1,6
EIFLKT,0,0,0,1,1,6
AFFTIA,0,0,0,1,1,6
FFTIAA,0,0,0,1,1,6
FTIAAV,0,0,0,1,1,6
TIAAVA,0,0,0,1,1,6
IAAVAR,0,0,0,1,1,6
AAVARV,0,0,0,1,1,6
AVARVL,0,0,0,1,1,6
VARVLD,0,0,0,1,1,6
AFRHSV,0,0,0,1,1,6
FRHSVK,0,0,0,1,1,6
RHSVKE,0,0,0,1,1,6
HSVKEE,0,0,0,1,1,6
SVKEEL,0,0,0,1,1,6
VKEELN,0,0,0,1,1,6
KEELNY,0,0,0,1,1,6
EELNYI,0,0,0,1,1,6
ELNYIR,0,0,0,1,1,6
LNYIRR,0,0,0,1,1,6
NYIRRR,0,0,0,1,1,6
YIRRRL,0,0,0,1,1,6
IRRRLE,0,0,0,1,1,6
RRRLER,0,0,0,1,1,6
RRLERF,0,0,0,1,1,6
RLERFP,0,0,0,1,1,6
LERFPN,0,0,0,1,1,6
ERFPNR,0,0,0,1,1,6
RFPNRL,0,0,0,1,1,6
AGDVLH,0,0,0,1,1,6
GDVLHN,0,0,0,1,1,6
DVLHNV,0,0,0,1,1,6
VLHNVL,0,0,0,1,1,6
LHNVLQ,0,0,0,1,1,6
HNVLQM,0,0,0,1,1,6
NVLQML,0,0,0,1,1,6
VLQMLI,0,0,0,1,1,6
LQMLII,0,0,0,1,1,6
QMLIIE,0,0,0,1,1,6
MLIIES,0,0,0,1,1,6
LIIESH,0,0,0,1,1,6
IIESHS,0,0,0,1,1,6
AGEMVR,0,0,0,1,1,6
GEMVRQ,0,0,0,1,1,6
EMVRQA,0,0,0,1,1,6
MVRQAR,0,0,0,1,1,6
VRQARI,0,0,0,1,1,6
RQARIL,0,0,0,1,1,6
QARILA,0,0,0,1,1,6
ARILAQ,0,0,0,1,1,6
RILAQA,0,0,0,1,1,6
ILAQAT,0,0,0,1,1,6
LAQATS,0,0,0,1,1,6
AQATSD,0,0,0,1,1,6
QATSDL,0,0,0,1,1,6
ATSDLV,0,0,0,1,1,6
TSDLVN,0,0,0,1,1,6
SDLVNA,0,0,0,1,1,6
DLVNAI,0,0,0,1,1,6
LVNAIK,0,0,0,1,1,6
VNAIKA,0,0,0,1,1,6
NAIKAD,0,0,0,1,1,6
AIKADA,0,0,0,1,1,6
AGNLDI,0,0,0,1,1,6
GNLDIM,0,0,0,1,1,6
NLDIMT,0,0,0,1,1,6
LDIMTS,0,0,0,1,1,6
DIMTSA,0,0,0,1,1,6
IMTSAA,0,0,0,1,1,6
MTSAAL,0,0,0,1,1,6
TSAALA,0,0,0,1,1,6
SAALAT,0,0,0,1,1,6
AALATA,0,0,0,1,1,6
ALATAE,0,0,0,1,1,6
LATAER,0,0,0,1,1,6
ATAERM,0,0,0,1,1,6
TAERMA,0,0,0,1,1,6
AERMAQ,0,0,0,1,1,6
ERMAQS,0,0,0,1,1,6
RMAQSM,0,0,0,1,1,6
MAQSML,0,0,0,1,1,6
AQSMLN,0,0,0,1,1,6
AHAIGV,0,0,0,1,1,6
HAIGVL,0,0,0,1,1,6
AIGVLL,0,0,0,1,1,6
IGVLLD,0,0,0,1,1,6
GVLLDN,0,0,0,1,1,6
VLLDNL,0,0,0,1,1,6
AIEKEI,0,0,0,1,1,6
IEKEIL,0,0,0,1,1,6
EKEILI,0,0,0,1,1,6
KEILIE,0,0,0,1,1,6
EILIEA,0,0,0,1,1,6
ILIEAI,0,0,0,1,1,6
LIEAIS,0,0,0,1,1,6
IEAISS,0,0,0,1,1,6
AKQEKI,0,0,0,1,1,6
KQEKII,0,0,0,1,1,6
QEKIII,0,0,0,1,1,6
EKIIIQ,0,0,0,1,1,6
KIIIQV,0,0,0,1,1,6
IIIQVA,0,0,0,1,1,6
IIQVAL,0,0,0,1,1,6
IQVALN,0,0,0,1,1,6
QVALND,0,0,0,1,1,6
VALNDI,0,0,0,1,1,6
ALNDIT,0,0,0,1,1,6
LNDITH,0,0,0,1,1,6
NDITHV,0,0,0,1,1,6
DITHVV,0,0,0,1,1,6
ITHVVE,0,0,0,1,1,6
THVVEL,0,0,0,1,1,6
HVVELL,0,0,0,1,1,6
AKVVRT,0,0,0,1,1,6
KVVRTA,0,0,0,1,1,6
VVRTAL,0,0,0,1,1,6
VRTALE,0,0,0,1,1,6
RTALED,0,0,0,1,1,6
TALEDA,0,0,0,1,1,6
ALEDAA,0,0,0,1,1,6
LEDAAS,0,0,0,1,1,6
EDAASV,0,0,0,1,1,6
DAASVA,0,0,0,1,1,6
AASVAG,0,0,0,1,1,6
ASVAGL,0,0,0,1,1,6
SVAGLL,0,0,0,1,1,6
VAGLLI,0,0,0,1,1,6
AGLLIT,0,0,0,1,1,6
ALAVAA,0,0,0,1,1,6
LAVAAK,0,0,0,1,1,6
AVAAKP,0,0,0,1,1,6
VAAKPF,0,0,0,1,1,6
AAKPFL,0,0,0,1,1,6
ALGKVI,0,0,0,1,1,6
LGKVIK,0,0,0,1,1,6
GKVIKK,0,0,0,1,1,6
KVIKKW,0,0,0,1,1,6
VIKKWG,0,0,0,1,1,6
IKKWGT,0,0,0,1,1,6
KKWGTT,0,0,0,1,1,6
KWGTTV,0,0,0,1,1,6
WGTTVA,0,0,0,1,1,6
GTTVAK,0,0,0,1,1,6
TTVAKL,0,0,0,1,1,6
TVAKLA,0,0,0,1,1,6
ALYGLL,0,0,0,1,1,6
LYGLLK,0,0,0,1,1,6
YGLLKE,0,0,0,1,1,6
GLLKEE,0,0,0,1,1,6
LLKEEM,0,0,0,1,1,6
LKEEMG,0,0,0,1,1,6
KEEMGE,0,0,0,1,1,6
EEMGEI,0,0,0,1,1,6
EMGEIL,0,0,0,1,1,6
MGEILA,0,0,0,1,1,6
GEILAK,0,0,0,1,1,6
AMFEQM,0,0,0,1,1,6
MFEQMR,0,0,0,1,1,6
FEQMRA,0,0,0,1,1,6
EQMRAN,0,0,0,1,1,6
QMRANV,0,0,0,1,1,6
MRANVG,0,0,0,1,1,6
RANVGK,0,0,0,1,1,6
ANVGKL,0,0,0,1,1,6
NVGKLL,0,0,0,1,1,6
VGKLLK,0,0,0,1,1,6
GKLLKG,0,0,0,1,1,6
APDAEG,0,0,0,1,1,6
PDAEGR,0,0,0,1,1,6
DAEGRA,0,0,0,1,1,6
AEGRAI,0,0,0,1,1,6
EGRAIQ,0,0,0,1,1,6
GRAIQA,0,0,0,1,1,6
RAIQAV,0,0,0,1,1,6
AIQAVY,0,0,0,1,1,6
IQAVYW,0,0,0,1,1,6
QAVYWA,0,0,0,1,1,6
AVYWAN,0,0,0,1,1,6
VYWANK,0,0,0,1,1,6
YWANKW,0,0,0,1,1,6
WANKWA,0,0,0,1,1,6
ANKWAK,0,0,0,1,1,6
NKWAKE,0,0,0,1,1,6
KWAKEQ,0,0,0,1,1,6
WAKEQG,0,0,0,1,1,6
APDLLI,0,0,0,1,1,6
PDLLIS,0,0,0,1,1,6
DLLISL,0,0,0,1,1,6
LLISLA,0,0,0,1,1,6
LISLAT,0,0,0,1,1,6
ISLATV,0,0,0,1,1,6
SLATVL,0,0,0,1,1,6
LATVLY,0,0,0,1,1,6
ATVLYH,0,0,0,1,1,6
TVLYHL,0,0,0,1,1,6
VLYHLQ,0,0,0,1,1,6
LYHLQQ,0,0,0,1,1,6
APEDVR,0,0,0,1,1,6
PEDVRK,0,0,0,1,1,6
EDVRKS,0,0,0,1,1,6
DVRKSS,0,0,0,1,1,6
VRKSSK,0,0,0,1,1,6
RKSSKE,0,0,0,1,1,6
KSSKEV,0,0,0,1,1,6
SSKEVL,0,0,0,1,1,6
APLLNF,0,0,0,1,1,6
PLLNFV,0,0,0,1,1,6
LLNFVR,0,0,0,1,1,6
LNFVRD,0,0,0,1,1,6
NFVRDF,0,0,0,1,1,6
FVRDFV,0,0,0,1,1,6
VRDFVR,0,0,0,1,1,6
RDFVRE,0,0,0,1,1,6
DFVRED,0,0,0,1,1,6
FVREDA,0,0,0,1,1,6
VREDAK,0,0,0,1,1,6
REDAKY,0,0,0,1,1,6
EDAKYL,0,0,0,1,1,6
DAKYLY,0,0,0,1,1,6
AKYLYS,0,0,0,1,1,6
KYLYSS,0,0,0,1,1,6
YLYSSL,0,0,0,1,1,6
LYSSLV,0,0,0,1,1,6
AQTSRW,0,0,0,1,1,6
QTSRWA,0,0,0,1,1,6
TSRWAA,0,0,0,1,1,6
SRWAAM,0,0,0,1,1,6
RWAAMQ,0,0,0,1,1,6
WAAMQI,0,0,0,1,1,6
AAMQIG,0,0,0,1,1,6
AMQIGM,0,0,0,1,1,6
MQIGMS,0,0,0,1,1,6
QIGMSF,0,0,0,1,1,6
IGMSFI,0,0,0,1,1,6
GMSFIS,0,0,0,1,1,6
MSFISA,0,0,0,1,1,6
SFISAY,0,0,0,1,1,6
ARDEAE,0,0,0,1,1,6
RDEAEM,0,0,0,1,1,6
DEAEME,0,0,0,1,1,6
EAEMEY,0,0,0,1,1,6
AEMEYL,0,0,0,1,1,6
EMEYLK,0,0,0,1,1,6
MEYLKI,0,0,0,1,1,6
EYLKIA,0,0,0,1,1,6
YLKIAQ,0,0,0,1,1,6
ASLPEA,0,0,0,1,1,6
SLPEAI,0,0,0,1,1,6
LPEAIE,0,0,0,1,1,6
PEAIEA,0,0,0,1,1,6
EAIEAL,0,0,0,2,2,6
AIEALT,0,0,0,1,1,6
IEALTK,0,0,0,1,1,6
EALTKG,0,0,0,1,1,6
ATLKNL,0,0,0,1,1,6
TLKNLG,0,0,0,1,1,6
LKNLGS,0,0,0,1,1,6
KNLGSV,0,0,0,1,1,6
NLGSVH,0,0,0,1,1,6
LGSVHV,0,0,0,1,1,6
GSVHVS,0,0,0,1,1,6
SVHVSK,0,0,0,1,1,6
VHVSKG,0,0,0,1,1,6
AVDTLV,0,0,0,1,1,6
VDTLVL,0,0,0,1,1,6
DTLVLA,0,0,0,1,1,6
TLVLAL,0,0,0,1,1,6
LVLALA,0,0,0,1,1,6
VLALAE,0,0,0,1,1,6
LALAEA,0,0,0,1,1,6
ALAEAT,0,0,0,1,1,6
DAAALF,0,0,0,1,1,6
AAALFR,0,0,0,1,1,6
AALFRL,0,0,0,1,1,6
ALFRLH,0,0,0,1,1,6
LFRLHK,0,0,0,1,1,6
FRLHKF,0,0,0,1,1,6
RLHKFL,0,0,0,1,1,6
LHKFLT,0,0,0,1,1,6
HKFLTK,0,0,0,1,1,6
KFLTKW,0,0,0,1,1,6
DAAGLA,0,0,0,1,1,6
AAGLAS,0,0,0,1,1,6
AGLASR,0,0,0,1,1,6
GLASRH,0,0,0,1,1,6
LASRHK,0,0,0,1,1,6
ASRHKG,0,0,0,1,1,6
DAENRD,0,0,0,1,1,6
AENRDL,0,0,0,1,1,6
ENRDLF,0,0,0,1,1,6
NRDLFL,0,0,0,1,1,6
RDLFLA,0,0,0,1,1,6
DLFLAL,0,0,0,1,1,6
LFLALL,0,0,0,1,1,6
FLALLS,0,0,0,1,1,6
LALLSV,0,0,0,1,1,6
DAHAWM,0,0,0,1,1,6
AHAWMI,0,0,0,1,1,6
HAWMIG,0,0,0,1,1,6
AWMIGQ,0,0,0,1,1,6
WMIGQL,0,0,0,1,1,6
MIGQLK,0,0,0,1,1,6
IGQLKG,0,0,0,1,1,6
GQLKGL,0,0,0,1,1,6
DALEIF,0,0,0,1,1,6
ALEIFK,0,0,0,1,1,6
LEIFKT,0,0,0,1,1,6
EIFKTL,0,0,0,1,1,6
IFKTLF,0,0,0,1,1,6
FKTLFS,0,0,0,1,1,6
KTLFSL,0,0,0,1,1,6
TLFSLV,0,0,0,1,1,6
LFSLVM,0,0,0,1,1,6
FSLVMR,0,0,0,1,1,6
SLVMRF,0,0,0,1,1,6
LVMRFS,0,0,0,1,1,6
VMRFSS,0,0,0,1,1,6
MRFSSY,0,0,0,1,1,6
RFSSYL,0,0,0,1,1,6
DAMLRT,0,0,0,1,1,6
AMLRTS,0,0,0,1,1,6
MLRTSM,0,0,0,1,1,6
LRTSMV,0,0,0,1,1,6
RTSMVA,0,0,0,1,1,6
TSMVAT,0,0,0,1,1,6
SMVATQ,0,0,0,1,1,6
MVATQL,0,0,0,1,1,6
VATQLV,0,0,0,1,1,6
ATQLVG,0,0,0,1,1,6
TQLVGL,0,0,0,1,1,6
QLVGLA,0,0,0,1,1,6
LVGLAM,0,0,0,1,1,6
VGLAMM,0,0,0,1,1,6
GLAMMR,0,0,0,1,1,6
LAMMRY,0,0,0,1,1,6
AMMRYV,0,0,0,1,1,6
DARAKK,0,0,0,1,1,6
ARAKKL,0,0,0,1,1,6
RAKKLL,0,0,0,1,1,6
AKKLLD,0,0,0,1,1,6
KKLLDK,0,0,0,1,1,6
KLLDKW,0,0,0,1,1,6
LLDKWA,0,0,0,1,1,6
LDKWAK,0,0,0,1,1,6
DKWAKW,0,0,0,1,1,6
KWAKWI,0,0,0,1,1,6
WAKWIN,0,0,0,1,1,6
AKWING,0,0,0,1,1,6
DATAAL,0,0,0,1,1,6
ATAALA,0,0,0,1,1,6
TAALAL,0,0,0,2,2,6
AALALT,0,0,0,1,1,6
ALALTM,0,0,0,1,1,6
LALTMA,0,0,0,1,1,6
DATLIS,0,0,0,1,1,6
ATLISE,0,0,0,1,1,6
TLISEL,0,0,0,1,1,6
LISELQ,0,0,0,1,1,6
ISELQQ,0,0,0,1,1,6
SELQQM,0,0,0,1,1,6
DDADLE,0,0,0,1,1,6
DADLEK,0,0,0,1,1,6
ADLEKF,0,0,0,1,1,6
DLEKFV,0,0,0,1,1,6
LEKFVI,0,0,0,1,1,6
EKFVIE,0,0,0,1,1,6
KFVIEY,0,0,0,1,1,6
DDETLG,0,0,0,1,1,6
DETLGV,0,0,0,1,1,6
ETLGVL,0,0,0,1,1,6
TLGVLM,0,0,0,1,1,6
LGVLMW,0,0,0,1,1,6
GVLMWI,0,0,0,1,1,6
VLMWIL,0,0,0,1,1,6
LMWILD,0,0,0,1,1,6
MWILDR,0,0,0,1,1,6
WILDRS,0,0,0,1,1,6
ILDRSI,0,0,0,1,1,6
LDRSIH,0,0,0,1,1,6
DDETRE,0,0,0,1,1,6
DETREE,0,0,0,1,1,6
ETREEL,0,0,0,1,1,6
TREELE,0,0,0,1,1,6
REELEE,0,0,0,1,1,6
EELEEL,0,0,0,1,1,6
ELEELL,0,0,0,1,1,6
LEELLI,0,0,0,1,1,6
EELLIQ,0,0,0,1,1,6
ELLIQA,0,0,0,1,1,6
DDRVQS,0,0,0,1,1,6
DRVQSH,0,0,0,1,1,6
RVQSHI,0,0,0,1,1,6
VQSHIL,0,0,0,1,1,6
QSHILH,0,0,0,1,1,6
SHILHL,0,0,0,1,1,6
HILHLE,0,0,0,1,1,6
ILHLEH,0,0,0,1,1,6
LHLEHD,0,0,0,1,1,6
HLEHDL,0,0,0,1,1,6
LEHDLV,0,0,0,1,1,6
EHDLVH,0,0,0,1,1,6
HDLVHV,0,0,0,1,1,6
DLVHVT,0,0,0,1,1,6
LVHVTR,0,0,0,1,1,6
VHVTRK,0,0,0,1,1,6
HVTRKN,0,0,0,1,1,6
DDYLKE,0,0,0,1,1,6
DYLKEQ,0,0,0,1,1,6
YLKEQV,0,0,0,1,1,6
LKEQVL,0,0,0,1,1,6
KEQVLH,0,0,0,1,1,6
EQVLHM,0,0,0,1,1,6
QVLHMK,0,0,0,1,1,6
VLHMKQ,0,0,0,1,1,6
LHMKQY,0,0,0,1,1,6
HMKQYV,0,0,0,1,1,6
MKQYVS,0,0,0,1,1,6
KQYVSD,0,0,0,1,1,6
QYVSDN,0,0,0,1,1,6
DEAAFQ,0,0,0,1,1,6
EAAFQK,0,0,0,1,1,6
AAFQKL,0,0,0,1,1,6
AFQKLM,0,0,0,1,1,6
FQKLMS,0,0,0,1,1,6
QKLMSN,0,0,0,1,1,6
KLMSNL,0,0,0,1,1,6
LMSNLD,0,0,0,1,1,6
DEAGLM,0,0,0,1,1,6
EAGLMR,0,0,0,1,1,6
AGLMRE,0,0,0,1,1,6
GLMREL,0,0,0,1,1,6
LMRELR,0,0,0,1,1,6
MRELRL,0,0,0,1,1,6
RELRLF,0,0,0,1,1,6
ELRLFR,0,0,0,1,1,6
LRLFRR,0,0,0,1,1,6
RLFRRR,0,0,0,1,1,6
LFRRRI,0,0,0,1,1,6
FRRRIM,0,0,0,1,1,6
RRRIMV,0,0,0,1,1,6
RRIMVR,0,0,0,1,1,6
RIMVRI,0,0,0,1,1,6
IMVRIA,0,0,0,1,1,6
MVRIAW,0,0,0,1,1,6
VRIAWA,0,0,0,1,1,6
RIAWAQ,0,0,0,1,1,6
IAWAQT,0,0,0,1,1,6
AWAQTL,0,0,0,1,1,6
DEETME,0,0,0,1,1,6
EETMER,0,0,0,1,1,6
ETMERI,0,0,0,1,1,6
TMERIM,0,0,0,1,1,6
MERIMR,0,0,0,1,1,6
ERIMRE,0,0,0,1,1,6
RIMREL,0,0,0,1,1,6
IMRELK,0,0,0,1,1,6
MRELKK,0,0,0,1,1,6
RELKKK,0,0,0,1,1,6
DEFTKQ,0,0,0,1,1,6
EFTKQH,0,0,0,1,1,6
FTKQHI,0,0,0,1,1,6
TKQHIV,0,0,0,1,1,6
KQHIVG,0,0,0,1,1,6
QHIVGK,0,0,0,1,1,6
DEKAFK,0,0,0,1,1,6
EKAFKN,0,0,0,1,1,6
KAFKNT,0,0,0,1,1,6
AFKNTY,0,0,0,1,1,6
FKNTYR,0,0,0,1,1,6
KNTYRQ,0,0,0,1,1,6
NTYRQA,0,0,0,1,1,6
TYRQAM,0,0,0,1,1,6
YRQAMN,0,0,0,1,1,6
RQAMND,0,0,0,1,1,6
DEKKIL,0,0,0,1,1,6
EKKILK,0,0,0,1,1,6
KKILKD,0,0,0,1,1,6
KILKDF,0,0,0,1,1,6
ILKDFL,0,0,0,1,1,6
LKDFLI,0,0,0,1,1,6
KDFLIQ,0,0,0,1,1,6
DEKSII,0,0,0,1,1,6
EKSIIT,0,0,0,1,1,6
KSIITY,0,0,0,1,1,6
SIITYV,0,0,0,1,1,6
IITYVS,0,0,0,1,1,6
ITYVSS,0,0,0,1,1,6
TYVSSL,0,0,0,1,1,6
YVSSLY,0,0,0,1,1,6
VSSLYD,0,0,0,1,1,6
SSLYDA,0,0,0,1,1,6
SLYDAM,0,0,0,1,1,6
DELLSK,0,0,0,1,1,6
ELLSKM,0,0,0,1,1,6
LLSKMR,0,0,0,1,1,6
LSKMRF,0,0,0,1,1,6
SKMRFA,0,0,0,1,1,6
KMRFAL,0,0,0,1,1,6
DEPQVQ,0,0,0,1,1,6
EPQVQA,0,0,0,1,1,6
PQVQAK,0,0,0,1,1,6
QVQAKI,0,0,0,1,1,6
VQAKIM,0,0,0,1,1,6
QAKIMA,0,0,0,1,1,6
AKIMAY,0,0,0,1,1,6
KIMAYL,0,0,0,1,1,6
IMAYLQ,0,0,0,1,1,6
MAYLQQ,0,0,0,1,1,6
AYLQQE,0,0,0,1,1,6
YLQQEQ,0,0,0,1,1,6
LQQEQS,0,0,0,1,1,6
QQEQSN,0,0,0,1,1,6
QEQSNR,0,0,0,1,1,6
DEQYRE,0,0,0,1,1,6
EQYREG,0,0,0,1,1,6
QYREGA,0,0,0,1,1,6
YREGAV,0,0,0,1,1,6
REGAVR,0,0,0,1,1,6
EGAVRT,0,0,0,1,1,6
GAVRTV,0,0,0,1,1,6
AVRTVA,0,0,0,1,1,6
VRTVAS,0,0,0,1,1,6
RTVASF,0,0,0,1,1,6
TVASFR,0,0,0,1,1,6
VASFRE,0,0,0,1,1,6
ASFRER,0,0,0,1,1,6
SFRERL,0,0,0,1,1,6
FRERLD,0,0,0,1,1,6
RERLDR,0,0,0,1,1,6
DERLLQ,0,0,0,1,1,6
ERLLQK,0,0,0,1,1,6
RLLQKY,0,0,0,1,1,6
LLQKYR,0,0,0,1,1,6
LQKYRA,0,0,0,1,1,6
QKYRAQ,0,0,0,1,1,6
KYRAQV,0,0,0,1,1,6
YRAQVF,0,0,0,1,1,6
RAQVFE,0,0,0,1,1,6
AQVFEW,0,0,0,1,1,6
QVFEWG,0,0,0,1,1,6
DEVLLA,0,0,0,1,1,6
EVLLAL,0,0,0,1,1,6
VLLALA,0,0,0,1,1,6
LLALAE,0,0,0,1,1,6
LALAEQ,0,0,0,1,1,6
ALAEQL,0,0,0,1,1,6
LAEQLG,0,0,0,1,1,6
AEQLGT,0,0,0,1,1,6
DFAALA,0,0,0,1,1,6
FAALAQ,0,0,0,1,1,6
AALAQT,0,0,0,1,1,6
ALAQTA,0,0,0,1,1,6
LAQTAH,0,0,0,1,1,6
AQTAHR,0,0,0,1,1,6
QTAHRL,0,0,0,1,1,6
TAHRLK,0,0,0,1,1,6
AHRLKG,0,0,0,1,1,6
HRLKGV,0,0,0,1,1,6
RLKGVF,0,0,0,1,1,6
LKGVFA,0,0,0,1,1,6
KGVFAM,0,0,0,1,1,6
GVFAML,0,0,0,1,1,6
VFAMLN,0,0,0,1,1,6
DFLEEQ,0,0,0,1,1,6
FLEEQY,0,0,0,1,1,6
LEEQYK,0,0,0,1,1,6
EEQYKG,0,0,0,1,1,6
EQYKGQ,0,0,0,1,1,6
QYKGQR,0,0,0,1,1,6
YKGQRD,0,0,0,1,1,6
KGQRDL,0,0,0,1,1,6
GQRDLA,0,0,0,1,1,6
QRDLAG,0,0,0,1,1,6
RDLAGK,0,0,0,1,1,6
DLAGKA,0,0,0,1,1,6
LAGKAS,0,0,0,1,1,6
AGKAST,0,0,0,1,1,6
GKASTL,0,0,0,1,1,6
KASTLK,0,0,0,1,1,6
ASTLKK,0,0,0,1,1,6
DFPALI,0,0,0,1,1,6
FPALIK,0,0,0,1,1,6
PALIKQ,0,0,0,1,1,6
ALIKQA,0,0,0,1,1,6
LIKQAS,0,0,0,1,1,6
IKQASL,0,0,0,1,1,6
KQASLD,0,0,0,1,1,6
QASLDA,0,0,0,1,1,6
ASLDAL,0,0,0,1,1,6
SLDALF,0,0,0,1,1,6
LDALFK,0,0,0,1,1,6
DFSETI,0,0,0,1,1,6
FSETIN,0,0,0,1,1,6
SETINA,0,0,0,1,1,6
ETINAY,0,0,0,1,1,6
TINAYF,0,0,0,1,1,6
INAYFV,0,0,0,1,1,6
NAYFVA,0,0,0,1,1,6
AYFVAK,0,0,0,1,1,6
YFVAKL,0,0,0,1,1,6
FVAKLL,0,0,0,1,1,6
DGALKR,0,0,0,1,1,6
GALKRA,0,0,0,1,1,6
ALKRAE,0,0,0,1,1,6
LKRAEE,0,0,0,1,1,6
KRAEEL,0,0,0,1,1,6
RAEELK,0,0,0,1,1,6
AEELKT,0,0,0,1,1,6
EELKTQ,0,0,0,1,1,6
ELKTQA,0,0,0,1,1,6
LKTQAN,0,0,0,1,1,6
KTQAND,0,0,0,1,1,6
TQANDY,0,0,0,1,1,6
QANDYF,0,0,0,1,1,6
ANDYFK,0,0,0,1,1,6
DGFSVL,0,0,0,1,1,6
GFSVLM,0,0,0,1,1,6
FSVLMR,0,0,0,1,1,6
SVLMRA,0,0,0,1,1,6
VLMRAM,0,0,0,1,1,6
LMRAMQ,0,0,0,1,1,6
MRAMQQ,0,0,0,1,1,6
DGGGFV,0,0,0,1,1,6
GGGFVI,0,0,0,1,1,6
GGFVIS,0,0,0,1,1,6
GFVISK,0,0,0,1,1,6
FVISKH,0,0,0,1,1,6
VISKHP,0,0,0,1,1,6
ISKHPV,0,0,0,1,1,6
SKHPVR,0,0,0,1,1,6
KHPVRL,0,0,0,1,1,6
HPVRLA,0,0,0,1,1,6
PVRLAK,0,0,0,1,1,6
VRLAKK,0,0,0,1,1,6
RLAKKL,0,0,0,1,1,6
LAKKLN,0,0,0,1,1,6
AKKLNR,0,0,0,1,1,6
DHAVLE,0,0,0,1,1,6
HAVLEV,0,0,0,1,1,6
AVLEVL,0,0,0,1,1,6
VLEVLA,0,0,0,1,1,6
LEVLAT,0,0,0,1,1,6
EVLATP,0,0,0,1,1,6
VLATPV,0,0,0,1,1,6
LATPVR,0,0,0,1,1,6
ATPVRE,0,0,0,1,1,6
TPVREA,0,0,0,1,1,6
PVREAL,0,0,0,1,1,6
VREALL,0,0,0,1,1,6
REALLA,0,0,0,1,1,6
EALLAR,0,0,0,1,1,6
ALLARF,0,0,0,1,1,6
LLARFG,0,0,0,1,1,6
DIFDFM,0,0,0,1,1,6
IFDFME,0,0,0,1,1,6
FDFMER,0,0,0,1,1,6
DFMERW,0,0,0,1,1,6
FMERWI,0,0,0,1,1,6
MERWIE,0,0,0,1,1,6
ERWIEK,0,0,0,1,1,6
RWIEKK,0,0,0,1,1,6
WIEKKL,0,0,0,1,1,6
IEKKLE,0,0,0,1,1,6
EKKLEY,0,0,0,1,1,6
KKLEYS,0,0,0,1,1,6
KLEYSA,0,0,0,1,1,6
LEYSAS,0,0,0,1,1,6
EYSASH,0,0,0,1,1,6
DIHAAI,0,0,0,1,1,6
IHAAIE,0,0,0,1,1,6
HAAIEM,0,0,0,1,1,6
AAIEML,0,0,0,1,1,6
AIEMLL,0,0,0,1,1,6
IEMLLG,0,0,0,1,1,6
DIIGTE,0,0,0,1,1,6
IIGTEI,0,0,0,1,1,6
IGTEIT,0,0,0,1,1,6
GTEITS,0,0,0,1,1,6
TEITSA,0,0,0,1,1,6
EITSAL,0,0,0,1,1,6
ITSALK,0,0,0,1,1,6
TSALKN,0,0,0,1,1,6
SALKNV,0,0,0,1,1,6
ALKNVY,0,0,0,1,1,6
LKNVYS,0,0,0,1,1,6
KNVYSI,0,0,0,1,1,6
NVYSIA,0,0,0,1,1,6
VYSIAI,0,0,0,1,1,6
YSIAIA,0,0,0,1,1,6
SIAIAW,0,0,0,1,1,6
IAIAWI,0,0,0,1,1,6
AIAWIR,0,0,0,1,1,6
IAWIRG,0,0,0,1,1,6
AWIRGY,0,0,0,1,1,6
WIRGYE,0,0,0,1,1,6
IRGYES,0,0,0,1,1,6
RGYESR,0,0,0,1,1,6
GYESRK,0,0,0,1,1,6
YESRKN,0,0,0,1,1,6
DILREI,0,0,0,1,1,6
ILREIG,0,0,0,1,1,6
LREIGM,0,0,0,1,1,6
REIGMI,0,0,0,1,1,6
EIGMIA,0,0,0,1,1,6
IGMIAR,0,0,0,1,1,6
GMIARA,0,0,0,1,1,6
MIARAL,0,0,0,1,1,6
IARALD,0,0,0,1,1,6
ARALDS,0,0,0,1,1,6
RALDSI,0,0,0,1,1,6
ALDSIS,0,0,0,1,1,6
LDSISN,0,0,0,1,1,6
DSISNI,0,0,0,1,1,6
SISNIE,0,0,0,1,1,6
ISNIEF,0,0,0,1,1,6
DIRAVL,0,0,0,1,1,6
IRAVLR,0,0,0,1,1,6
RAVLRD,0,0,0,1,1,6
AVLRDL,0,0,0,1,1,6
VLRDLS,0,0,0,1,1,6
LRDLSF,0,0,0,1,1,6
RDLSFH,0,0,0,1,1,6
DLSFHL,0,0,0,1,1,6
LSFHLN,0,0,0,1,1,6
SFHLNG,0,0,0,1,1,6
FHLNGH,0,0,0,1,1,6
HLNGHI,0,0,0,1,1,6
LNGHIL,0,0,0,1,1,6
NGHILH,0,0,0,1,1,6
GHILHS,0,0,0,1,1,6
HILHSI,0,0,0,1,1,6
ILHSIF,0,0,0,1,1,6
LHSIFW,0,0,0,1,1,6
HSIFWP,0,0,0,1,1,6
SIFWPN,0,0,0,1,1,6
IFWPNM,0,0,0,1,1,6
DIRTSL,0,0,0,1,1,6
IRTSLA,0,0,0,1,1,6
RTSLAN,0,0,0,1,1,6
TSLAND,0,0,0,1,1,6
SLANDM,0,0,0,1,1,6
LANDMA,0,0,0,1,1,6
ANDMAI,0,0,0,1,1,6
NDMAIY,0,0,0,1,1,6
DMAIYG,0,0,0,1,1,6
MAIYGD,0,0,0,1,1,6
AIYGDI,0,0,0,1,1,6
IYGDII,0,0,0,1,1,6
YGDIIE,0,0,0,1,1,6
GDIIEA,0,0,0,1,1,6
DIIEAT,0,0,0,1,1,6
IIEATR,0,0,0,1,1,6
IEATRE,0,0,0,1,1,6
EATREH,0,0,0,1,1,6
ATREHT,0,0,0,1,1,6
TREHTE,0,0,0,1,1,6
REHTEL,0,0,0,1,1,6
EHTELA,0,0,0,1,1,6
HTELAE,0,0,0,1,1,6
TELAEN,0,0,0,1,1,6
ELAENL,0,0,0,1,1,6
DIYQQV,0,0,0,1,1,6
IYQQVR,0,0,0,1,1,6
YQQVRD,0,0,0,1,1,6
QQVRDE,0,0,0,1,1,6
QVRDEL,0,0,0,1,1,6
VRDELK,0,0,0,1,1,6
RDELKR,0,0,0,1,1,6
DELKRA,0,0,0,1,1,6
ELKRAS,0,0,0,1,1,6
DKETMN,0,0,0,1,1,6
KETMNI,0,0,0,1,1,6
ETMNIH,0,0,0,1,1,6
TMNIHH,0,0,0,1,1,6
MNIHHT,0,0,0,1,1,6
NIHHTK,0,0,0,1,1,6
DLAANN,0,0,0,1,1,6
LAANNG,0,0,0,1,1,6
AANNGG,0,0,0,1,1,6
ANNGGW,0,0,0,1,1,6
NNGGWQ,0,0,0,1,1,6
NGGWQW,0,0,0,1,1,6
GGWQWS,0,0,0,1,1,6
DLARIE,0,0,0,1,1,6
LARIEQ,0,0,0,1,1,6
ARIEQF,0,0,0,1,1,6
RIEQFL,0,0,0,1,1,6
IEQFLD,0,0,0,1,1,6
EQFLDA,0,0,0,1,1,6
QFLDAL,0,0,0,1,1,6
FLDALW,0,0,0,1,1,6
LDALWL,0,0,0,1,1,6
DALWLE,0,0,0,1,1,6
DLEAKK,0,0,0,1,1,6
LEAKKM,0,0,0,1,1,6
EAKKMY,0,0,0,1,1,6
AKKMYF,0,0,0,1,1,6
KKMYFD,0,0,0,1,1,6
KMYFDA,0,0,0,1,1,6
MYFDAV,0,0,0,1,1,6
YFDAVQ,0,0,0,1,1,6
FDAVQA,0,0,0,1,1,6
DAVQAI,0,0,0,1,1,6
AVQAIE,0,0,0,1,1,6
VQAIET,0,0,0,1,1,6
QAIETH,0,0,0,1,1,6
AIETHL,0,0,0,1,1,6
DLESDA,0,0,0,1,1,6
LESDAL,0,0,0,1,1,6
ESDALG,0,0,0,1,1,6
SDALGW,0,0,0,1,1,6
DALGWQ,0,0,0,1,1,6
ALGWQY,0,0,0,1,1,6
LGWQYI,0,0,0,1,1,6
GWQYIT,0,0,0,1,1,6
WQYITG,0,0,0,1,1,6
DLGRKI,0,0,0,1,1,6
LGRKIT,0,0,0,1,1,6
GRKITS,0,0,0,1,1,6
RKITSA,0,0,0,1,1,6
KITSAL,0,0,0,1,1,6
ITSALR,0,0,0,1,1,6
TSALRS,0,0,0,1,1,6
SALRSL,0,0,0,1,1,6
ALRSLS,0,0,0,1,1,6
LRSLSN,0,0,0,1,1,6
DLKQAE,0,0,0,1,1,6
LKQAES,0,0,0,1,1,6
KQAESW,0,0,0,1,1,6
QAESWL,0,0,0,1,1,6
AESWLH,0,0,0,1,1,6
ESWLHK,0,0,0,1,1,6
SWLHKQ,0,0,0,1,1,6
WLHKQA,0,0,0,1,1,6
LHKQAQ,0,0,0,1,1,6
HKQAQK,0,0,0,1,1,6
KQAQKE,0,0,0,1,1,6
QAQKEG,0,0,0,1,1,6
AQKEGW,0,0,0,1,1,6
QKEGWS,0,0,0,1,1,6
KEGWSK,0,0,0,1,1,6
EGWSKA,0,0,0,1,1,6
GWSKAA,0,0,0,1,1,6
WSKAAR,0,0,0,1,1,6
SKAARL,0,0,0,1,1,6
KAARLH,0,0,0,1,1,6
DLKRAE,0,0,0,1,1,6
LKRAES,0,0,0,1,1,6
KRAESM,0,0,0,1,1,6
RAESML,0,0,0,1,1,6
AESMLQ,0,0,0,1,1,6
ESMLQQ,0,0,0,1,1,6
SMLQQA,0,0,0,1,1,6
DLKTMT,0,0,0,1,1,6
LKTMTE,0,0,0,1,1,6
KTMTER,0,0,0,1,1,6
TMTERL,0,0,0,1,1,6
MTERLR,0,0,0,1,1,6
TERLRS,0,0,0,1,1,6
DLQLNA,0,0,0,1,1,6
LQLNAN,0,0,0,1,1,6
QLNANA,0,0,0,1,1,6
LNANAE,0,0,0,1,1,6
NANAER,0,0,0,1,1,6
ANAERI,0,0,0,1,1,6
NAERIN,0,0,0,1,1,6
AERINV,0,0,0,1,1,6
ERINVY,0,0,0,1,1,6
RINVYY,0,0,0,1,1,6
DLRELI,0,0,0,1,1,6
LRELIA,0,0,0,1,1,6
RELIAR,0,0,0,1,1,6
ELIARV,0,0,0,1,1,6
LIARVR,0,0,0,1,1,6
IARVRA,0,0,0,1,1,6
ARVRAL,0,0,0,1,1,6
RVRALI,0,0,0,1,1,6
VRALIR,0,0,0,1,1,6
RALIRR,0,0,0,1,1,6
ALIRRK,0,0,0,1,1,6
LIRRKS,0,0,0,1,1,6
DLSASR,0,0,0,1,1,6
LSASRS,0,0,0,1,1,6
SASRSA,0,0,0,1,1,6
ASRSAI,0,0,0,1,1,6
SRSAID,0,0,0,1,1,6
RSAIDS,0,0,0,1,1,6
SAIDSL,0,0,0,1,1,6
AIDSLN,0,0,0,1,1,6
IDSLNN,0,0,0,1,1,6
DSLNNR,0,0,0,1,1,6
SLNNRM,0,0,0,1,1,6
LNNRML,0,0,0,1,1,6
NNRMLS,0,0,0,1,1,6
NRMLSQ,0,0,0,1,1,6
RMLSQI,0,0,0,1,1,6
MLSQIW,0,0,0,1,1,6
LSQIWS,0,0,0,1,1,6
SQIWSH,0,0,0,1,1,6
DLVDFA,0,0,0,1,1,6
LVDFAV,0,0,0,1,1,6
VDFAVE,0,0,0,1,1,6
DFAVEY,0,0,0,1,1,6
FAVEYF,0,0,0,1,1,6
AVEYFT,0,0,0,1,1,6
VEYFTR,0,0,0,1,1,6
EYFTRL,0,0,0,1,1,6
YFTRLR,0,0,0,1,1,6
FTRLRE,0,0,0,1,1,6
TRLREA,0,0,0,1,1,6
RLREAR,0,0,0,1,1,6
LREARR,0,0,0,1,1,6
REARRG,0,0,0,1,1,6
EARRGL,0,0,0,1,1,6
ARRGLE,0,0,0,1,1,6
RRGLEH,0,0,0,1,1,6
RGLEHH,0,0,0,1,1,6
GLEHHH,0,0,0,1,1,6
DMASLQ,0,0,0,1,1,6
MASLQQ,0,0,0,1,1,6
ASLQQQ,0,0,0,1,1,6
SLQQQR,0,0,0,1,1,6
LQQQRQ,0,0,0,1,1,6
QQQRQE,0,0,0,1,1,6
DMNQVL,0,0,0,1,1,6
MNQVLD,0,0,0,1,1,6
NQVLDA,0,0,0,1,1,6
QVLDAY,0,0,0,1,1,6
VLDAYE,0,0,0,1,1,6
LDAYEN,0,0,0,1,1,6
DNAMAN,0,0,0,1,1,6
NAMANQ,0,0,0,1,1,6
AMANQY,0,0,0,1,1,6
MANQYE,0,0,0,1,1,6
ANQYET,0,0,0,1,1,6
NQYETL,0,0,0,1,1,6
QYETLA,0,0,0,1,1,6
YETLAN,0,0,0,1,1,6
ETLANA,0,0,0,1,1,6
TLANAR,0,0,0,1,1,6
LANARQ,0,0,0,1,1,6
ANARQK,0,0,0,1,1,6
NARQKG,0,0,0,1,1,6
ARQKGI,0,0,0,1,1,6
RQKGIE,0,0,0,1,1,6
QKGIEK,0,0,0,1,1,6
KGIEKY,0,0,0,1,1,6
GIEKYL,0,0,0,1,1,6
DNKTRF,0,0,0,1,1,6
NKTRFK,0,0,0,1,1,6
KTRFKI,0,0,0,1,1,6
TRFKII,0,0,0,1,1,6
RFKIIK,0,0,0,1,1,6
FKIIKE,0,0,0,1,1,6
KIIKEK,0,0,0,1,1,6
IIKEKL,0,0,0,1,1,6
IKEKLK,0,0,0,1,1,6
KEKLKE,0,0,0,1,1,6
EKLKEF,0,0,0,1,1,6
DNTYLN,0,0,0,1,1,6
NTYLNT,0,0,0,1,1,6
TYLNTA,0,0,0,1,1,6
YLNTAE,0,0,0,1,1,6
LNTAES,0,0,0,1,1,6
NTAESL,0,0,0,1,1,6
TAESLY,0,0,0,1,1,6
AESLYD,0,0,0,1,1,6
ESLYDE,0,0,0,1,1,6
SLYDEF,0,0,0,1,1,6
DNVVLQ,0,0,0,1,1,6
NVVLQL,0,0,0,1,1,6
VVLQLQ,0,0,0,1,1,6
VLQLQV,0,0,0,1,1,6
LQLQVA,0,0,0,1,1,6
QLQVAR,0,0,0,1,1,6
LQVARF,0,0,0,1,1,6
QVARFL,0,0,0,1,1,6
VARFLM,0,0,0,1,1,6
ARFLMK,0,0,0,1,1,6
RFLMKT,0,0,0,1,1,6
FLMKTV,0,0,0,1,1,6
LMKTVA,0,0,0,1,1,6
MKTVAQ,0,0,0,1,1,6
DPARAL,0,0,0,1,1,6
PARALF,0,0,0,1,1,6
ARALFA,0,0,0,1,1,6
RALFAA,0,0,0,1,1,6
ALFAAM,0,0,0,1,1,6
LFAAMS,0,0,0,1,1,6
FAAMSQ,0,0,0,1,1,6
DPATVK,0,0,0,1,1,6
PATVKK,0,0,0,1,1,6
ATVKKV,0,0,0,1,1,6
TVKKVV,0,0,0,1,1,6
VKKVVN,0,0,0,1,1,6
KKVVNF,0,0,0,1,1,6
KVVNFL,0,0,0,1,1,6
DPAWQG,0,0,0,1,1,6
PAWQGF,0,0,0,1,1,6
AWQGFR,0,0,0,1,1,6
WQGFRE,0,0,0,1,1,6
QGFREL,0,0,0,1,1,6
GFRELI,0,0,0,1,1,6
FRELIE,0,0,0,1,1,6
RELIEK,0,0,0,1,1,6
ELIEKA,0,0,0,1,1,6
LIEKAL,0,0,0,1,1,6
DPEKVL,0,0,0,1,1,6
PEKVLF,0,0,0,1,1,6
EKVLFL,0,0,0,1,1,6
KVLFLA,0,0,0,1,1,6
VLFLAG,0,0,0,1,1,6
LFLAGN,0,0,0,1,1,6
FLAGNL,0,0,0,1,1,6
LAGNLL,0,0,0,1,1,6
AGNLLA,0,0,0,1,1,6
GNLLAR,0,0,0,1,1,6
NLLARL,0,0,0,1,1,6
LLARLT,0,0,0,1,1,6
LARLTE,0,0,0,1,1,6
DPETLE,0,0,0,1,1,6
PETLEA,0,0,0,1,1,6
ETLEAI,0,0,0,1,1,6
TLEAIA,0,0,0,1,1,6
LEAIAE,0,0,0,1,1,6
EAIAEN,0,0,0,1,1,6
DPETNI,0,0,0,1,1,6
PETNIN,0,0,0,1,1,6
ETNINI,0,0,0,1,1,6
TNINIG,0,0,0,1,1,6
NINIGT,0,0,0,1,1,6
INIGTS,0,0,0,1,1,6
NIGTSY,0,0,0,1,1,6
IGTSYL,0,0,0,1,1,6
GTSYLQ,0,0,0,1,1,6
TSYLQY,0,0,0,1,1,6
SYLQYV,0,0,0,1,1,6
YLQYVY,0,0,0,1,1,6
LQYVYQ,0,0,0,1,1,6
QYVYQQ,0,0,0,1,1,6
YVYQQF,0,0,0,1,1,6
DPKRLQ,0,0,0,1,1,6
PKRLQA,0,0,0,1,1,6
KRLQAS,0,0,0,1,1,6
RLQASL,0,0,0,1,1,6
LQASLQ,0,0,0,1,1,6
QASLQT,0,0,0,1,1,6
ASLQTI,0,0,0,1,1,6
SLQTIV,0,0,0,1,1,6
LQTIVG,0,0,0,1,1,6
QTIVGM,0,0,0,1,1,6
TIVGMV,0,0,0,1,1,6
IVGMVV,0,0,0,1,1,6
VGMVVY,0,0,0,1,1,6
GMVVYS,0,0,0,1,1,6
MVVYSW,0,0,0,1,1,6
DPLRER,0,0,0,1,1,6
PLRERQ,0,0,0,1,1,6
LRERQV,0,0,0,1,1,6
RERQVA,0,0,0,1,1,6
ERQVAE,0,0,0,1,1,6
RQVAEK,0,0,0,1,1,6
QVAEKQ,0,0,0,1,1,6
VAEKQL,0,0,0,1,1,6
AEKQLA,0,0,0,1,1,6
EKQLAA,0,0,0,1,1,6
KQLAAL,0,0,0,1,1,6
QLAALG,0,0,0,1,1,6
LAALGD,0,0,0,1,1,6
AALGDI,0,0,0,1,1,6
ALGDIL,0,0,0,1,1,6
LGDILS,0,0,0,1,1,6
GDILSA,0,0,0,1,1,6
DPLWKK,0,0,0,1,1,6
PLWKKE,0,0,0,1,1,6
LWKKEM,0,0,0,1,1,6
WKKEMF,0,0,0,1,1,6
KKEMFE,0,0,0,1,1,6
KEMFEK,0,0,0,1,1,6
EMFEKY,0,0,0,1,1,6
MFEKYL,0,0,0,1,1,6
FEKYLS,0,0,0,1,1,6
EKYLSN,0,0,0,1,1,6
DPQKAD,0,0,0,1,1,6
PQKADA,0,0,0,1,1,6
QKADAV,0,0,0,1,1,6
KADAVA,0,0,0,1,1,6
ADAVAV,0,0,0,1,1,6
DAVAVN,0,0,0,1,1,6
DPQKRA,0,0,0,1,1,6
PQKRAV,0,0,0,1,1,6
QKRAVV,0,0,0,1,1,6
KRAVVN,0,0,0,1,1,6
RAVVNQ,0,0,0,1,1,6
AVVNQR,0,0,0,1,1,6
VVNQRL,0,0,0,1,1,6
VNQRLY,0,0,0,1,1,6
NQRLYF,0,0,0,1,1,6
QRLYFD,0,0,0,1,1,6
RLYFDM,0,0,0,1,1,6
LYFDMG,0,0,0,1,1,6
YFDMGT,0,0,0,1,1,6
DPTKLN,0,0,0,1,1,6
PTKLNH,0,0,0,1,1,6
TKLNHA,0,0,0,1,1,6
KLNHAV,0,0,0,1,1,6
LNHAVA,0,0,0,1,1,6
NHAVAG,0,0,0,1,1,6
HAVAGL,0,0,0,1,1,6
DPYVIL,0,0,0,1,1,6
PYVILI,0,0,0,1,1,6
YVILIT,0,0,0,1,1,6
VILITE,0,0,0,1,1,6
ILITEI,0,0,0,1,1,6
LITEIL,0,0,0,1,1,6
ITEILL,0,0,0,1,1,6
DQDKIQ,0,0,0,1,1,6
QDKIQK,0,0,0,1,1,6
DKIQKA,0,0,0,1,1,6
KIQKAI,0,0,0,1,1,6
IQKAIA,0,0,0,1,1,6
QKAIAA,0,0,0,1,1,6
KAIAAG,0,0,0,1,1,6
DQEDVA,0,0,0,1,1,6
QEDVAQ,0,0,0,1,1,6
EDVAQT,0,0,0,1,1,6
DVAQTI,0,0,0,1,1,6
VAQTIR,0,0,0,1,1,6
AQTIRD,0,0,0,1,1,6
QTIRDY,0,0,0,1,1,6
TIRDYD,0,0,0,1,1,6
DQGTLF,0,0,0,1,1,6
QGTLFE,0,0,0,1,1,6
GTLFEL,0,0,0,1,1,6
TLFELI,0,0,0,1,1,6
LFELIL,0,0,0,1,1,6
FELILA,0,0,0,1,1,6
ELILAA,0,0,0,1,1,6
LILAAN,0,0,0,1,1,6
ILAANY,0,0,0,1,1,6
LAANYL,0,0,0,1,1,6
AANYLD,0,0,0,1,1,6
DQHLMA,0,0,0,1,1,6
QHLMAE,0,0,0,1,1,6
HLMAEY,0,0,0,1,1,6
LMAEYR,0,0,0,1,1,6
MAEYRE,0,0,0,1,1,6
AEYREL,0,0,0,1,1,6
EYRELP,0,0,0,1,1,6
YRELPR,0,0,0,1,1,6
RELPRV,0,0,0,1,1,6
ELPRVF,0,0,0,1,1,6
LPRVFG,0,0,0,1,1,6
PRVFGA,0,0,0,1,1,6
RVFGAV,0,0,0,1,1,6
VFGAVR,0,0,0,1,1,6
FGAVRK,0,0,0,1,1,6
GAVRKH,0,0,0,1,1,6
AVRKHV,0,0,0,1,1,6
VRKHVA,0,0,0,1,1,6
RKHVAN,0,0,0,1,1,6
KHVANG,0,0,0,1,1,6
DQNGEI,0,0,0,1,1,6
QNGEIY,0,0,0,1,1,6
NGEIYM,0,0,0,1,1,6
GEIYMW,0,0,0,1,1,6
EIYMWP,0,0,0,1,1,6
IYMWPV,0,0,0,1,1,6
YMWPVA,0,0,0,1,1,6
MWPVAQ,0,0,0,1,1,6
WPVAQA,0,0,0,1,1,6
DQQGVF,0,0,0,1,1,6
QQGVFV,0,0,0,1,1,6
QGVFVK,0,0,0,1,1,6
GVFVKG,0,0,0,1,1,6
VFVKGY,0,0,0,1,1,6
FVKGYA,0,0,0,1,1,6
VKGYAM,0,0,0,1,1,6
DRASYE,0,0,0,1,1,6
RASYEA,0,0,0,1,1,6
ASYEAR,0,0,0,1,1,6
SYEARE,0,0,0,1,1,6
YEARER,0,0,0,1,1,6
EARERH,0,0,0,1,1,6
ARERHV,0,0,0,1,1,6
RERHVA,0,0,0,1,1,6
ERHVAE,0,0,0,1,1,6
RHVAER,0,0,0,1,1,6
HVAERL,0,0,0,1,1,6
VAERLL,0,0,0,1,1,6
AERLLM,0,0,0,1,1,6
ERLLMH,0,0,0,1,1,6
RLLMHL,0,0,0,1,1,6
LLMHLE,0,0,0,1,1,6
LMHLEE,0,0,0,1,1,6
MHLEEM,0,0,0,1,1,6
DRAVIE,0,0,0,1,1,6
RAVIEH,0,0,0,1,1,6
AVIEHN,0,0,0,1,1,6
VIEHNL,0,0,0,1,1,6
IEHNLL,0,0,0,1,1,6
EHNLLS,0,0,0,1,1,6
HNLLSA,0,0,0,1,1,6
NLLSAS,0,0,0,1,1,6
LLSASK,0,0,0,1,1,6
LSASKL,0,0,0,1,1,6
DRQLRS,0,0,0,1,1,6
RQLRSS,0,0,0,1,1,6
QLRSSI,0,0,0,1,1,6
LRSSIE,0,0,0,1,1,6
RSSIER,0,0,0,1,1,6
SSIERV,0,0,0,1,1,6
SIERVI,0,0,0,1,1,6
IERVIS,0,0,0,1,1,6
ERVISI,0,0,0,1,1,6
RVISIF,0,0,0,1,1,6
VISIFQ,0,0,0,1,1,6
ISIFQS,0,0,0,1,1,6
DRTSFD,0,0,0,1,1,6
RTSFDK,0,0,0,1,1,6
TSFDKL,0,0,0,1,1,6
SFDKLA,0,0,0,1,1,6
FDKLAN,0,0,0,1,1,6
DKLANS,0,0,0,1,1,6
DSEQVV,0,0,0,1,1,6
SEQVVH,0,0,0,1,1,6
EQVVHQ,0,0,0,1,1,6
QVVHQL,0,0,0,1,1,6
VVHQLE,0,0,0,1,1,6
VHQLER,0,0,0,1,1,6
HQLERL,0,0,0,1,1,6
QLERLI,0,0,0,1,1,6
LERLIA,0,0,0,1,1,6
ERLIAR,0,0,0,1,1,6
DSGYRS,0,0,0,1,1,6
SGYRSA,0,0,0,1,1,6
GYRSAM,0,0,0,1,1,6
YRSAMS,0,0,0,1,1,6
RSAMSV,0,0,0,1,1,6
SAMSVQ,0,0,0,1,1,6
AMSVQS,0,0,0,1,1,6
MSVQSS,0,0,0,1,1,6
SVQSSL,0,0,0,1,1,6
DSMVVL,0,0,0,1,1,6
SMVVLQ,0,0,0,1,1,6
MVVLQQ,0,0,0,1,1,6
VVLQQR,0,0,0,1,1,6
VLQQRA,0,0,0,1,1,6
LQQRAY,0,0,0,1,1,6
QQRAYE,0,0,0,1,1,6
QRAYEI,0,0,0,1,1,6
RAYEIL,0,0,0,1,1,6
AYEILM,0,0,0,1,1,6
YEILMT,0,0,0,1,1,6
EILMTI,0,0,0,1,1,6
ILMTIM,0,0,0,1,1,6
LMTIME,0,0,0,1,1,6
DSSVII,0,0,0,1,1,6
SSVIIS,0,0,0,1,1,6
SVIISA,0,0,0,1,1,6
VIISAL,0,0,0,1,1,6
IISALK,0,0,0,1,1,6
ISALKT,0,0,0,1,1,6
SALKTY,0,0,0,1,1,6
ALKTYL,0,0,0,1,1,6
LKTYLV,0,0,0,1,1,6
KTYLVS,0,0,0,1,1,6
TYLVSG,0,0,0,1,1,6
DSVASL,0,0,0,1,1,6
SVASLL,0,0,0,1,1,6
VASLLD,0,0,0,1,1,6
ASLLDV,0,0,0,1,1,6
SLLDVV,0,0,0,1,1,6
LLDVVK,0,0,0,1,1,6
LDVVKS,0,0,0,1,1,6
DVVKST,0,0,0,1,1,6
VVKSTG,0,0,0,1,1,6
DSVTND,0,0,0,1,1,6
SVTNDI,0,0,0,1,1,6
VTNDIF,0,0,0,1,1,6
TNDIFN,0,0,0,1,1,6
NDIFNV,0,0,0,1,1,6
DIFNVA,0,0,0,1,1,6
IFNVAK,0,0,0,1,1,6
FNVAKA,0,0,0,1,1,6
NVAKAS,0,0,0,1,1,6
VAKASI,0,0,0,1,1,6
AKASIE,0,0,0,1,1,6
KASIEK,0,0,0,1,1,6
ASIEKH,0,0,0,1,1,6
SIEKHI,0,0,0,1,1,6
IEKHIW,0,0,0,1,1,6
EKHIWM,0,0,0,1,1,6
KHIWML,0,0,0,1,1,6
HIWMLQ,0,0,0,1,1,6
IWMLQA,0,0,0,1,1,6
WMLQAE,0,0,0,1,1,6
MLQAEL,0,0,0,1,1,6
DTAFLM,0,0,0,1,1,6
TAFLME,0,0,0,1,1,6
AFLMEQ,0,0,0,1,1,6
FLMEQL,0,0,0,1,1,6
LMEQLE,0,0,0,1,1,6
MEQLEL,0,0,0,1,1,6
EQLELR,0,0,0,1,1,6
QLELRE,0,0,0,1,1,6
LELREE,0,0,0,1,1,6
ELREEL,0,0,0,1,1,6
LREELD,0,0,0,1,1,6
REELDE,0,0,0,1,1,6
EELDEI,0,0,0,1,1,6
ELDEIE,0,0,0,1,1,6
LDEIEQ,0,0,0,1,1,6
DEIEQA,0,0,0,1,1,6
EIEQAK,0,0,0,1,1,6
DTMKDA,0,0,0,1,1,6
TMKDAG,0,0,0,1,1,6
MKDAGM,0,0,0,1,1,6
KDAGMQ,0,0,0,1,1,6
DAGMQM,0,0,0,1,1,6
AGMQMK,0,0,0,1,1,6
GMQMKK,0,0,0,1,1,6
MQMKKV,0,0,0,1,1,6
QMKKVL,0,0,0,1,1,6
MKKVLD,0,0,0,1,1,6
KKVLDS,0,0,0,1,1,6
DTRAWA,0,0,0,1,1,6
TRAWAL,0,0,0,1,1,6
RAWALA,0,0,0,1,1,6
AWALAE,0,0,0,1,1,6
WALAEK,0,0,0,1,1,6
ALAEKL,0,0,0,1,1,6
LAEKLF,0,0,0,1,1,6
AEKLFG,0,0,0,1,1,6
DVALAD,0,0,0,1,1,6
VALADS,0,0,0,1,1,6
ALADSF,0,0,0,1,1,6
LADSFD,0,0,0,1,1,6
ADSFDA,0,0,0,1,1,6
DSFDAL,0,0,0,1,1,6
DVEAVE,0,0,0,1,1,6
VEAVEI,0,0,0,1,1,6
EAVEIM,0,0,0,1,1,6
AVEIMQ,0,0,0,1,1,6
VEIMQR,0,0,0,1,1,6
EIMQRI,0,0,0,1,1,6
IMQRIH,0,0,0,1,1,6
MQRIHV,0,0,0,1,1,6
QRIHVL,0,0,0,1,1,6
RIHVLR,0,0,0,1,1,6
IHVLRS,0,0,0,1,1,6
HVLRSQ,0,0,0,1,1,6
VLRSQG,0,0,0,1,1,6
LRSQGG,0,0,0,1,1,6
RSQGGF,0,0,0,1,1,6
SQGGFN,0,0,0,1,1,6
DVLAED,0,0,0,1,1,6
VLAEDT,0,0,0,1,1,6
LAEDTI,0,0,0,1,1,6
AEDTIT,0,0,0,1,1,6
EDTITA,0,0,0,1,1,6
DTITAL,0,0,0,1,1,6
TITALL,0,0,0,1,1,6
ITALLH,0,0,0,1,1,6
DVRVKE,0,0,0,1,1,6
VRVKEY,0,0,0,1,1,6
RVKEYF,0,0,0,1,1,6
VKEYFD,0,0,0,1,1,6
KEYFDD,0,0,0,1,1,6
EYFDDI,0,0,0,1,1,6
YFDDIA,0,0,0,1,1,6
FDDIAR,0,0,0,1,1,6
DDIARY,0,0,0,1,1,6
DIARYF,0,0,0,1,1,6
IARYFS,0,0,0,1,1,6
ARYFSI,0,0,0,1,1,6
RYFSIG,0,0,0,1,1,6
YFSIGL,0,0,0,1,1,6
FSIGLL,0,0,0,1,1,6
SIGLLN,0,0,0,1,1,6
IGLLNL,0,0,0,1,1,6
GLLNLI,0,0,0,1,1,6
LLNLIH,0,0,0,1,1,6
LNLIHL,0,0,0,1,1,6
NLIHLF,0,0,0,1,1,6
LIHLFG,0,0,0,1,1,6
DWGEAF,0,0,0,1,1,6
WGEAFT,0,0,0,1,1,6
GEAFTA,0,0,0,1,1,6
EAFTAI,0,0,0,1,1,6
AFTAIN,0,0,0,1,1,6
FTAINL,0,0,0,1,1,6
DWLKRL,0,0,0,1,1,6
WLKRLQ,0,0,0,1,1,6
LKRLQK,0,0,0,1,1,6
KRLQKI,0,0,0,1,1,6
RLQKIF,0,0,0,1,1,6
LQKIFP,0,0,0,1,1,6
QKIFPP,0,0,0,1,1,6
KIFPPI,0,0,0,1,1,6
IFPPIL,0,0,0,1,1,6
FPPILS,0,0,0,1,1,6
PPILSI,0,0,0,1,1,6
DWYRTY,0,0,0,1,1,6
WYRTYA,0,0,0,1,1,6
YRTYAE,0,0,0,1,1,6
RTYAEL,0,0,0,1,1,6
TYAELR,0,0,0,1,1,6
YAELRE,0,0,0,1,1,6
AELRET,0,0,0,1,1,6
ELRETA,0,0,0,1,1,6
DYERFK,0,0,0,1,1,6
YERFKS,0,0,0,1,1,6
ERFKSY,0,0,0,1,1,6
RFKSYI,0,0,0,1,1,6
FKSYIQ,0,0,0,1,1,6
KSYIQT,0,0,0,1,1,6
SYIQTL,0,0,0,1,1,6
EALVHK,0,0,0,1,1,6
ALVHKL,0,0,0,1,1,6
LVHKLT,0,0,0,1,1,6
VHKLTE,0,0,0,1,1,6
HKLTER,0,0,0,1,1,6
KLTERM,0,0,0,1,1,6
EAQKID,0,0,0,1,1,6
AQKIDR,0,0,0,1,1,6
QKIDRL,0,0,0,1,1,6
KIDRLV,0,0,0,1,1,6
IDRLVQ,0,0,0,1,1,6
DRLVQS,0,0,0,1,1,6
RLVQSF,0,0,0,1,1,6
LVQSFS,0,0,0,1,1,6
VQSFSG,0,0,0,1,1,6
QSFSGA,0,0,0,1,1,6
SFSGAY,0,0,0,1,1,6
FSGAYF,0,0,0,1,1,6
SGAYFQ,0,0,0,1,1,6
GAYFQQ,0,0,0,1,1,6
AYFQQN,0,0,0,1,1,6
EDDIMY,0,0,0,1,1,6
DDIMYL,0,0,0,1,1,6
DIMYLM,0,0,0,1,1,6
EDDSKL,0,0,0,1,1,6
DDSKLA,0,0,0,1,1,6
DSKLAS,0,0,0,1,1,6
SKLASR,0,0,0,1,1,6
KLASRK,0,0,0,1,1,6
LASRKY,0,0,0,1,1,6
ASRKYA,0,0,0,1,1,6
SRKYAR,0,0,0,1,1,6
RKYARI,0,0,0,1,1,6
KYARII,0,0,0,1,1,6
YARIIQ,0,0,0,1,1,6
ARIIQK,0,0,0,1,1,6
RIIQKI,0,0,0,1,1,6
EDKEAV,0,0,0,1,1,6
DKEAVF,0,0,0,1,1,6
KEAVFD,0,0,0,1,1,6
EAVFDV,0,0,0,1,1,6
AVFDVV,0,0,0,1,1,6
VFDVVD,0,0,0,1,1,6
FDVVDT,0,0,0,1,1,6
DVVDTL,0,0,0,1,1,6
VVDTLT,0,0,0,1,1,6
VDTLTA,0,0,0,1,1,6
DTLTAV,0,0,0,1,1,6
TLTAVL,0,0,0,1,1,6
LTAVLQ,0,0,0,1,1,6
TAVLQV,0,0,0,1,1,6
AVLQVA,0,0,0,1,1,6
VLQVAT,0,0,0,1,1,6
LQVATG,0,0,0,1,1,6
QVATGV,0,0,0,1,1,6
VATGVI,0,0,0,1,1,6
ATGVIS,0,0,0,1,1,6
TGVIST,0,0,0,1,1,6
GVISTL,0,0,0,1,1,6
EDLPKW,0,0,0,1,1,6
DLPKWS,0,0,0,1,1,6
LPKWSG,0,0,0,1,1,6
PKWSGY,0,0,0,1,1,6
KWSGYF,0,0,0,1,1,6
WSGYFE,0,0,0,1,1,6
SGYFEK,0,0,0,1,1,6
GYFEKL,0,0,0,1,1,6
YFEKLL,0,0,0,1,1,6
FEKLLK,0,0,0,1,1,6
EKLLKK,0,0,0,1,1,6
KLLKKN,0,0,0,1,1,6
EDMIFE,0,0,0,1,1,6
DMIFEI,0,0,0,1,1,6
MIFEIF,0,0,0,1,1,6
IFEIFK,0,0,0,1,1,6
FEIFKN,0,0,0,1,1,6
EIFKNY,0,0,0,1,1,6
IFKNYL,0,0,0,1,1,6
FKNYLT,0,0,0,1,1,6
KNYLTK,0,0,0,1,1,6
NYLTKV,0,0,0,1,1,6
YLTKVA,0,0,0,1,1,6
LTKVAY,0,0,0,1,1,6
TKVAYY,0,0,0,1,1,6
KVAYYA,0,0,0,1,1,6
VAYYAR,0,0,0,1,1,6
AYYARQ,0,0,0,1,1,6
YYARQV,0,0,0,1,1,6
YARQVA,0,0,0,1,1,6
ARQVAE,0,0,0,1,1,6
RQVAEM,0,0,0,1,1,6
QVAEMN,0,0,0,1,1,6
EDNLLR,0,0,0,1,1,6
DNLLRQ,0,0,0,1,1,6
NLLRQL,0,0,0,1,1,6
LLRQLA,0,0,0,1,1,6
LRQLAQ,0,0,0,1,1,6
RQLAQK,0,0,0,1,1,6
QLAQKV,0,0,0,1,1,6
EELHTS,0,0,0,1,1,6
ELHTSL,0,0,0,1,1,6
LHTSLV,0,0,0,1,1,6
HTSLVE,0,0,0,1,1,6
TSLVEE,0,0,0,1,1,6
SLVEEL,0,0,0,2,2,6
EEMIAE,0,0,0,1,1,6
EMIAEF,0,0,0,1,1,6
MIAEFK,0,0,0,1,1,6
IAEFKA,0,0,0,1,1,6
AEFKAA,0,0,0,1,1,6
EFKAAF,0,0,0,1,1,6
FKAAFD,0,0,0,1,1,6
KAAFDM,0,0,0,1,1,6
AAFDMF,0,0,0,1,1,6
EERVKN,0,0,0,1,1,6
ERVKNG,0,0,0,1,1,6
RVKNGL,0,0,0,1,1,6
VKNGLE,0,0,0,1,1,6
KNGLER,0,0,0,1,1,6
NGLERL,0,0,0,1,1,6
GLERLK,0,0,0,1,1,6
LERLKK,0,0,0,1,1,6
ERLKKA,0,0,0,1,1,6
RLKKAI,0,0,0,1,1,6
LKKAIK,0,0,0,1,1,6
KKAIKS,0,0,0,1,1,6
KAIKSG,0,0,0,1,1,6
AIKSGK,0,0,0,1,1,6
IKSGKQ,0,0,0,1,1,6
KSGKQS,0,0,0,1,1,6
SGKQST,0,0,0,1,1,6
EESDIK,0,0,0,1,1,6
ESDIKY,0,0,0,1,1,6
SDIKYK,0,0,0,1,1,6
DIKYKT,0,0,0,1,1,6
IKYKTS,0,0,0,1,1,6
KYKTSK,0,0,0,1,1,6
YKTSKN,0,0,0,1,1,6
KTSKNF,0,0,0,1,1,6
TSKNFI,0,0,0,1,1,6
SKNFIN,0,0,0,1,1,6
KNFINK,0,0,0,1,1,6
NFINKV,0,0,0,1,1,6
FINKVY,0,0,0,1,1,6
EEVKKH,0,0,0,2,2,6
EVKKHG,0,0,0,1,1,6
VKKHGT,0,0,0,1,1,6
KKHGTT,0,0,0,1,1,6
KHGTTV,0,0,0,1,1,6
HGTTVL,0,0,0,1,1,6
GTTVLT,0,0,0,1,1,6
TTVLTA,0,0,0,1,1,6
TVLTAL,0,0,0,1,1,6
VLTALG,0,0,0,1,1,6
LTALGR,0,0,0,1,1,6
TALGRI,0,0,0,1,1,6
ALGRIL,0,0,0,1,1,6
LGRILK,0,0,0,1,1,6
GRILKQ,0,0,0,1,1,6
EFPEML,0,0,0,1,1,6
FPEMLA,0,0,0,1,1,6
PEMLAE,0,0,0,1,1,6
EMLAEI,0,0,0,1,1,6
MLAEII,0,0,0,1,1,6
LAEIIT,0,0,0,1,1,6
EFRDLH,0,0,0,1,1,6
FRDLHL,0,0,0,1,1,6
RDLHLF,0,0,0,1,1,6
DLHLFL,0,0,0,1,1,6
LHLFLG,0,0,0,1,1,6
HLFLGE,0,0,0,1,1,6
LFLGEA,0,0,0,1,1,6
FLGEAA,0,0,0,1,1,6
LGEAAE,0,0,0,1,1,6
GEAAET,0,0,0,1,1,6
EAAETA,0,0,0,1,1,6
AAETAE,0,0,0,1,1,6
AETAEE,0,0,0,1,1,6
ETAEEV,0,0,0,1,1,6
TAEEVA,0,0,0,1,1,6
AEEVAD,0,0,0,1,1,6
EEVADE,0,0,0,1,1,6
EVADEL,0,0,0,1,1,6
VADELA,0,0,0,1,1,6
ADELAE,0,0,0,1,1,6
DELAER,0,0,0,1,1,6
ELAERV,0,0,0,1,1,6
LAERVQ,0,0,0,1,1,6
AERVQA,0,0,0,1,1,6
ERVQAL,0,0,0,1,1,6
EGDQQL,0,0,0,1,1,6
GDQQLL,0,0,0,1,1,6
DQQLLK,0,0,0,1,1,6
QQLLKR,0,0,0,1,1,6
QLLKRV,0,0,0,1,1,6
LLKRVL,0,0,0,1,1,6
LKRVLV,0,0,0,1,1,6
KRVLVR,0,0,0,1,1,6
RVLVRK,0,0,0,1,1,6
VLVRKL,0,0,0,1,1,6
EGHVAA,0,0,0,1,1,6
GHVAAV,0,0,0,1,1,6
HVAAVE,0,0,0,1,1,6
VAAVEV,0,0,0,1,1,6
AAVEVL,0,0,0,1,1,6
AVEVLR,0,0,0,1,1,6
VEVLRG,0,0,0,1,1,6
EVLRGI,0,0,0,1,1,6
VLRGIH,0,0,0,1,1,6
LRGIHR,0,0,0,1,1,6
RGIHRI,0,0,0,1,1,6
GIHRIA,0,0,0,1,1,6
IHRIAD,0,0,0,1,1,6
HRIADM,0,0,0,1,1,6
RIADMS,0,0,0,1,1,6
EGKDRE,0,0,0,1,1,6
GKDREL,0,0,0,1,1,6
KDRELY,0,0,0,1,1,6
DRELYG,0,0,0,1,1,6
RELYGK,0,0,0,1,1,6
ELYGKL,0,0,0,1,1,6
LYGKLH,0,0,0,1,1,6
YGKLHE,0,0,0,1,1,6
GKLHET,0,0,0,1,1,6
KLHETL,0,0,0,1,1,6
LHETLK,0,0,0,1,1,6
HETLKK,0,0,0,1,1,6
ETLKKV,0,0,0,1,1,6
TLKKVT,0,0,0,1,1,6
LKKVTE,0,0,0,1,1,6
KKVTED,0,0,0,1,1,6
KVTEDL,0,0,0,1,1,6
VTEDLE,0,0,0,1,1,6
TEDLEA,0,0,0,1,1,6
EGNKRL,0,0,0,1,1,6
GNKRLD,0,0,0,1,1,6
NKRLDS,0,0,0,1,1,6
KRLDSV,0,0,0,1,1,6
RLDSVN,0,0,0,1,1,6
LDSVNS,0,0,0,1,1,6
DSVNSI,0,0,0,1,1,6
SVNSIV,0,0,0,1,1,6
VNSIVS,0,0,0,1,1,6
EGQQRR,0,0,0,1,1,6
GQQRRI,0,0,0,1,1,6
QQRRIR,0,0,0,1,1,6
QRRIRQ,0,0,0,1,1,6
RRIRQQ,0,0,0,1,1,6
RIRQQR,0,0,0,1,1,6
IRQQRL,0,0,0,1,1,6
RQQRLI,0,0,0,1,1,6
QQRLIS,0,0,0,1,1,6
QRLISI,0,0,0,1,1,6
RLISIG,0,0,0,1,1,6
LISIGK,0,0,0,1,1,6
ISIGKW,0,0,0,1,1,6
SIGKWI,0,0,0,1,1,6
IGKWIA,0,0,0,1,1,6
GKWIAD,0,0,0,1,1,6
KWIADN,0,0,0,1,1,6
WIADNQ,0,0,0,1,1,6
EGVAWL,0,0,0,1,1,6
GVAWLE,0,0,0,1,1,6
VAWLEA,0,0,0,1,1,6
AWLEAV,0,0,0,1,1,6
WLEAVL,0,0,0,1,1,6
LEAVLR,0,0,0,1,1,6
EAVLRL,0,0,0,1,1,6
AVLRLL,0,0,0,1,1,6
VLRLLA,0,0,0,1,1,6
LRLLAQ,0,0,0,1,1,6
EHEIQE,0,0,0,1,1,6
HEIQEW,0,0,0,1,1,6
EIQEWY,0,0,0,1,1,6
IQEWYK,0,0,0,1,1,6
QEWYKG,0,0,0,1,1,6
EWYKGF,0,0,0,1,1,6
WYKGFL,0,0,0,1,1,6
YKGFLR,0,0,0,1,1,6
KGFLRD,0,0,0,1,1,6
EIEKFR,0,0,0,1,1,6
IEKFRV,0,0,0,1,1,6
EKFRVW,0,0,0,1,1,6
KFRVWI,0,0,0,1,1,6
FRVWIS,0,0,0,1,1,6
RVWISI,0,0,0,1,1,6
VWISIL,0,0,0,1,1,6
EISEMV,0,0,0,1,1,6
ISEMVR,0,0,0,1,1,6
SEMVRM,0,0,0,1,1,6
EMVRMR,0,0,0,1,1,6
MVRMRE,0,0,0,1,1,6
VRMRER,0,0,0,1,1,6
RMRERI,0,0,0,1,1,6
MRERIL,0,0,0,1,1,6
RERILD,0,0,0,1,1,6
ERILDS,0,0,0,1,1,6
RILDSI,0,0,0,1,1,6
ILDSIH,0,0,0,1,1,6
LDSIHL,0,0,0,1,1,6
DSIHLG,0,0,0,1,1,6
EISKLV,0,0,0,1,1,6
ISKLVK,0,0,0,1,1,6
SKLVKK,0,0,0,1,1,6
KLVKKM,0,0,0,1,1,6
LVKKMI,0,0,0,1,1,6
VKKMIS,0,0,0,1,1,6
KKMISS,0,0,0,1,1,6
KMISSW,0,0,0,1,1,6
MISSWK,0,0,0,1,1,6
ISSWKD,0,0,0,1,1,6
SSWKDA,0,0,0,1,1,6
SWKDAI,0,0,0,1,1,6
WKDAIN,0,0,0,1,1,6
EKETFR,0,0,0,1,1,6
KETFRE,0,0,0,1,1,6
ETFREK,0,0,0,1,1,6
TFREKF,0,0,0,1,1,6
FREKFM,0,0,0,1,1,6
REKFMQ,0,0,0,1,1,6
EKFMQH,0,0,0,1,1,6
EKNSYR,0,0,0,1,1,6
KNSYRK,0,0,0,1,1,6
NSYRKL,0,0,0,1,1,6
SYRKLV,0,0,0,1,1,6
YRKLVG,0,0,0,1,1,6
RKLVGN,0,0,0,1,1,6
KLVGNL,0,0,0,1,1,6
LVGNLY,0,0,0,1,1,6
VGNLYF,0,0,0,1,1,6
GNLYFV,0,0,0,1,1,6
NLYFVY,0,0,0,1,1,6
LYFVYS,0,0,0,1,1,6
YFVYSA,0,0,0,1,1,6
FVYSAM,0,0,0,1,1,6
VYSAME,0,0,0,1,1,6
YSAMEE,0,0,0,1,1,6
SAMEEE,0,0,0,1,1,6
AMEEEM,0,0,0,1,1,6
MEEEMA,0,0,0,1,1,6
EEEMAK,0,0,0,1,1,6
EEMAKF,0,0,0,1,1,6
EKVQYL,0,0,0,1,1,6
KVQYLT,0,0,0,1,1,6
VQYLTR,0,0,0,1,1,6
QYLTRS,0,0,0,1,1,6
YLTRSA,0,0,0,1,1,6
LTRSAI,0,0,0,1,1,6
TRSAIR,0,0,0,1,1,6
RSAIRR,0,0,0,1,1,6
EMNYYT,0,0,0,1,1,6
MNYYTV,0,0,0,1,1,6
NYYTVL,0,0,0,1,1,6
YYTVLF,0,0,0,1,1,6
YTVLFG,0,0,0,1,1,6
TVLFGV,0,0,0,1,1,6
VLFGVS,0,0,0,1,1,6
LFGVSR,0,0,0,1,1,6
FGVSRA,0,0,0,1,1,6
GVSRAL,0,0,0,1,1,6
VSRALG,0,0,0,1,1,6
SRALGV,0,0,0,1,1,6
RALGVL,0,0,0,1,1,6
ALGVLA,0,0,0,1,1,6
LGVLAQ,0,0,0,1,1,6
GVLAQL,0,0,0,1,1,6
VLAQLI,0,0,0,1,1,6
LAQLIW,0,0,0,1,1,6
AQLIWS,0,0,0,1,1,6
QLIWSR,0,0,0,1,1,6
LIWSRA,0,0,0,1,1,6
IWSRAL,0,0,0,1,1,6
EPEEVF,0,0,0,1,1,6
PEEVFK,0,0,0,1,1,6
EEVFKS,0,0,0,1,1,6
EVFKSV,0,0,0,1,1,6
VFKSVL,0,0,0,1,1,6
FKSVLK,0,0,0,1,1,6
KSVLKE,0,0,0,1,1,6
SVLKEM,0,0,0,1,1,6
VLKEME,0,0,0,1,1,6
LKEMEG,0,0,0,1,1,6
EPEKVD,0,0,0,1,1,6
PEKVDK,0,0,0,1,1,6
EKVDKL,0,0,0,1,1,6
KVDKLQ,0,0,0,1,1,6
VDKLQE,0,0,0,1,1,6
DKLQEP,0,0,0,1,1,6
KLQEPL,0,0,0,1,1,6
LQEPLL,0,0,0,1,1,6
QEPLLE,0,0,0,1,1,6
EPLLEA,0,0,0,1,1,6
PLLEAL,0,0,0,1,1,6
LLEALR,0,0,0,1,1,6
LEALRL,0,0,0,1,1,6
EALRLY,0,0,0,1,1,6
ALRLYA,0,0,0,1,1,6
LRLYAR,0,0,0,1,1,6
RLYARR,0,0,0,1,1,6
LYARRR,0,0,0,1,1,6
YARRRR,0,0,0,1,1,6
EPGQRK,0,0,0,1,1,6
PGQRKI,0,0,0,1,1,6
GQRKIV,0,0,0,1,1,6
QRKIVM,0,0,0,1,1,6
RKIVMH,0,0,0,1,1,6
KIVMHK,0,0,0,1,1,6
EQEILR,0,0,0,1,1,6
QEILRQ,0,0,0,1,1,6
EILRQV,0,0,0,1,1,6
ILRQVK,0,0,0,1,1,6
LRQVKK,0,0,0,1,1,6
RQVKKA,0,0,0,1,1,6
QVKKAY,0,0,0,1,1,6
VKKAYD,0,0,0,1,1,6
KKAYDR,0,0,0,1,1,6
KAYDRA,0,0,0,1,1,6
AYDRAA,0,0,0,1,1,6
YDRAAR,0,0,0,1,1,6
DRAARL,0,0,0,1,1,6
RAARLG,0,0,0,1,1,6
EQEVYA,0,0,0,1,1,6
QEVYAQ,0,0,0,1,1,6
EVYAQV,0,0,0,1,1,6
VYAQVA,0,0,0,1,1,6
YAQVAR,0,0,0,1,1,6
AQVARL,0,0,0,1,1,6
EQPSLV,0,0,0,1,1,6
QPSLVR,0,0,0,1,1,6
PSLVRT,0,0,0,1,1,6
SLVRTL,0,0,0,1,1,6
LVRTLD,0,0,0,1,1,6
VRTLDQ,0,0,0,1,1,6
RTLDQL,0,0,0,1,1,6
TLDQLE,0,0,0,1,1,6
LDQLED,0,0,0,1,1,6
DQLEDK,0,0,0,1,1,6
ERQEVK,0,0,0,1,1,6
RQEVKQ,0,0,0,1,1,6
QEVKQM,0,0,0,1,1,6
EVKQMV,0,0,0,1,1,6
VKQMVV,0,0,0,1,1,6
KQMVVA,0,0,0,1,1,6
QMVVAT,0,0,0,1,1,6
MVVATL,0,0,0,1,1,6
VVATLA,0,0,0,1,1,6
VATLAE,0,0,0,1,1,6
ATLAES,0,0,0,1,1,6
ERVRAA,0,0,0,1,1,6
RVRAAM,0,0,0,1,1,6
VRAAME,0,0,0,1,1,6
RAAMEK,0,0,0,1,1,6
AAMEKL,0,0,0,1,1,6
AMEKLA,0,0,0,1,1,6
ESLYES,0,0,0,1,1,6
SLYESI,0,0,0,1,1,6
LYESIR,0,0,0,1,1,6
YESIRR,0,0,0,1,1,6
ESIRRR,0,0,0,1,1,6
SIRRRY,0,0,0,1,1,6
IRRRYE,0,0,0,1,1,6
RRRYEE,0,0,0,1,1,6
RRYEEL,0,0,0,1,1,6
ESPVRK,0,0,0,1,1,6
SPVRKI,0,0,0,1,1,6
PVRKIL,0,0,0,1,1,6
VRKILR,0,0,0,1,1,6
RKILRI,0,0,0,1,1,6
KILRIV,0,0,0,1,1,6
ILRIVF,0,0,0,1,1,6
LRIVFH,0,0,0,1,1,6
RIVFHD,0,0,0,1,1,6
IVFHDA,0,0,0,1,1,6
VFHDAI,0,0,0,1,1,6
ETNIRV,0,0,0,1,1,6
TNIRVA,0,0,0,1,1,6
NIRVAL,0,0,0,1,1,6
IRVALE,0,0,0,1,1,6
RVALEK,0,0,0,1,1,6
VALEKS,0,0,0,1,1,6
ALEKSF,0,0,0,1,1,6
LEKSFL,0,0,0,1,1,6
EVKRRF,0,0,0,1,1,6
VKRRFP,0,0,0,1,1,6
KRRFPT,0,0,0,1,1,6
RRFPTK,0,0,0,1,1,6
RFPTKL,0,0,0,1,1,6
FPTKLG,0,0,0,1,1,6
PTKLGA,0,0,0,1,1,6
TKLGAW,0,0,0,1,1,6
KLGAWA,0,0,0,1,1,6
LGAWAL,0,0,0,1,1,6
GAWALI,0,0,0,1,1,6
AWALIW,0,0,0,1,1,6
WALIWW,0,0,0,1,1,6
ALIWWL,0,0,0,1,1,6
LIWWLL,0,0,0,1,1,6
EVKRSV,0,0,0,1,1,6
VKRSVN,0,0,0,1,1,6
KRSVNR,0,0,0,1,1,6
RSVNRD,0,0,0,1,1,6
SVNRDF,0,0,0,1,1,6
VNRDFA,0,0,0,1,1,6
NRDFAK,0,0,0,1,1,6
RDFAKW,0,0,0,1,1,6
DFAKWF,0,0,0,1,1,6
FAKWFL,0,0,0,1,1,6
AKWFLI,0,0,0,1,1,6
KWFLIV,0,0,0,1,1,6
WFLIVF,0,0,0,1,1,6
FLIVFI,0,0,0,1,1,6
EVNRNF,0,0,0,1,1,6
VNRNFG,0,0,0,1,1,6
NRNFGE,0,0,0,1,1,6
RNFGER,0,0,0,1,1,6
NFGERI,0,0,0,1,1,6
FGERIN,0,0,0,1,1,6
GERIND,0,0,0,1,1,6
ERINDL,0,0,0,1,1,6
RINDLR,0,0,0,1,1,6
INDLRI,0,0,0,1,1,6
NDLRIL,0,0,0,1,1,6
DLRILI,0,0,0,1,1,6
LRILIL,0,0,0,1,1,6
RILILL,0,0,0,1,1,6
ILILLL,0,0,0,1,1,6
EVVGRV,0,0,0,1,1,6
VVGRVS,0,0,0,1,1,6
VGRVSK,0,0,0,1,1,6
GRVSKL,0,0,0,1,1,6
RVSKLW,0,0,0,1,1,6
VSKLWN,0,0,0,1,1,6
SKLWNE,0,0,0,1,1,6
KLWNEW,0,0,0,1,1,6
LWNEWW,0,0,0,1,1,6
WNEWWL,0,0,0,1,1,6
NEWWLI,0,0,0,1,1,6
EWWLIV,0,0,0,1,1,6
EWQTMV,0,0,0,1,1,6
WQTMVA,0,0,0,1,1,6
QTMVAA,0,0,0,1,1,6
TMVAAL,0,0,0,1,1,6
MVAALQ,0,0,0,1,1,6
VAALQA,0,0,0,1,1,6
EYKYYK,0,0,0,1,1,6
YKYYKL,0,0,0,1,1,6
KYYKLK,0,0,0,1,1,6
YYKLKL,0,0,0,1,1,6
YKLKLA,0,0,0,1,1,6
KLKLAE,0,0,0,1,1,6
LKLAEM,0,0,0,1,1,6
KLAEMQ,0,0,0,1,1,6
LAEMQR,0,0,0,1,1,6
FADLFD,0,0,0,1,1,6
ADLFDP,0,0,0,1,1,6
DLFDPV,0,0,0,1,1,6
LFDPVI,0,0,0,1,1,6
FDPVIQ,0,0,0,1,1,6
DPVIQE,0,0,0,1,1,6
PVIQER,0,0,0,1,1,6
VIQERH,0,0,0,1,1,6
FALRLR,0,0,0,1,1,6
ALRLRR,0,0,0,1,1,6
LRLRRV,0,0,0,1,1,6
RLRRVI,0,0,0,1,1,6
LRRVIN,0,0,0,1,1,6
RRVINR,0,0,0,1,1,6
RVINRI,0,0,0,1,1,6
VINRIG,0,0,0,1,1,6
INRIGQ,0,0,0,1,1,6
NRIGQA,0,0,0,1,1,6
RIGQAW,0,0,0,1,1,6
IGQAWR,0,0,0,1,1,6
FEVIDT,0,0,0,1,1,6
EVIDTI,0,0,0,1,1,6
VIDTIK,0,0,0,1,1,6
IDTIKA,0,0,0,1,1,6
DTIKAA,0,0,0,1,1,6
TIKAAV,0,0,0,1,1,6
IKAAVE,0,0,0,1,1,6
KAAVEN,0,0,0,1,1,6
AAVENA,0,0,0,1,1,6
FFSFEL,0,0,0,1,1,6
FSFELV,0,0,0,1,1,6
SFELVE,0,0,0,1,1,6
FELVES,0,0,0,1,1,6
ELVESI,0,0,0,1,1,6
LVESIN,0,0,0,1,1,6
VESIND,0,0,0,1,1,6
ESINDV,0,0,0,1,1,6
SINDVK,0,0,0,1,1,6
INDVKK,0,0,0,1,1,6
NDVKKS,0,0,0,1,1,6
DVKKSL,0,0,0,1,1,6
VKKSLR,0,0,0,1,1,6
FGLKVL,0,0,0,1,1,6
GLKVLG,0,0,0,1,1,6
LKVLGW,0,0,0,1,1,6
KVLGWY,0,0,0,1,1,6
VLGWYS,0,0,0,1,1,6
LGWYSE,0,0,0,1,1,6
GWYSEM,0,0,0,1,1,6
WYSEMK,0,0,0,1,1,6
YSEMKR,0,0,0,1,1,6
SEMKRN,0,0,0,1,1,6
EMKRNV,0,0,0,1,1,6
MKRNVQ,0,0,0,1,1,6
KRNVQR,0,0,0,1,1,6
RNVQRL,0,0,0,1,1,6
NVQRLE,0,0,0,1,1,6
VQRLER,0,0,0,1,1,6
QRLERA,0,0,0,1,1,6
RLERAI,0,0,0,1,1,6
LERAIE,0,0,0,1,1,6
ERAIEE,0,0,0,1,1,6
RAIEEV,0,0,0,1,1,6
FHSVAE,0,0,0,1,1,6
HSVAEQ,0,0,0,1,1,6
SVAEQF,0,0,0,1,1,6
FIAVHE,0,0,0,1,1,6
IAVHEM,0,0,0,1,1,6
AVHEML,0,0,0,1,1,6
VHEMLD,0,0,0,1,1,6
HEMLDG,0,0,0,1,1,6
EMLDGF,0,0,0,1,1,6
MLDGFR,0,0,0,1,1,6
LDGFRT,0,0,0,1,1,6
DGFRTA,0,0,0,1,1,6
GFRTAL,0,0,0,1,1,6
FRTALI,0,0,0,1,1,6
RTALID,0,0,0,1,1,6
TALIDH,0,0,0,1,1,6
ALIDHL,0,0,0,1,1,6
LIDHLD,0,0,0,1,1,6
IDHLDT,0,0,0,1,1,6
DHLDTM,0,0,0,1,1,6
HLDTMA,0,0,0,1,1,6
LDTMAE,0,0,0,1,1,6
DTMAER,0,0,0,1,1,6
TMAERA,0,0,0,1,1,6
MAERAV,0,0,0,1,1,6
AERAVQ,0,0,0,1,1,6
FKATIA,0,0,0,1,1,6
KATIAD,0,0,0,1,1,6
ATIADL,0,0,0,1,1,6
TIADLS,0,0,0,1,1,6
IADLSK,0,0,0,1,1,6
ADLSKK,0,0,0,1,1,6
DLSKKR,0,0,0,1,1,6
FKEAIE,0,0,0,1,1,6
KEAIEA,0,0,0,1,1,6
EAIEAI,0,0,0,1,1,6
AIEAIA,0,0,0,1,1,6
IEAIAE,0,0,0,1,1,6
EAIAES,0,0,0,1,1,6
AIAESA,0,0,0,1,1,6
FKGKII,0,0,0,1,1,6
KGKIIK,0,0,0,1,1,6
GKIIKK,0,0,0,1,1,6
KIIKKV,0,0,0,1,1,6
IIKKVI,0,0,0,1,1,6
IKKVIS,0,0,0,1,1,6
KKVIST,0,0,0,1,1,6
KVISTG,0,0,0,1,1,6
VISTGA,0,0,0,1,1,6
ISTGAK,0,0,0,1,1,6
STGAKL,0,0,0,1,1,6
TGAKLI,0,0,0,1,1,6
FKSIYR,0,0,0,1,1,6
KSIYRF,0,0,0,1,1,6
SIYRFF,0,0,0,1,1,6
IYRFFE,0,0,0,1,1,6
YRFFEH,0,0,0,1,1,6
RFFEHG,0,0,0,1,1,6
FFEHGL,0,0,0,1,1,6
FEHGLK,0,0,0,1,1,6
FKSVQN,0,0,0,1,1,6
KSVQNS,0,0,0,1,1,6
SVQNSL,0,0,0,1,1,6
VQNSLQ,0,0,0,1,1,6
QNSLQR,0,0,0,1,1,6
NSLQRI,0,0,0,1,1,6
SLQRIL,0,0,0,1,1,6
LQRILY,0,0,0,1,1,6
QRILYL,0,0,0,1,1,6
RILYLW,0,0,0,1,1,6
ILYLWA,0,0,0,1,1,6
LYLWAI,0,0,0,1,1,6
YLWAIR,0,0,0,1,1,6
LWAIRH,0,0,0,1,1,6
FLDQNM,0,0,0,1,1,6
LDQNML,0,0,0,1,1,6
DQNMLA,0,0,0,1,1,6
QNMLAV,0,0,0,1,1,6
NMLAVI,0,0,0,1,1,6
MLAVID,0,0,0,1,1,6
LAVIDE,0,0,0,1,1,6
AVIDEL,0,0,0,1,1,6
VIDELM,0,0,0,1,1,6
IDELMQ,0,0,0,1,1,6
DELMQA,0,0,0,1,1,6
ELMQAL,0,0,0,1,1,6
FLLKKL,0,0,0,1,1,6
KKLKKV,0,0,0,1,1,6
KLKKVA,0,0,0,1,1,6
LKKVAT,0,0,0,1,1,6
KKVATG,0,0,0,1,1,6
KVATGF,0,0,0,1,1,6
VATGFA,0,0,0,1,1,6
ATGFAK,0,0,0,1,1,6
TGFAKG,0,0,0,1,1,6
FLLSKA,0,0,0,1,1,6
LLSKAK,0,0,0,1,1,6
LSKAKD,0,0,0,1,1,6
SKAKDA,0,0,0,1,1,6
KAKDAK,0,0,0,1,1,6
AKDAKS,0,0,0,1,1,6
KDAKSS,0,0,0,1,1,6
DAKSSA,0,0,0,1,1,6
AKSSAE,0,0,0,1,1,6
KSSAEG,0,0,0,1,1,6
SSAEGA,0,0,0,1,1,6
SAEGAV,0,0,0,1,1,6
FNQRRI,0,0,0,1,1,6
NQRRIS,0,0,0,1,1,6
QRRISS,0,0,0,1,1,6
RRISSA,0,0,0,1,1,6
RISSAK,0,0,0,1,1,6
ISSAKF,0,0,0,1,1,6
SSAKFL,0,0,0,1,1,6
SAKFLG,0,0,0,1,1,6
AKFLGE,0,0,0,1,1,6
KFLGEL,0,0,0,1,1,6
FLGELY,0,0,0,1,1,6
LGELYN,0,0,0,1,1,6
GELYNY,0,0,0,1,1,6
FNRMFE,0,0,0,2,2,6
NRMFEK,0,0,0,2,2,6
RMFEKS,0,0,0,2,2,6
MFEKST,0,0,0,2,2,6
FEKSTH,0,0,0,2,2,6
EKSTHH,0,0,0,2,2,6
KSTHHY,0,0,0,2,2,6
STHHYT,0,0,0,2,2,6
THHYTD,0,0,0,2,2,6
HHYTDS,0,0,0,2,2,6
HYTDSV,0,0,0,2,2,6
YTDSVG,0,0,0,2,2,6
TDSVGG,0,0,0,2,2,6
DSVGGI,0,0,0,2,2,6
SVGGIL,0,0,0,1,1,6
VGGILR,0,0,0,1,1,6
FPLLVD,0,0,0,1,1,6
PLLVDH,0,0,0,1,1,6
LLVDHT,0,0,0,1,1,6
LVDHTS,0,0,0,1,1,6
VDHTSR,0,0,0,1,1,6
DHTSRE,0,0,0,1,1,6
HTSREA,0,0,0,1,1,6
TSREAD,0,0,0,1,1,6
SREADY,0,0,0,1,1,6
READYF,0,0,0,1,1,6
EADYFR,0,0,0,1,1,6
ADYFRK,0,0,0,1,1,6
DYFRKR,0,0,0,1,1,6
YFRKRL,0,0,0,1,1,6
FRKRLI,0,0,0,1,1,6
RKRLIQ,0,0,0,1,1,6
KRLIQL,0,0,0,1,1,6
RLIQLN,0,0,0,1,1,6
LIQLNE,0,0,0,1,1,6
IQLNEG,0,0,0,1,1,6
FPNLAS,0,0,0,1,1,6
PNLASA,0,0,0,1,1,6
NLASAA,0,0,0,1,1,6
LASAAF,0,0,0,1,1,6
ASAAFY,0,0,0,1,1,6
SAAFYW,0,0,0,1,1,6
AAFYWS,0,0,0,1,1,6
AFYWSK,0,0,0,1,1,6
FYWSKK,0,0,0,1,1,6
YWSKKE,0,0,0,1,1,6
WSKKEN,0,0,0,1,1,6
FPQLTQ,0,0,0,1,1,6
PQLTQN,0,0,0,1,1,6
QLTQNN,0,0,0,1,1,6
LTQNNS,0,0,0,1,1,6
TQNNSR,0,0,0,1,1,6
QNNSRE,0,0,0,1,1,6
FSALNI,0,0,0,1,1,6
SALNIA,0,0,0,1,1,6
ALNIAV,0,0,0,1,1,6
LNIAVH,0,0,0,1,1,6
NIAVHE,0,0,0,1,1,6
IAVHEL,0,0,0,1,1,6
AVHELS,0,0,0,1,1,6
VHELSD,0,0,0,1,1,6
HELSDV,0,0,0,1,1,6
ELSDVG,0,0,0,1,1,6
LSDVGR,0,0,0,1,1,6
SDVGRA,0,0,0,1,1,6
DVGRAI,0,0,0,1,1,6
VGRAIV,0,0,0,1,1,6
GRAIVR,0,0,0,1,1,6
RAIVRN,0,0,0,1,1,6
FSEFIQ,0,0,0,1,1,6
SEFIQA,0,0,0,1,1,6
EFIQAL,0,0,0,1,1,6
FIQALS,0,0,0,1,1,6
IQALSV,0,0,0,1,1,6
QALSVT,0,0,0,1,1,6
ALSVTS,0,0,0,1,1,6
LSVTSR,0,0,0,1,1,6
SVTSRG,0,0,0,1,1,6
FTELQR,0,0,0,1,1,6
TELQRD,0,0,0,1,1,6
ELQRDF,0,0,0,1,1,6
LQRDFL,0,0,0,1,1,6
QRDFLR,0,0,0,1,1,6
RDFLRN,0,0,0,1,1,6
FTRIIK,0,0,0,1,1,6
TRIIKA,0,0,0,1,1,6
RIIKAA,0,0,0,1,1,6
IIKAAG,0,0,0,1,1,6
FVPVFF,0,0,0,1,1,6
VPVFFV,0,0,0,1,1,6
PVFFVV,0,0,0,1,1,6
VFFVVV,0,0,0,1,1,6
FFVVVR,0,0,0,1,1,6
FVVVRR,0,0,0,1,1,6
VVVRRR,0,0,0,1,1,6
FYQTFF,0,0,0,1,1,6
YQTFFD,0,0,0,1,1,6
QTFFDE,0,0,0,1,1,6
TFFDEA,0,0,0,1,1,6
FFDEAD,0,0,0,1,1,6
FDEADE,0,0,0,1,1,6
DEADEL,0,0,0,1,1,6
EADELL,0,0,0,1,1,6
ADELLA,0,0,0,1,1,6
DELLAD,0,0,0,1,1,6
ELLADM,0,0,0,1,1,6
LLADME,0,0,0,1,1,6
LADMEQ,0,0,0,1,1,6
ADMEQH,0,0,0,1,1,6
DMEQHL,0,0,0,1,1,6
MEQHLL,0,0,0,1,1,6
EQHLLD,0,0,0,1,1,6
QHLLDL,0,0,0,1,1,6
GAFRKL,0,0,0,1,1,6
AFRKLL,0,0,0,1,1,6
FRKLLQ,0,0,0,1,1,6
RKLLQS,0,0,0,1,1,6
KLLQSA,0,0,0,1,1,6
LLQSAK,0,0,0,1,1,6
LQSAKD,0,0,0,1,1,6
QSAKDN,0,0,0,1,1,6
GAGTSV,0,0,0,1,1,6
AGTSVN,0,0,0,1,1,6
GTSVNM,0,0,0,1,1,6
TSVNMN,0,0,0,1,1,6
SVNMNT,0,0,0,1,1,6
VNMNTN,0,0,0,1,1,6
NMNTNE,0,0,0,1,1,6
MNTNEV,0,0,0,1,1,6
NTNEVL,0,0,0,1,1,6
TNEVLA,0,0,0,1,1,6
NEVLAN,0,0,0,1,1,6
EVLANI,0,0,0,1,1,6
VLANIG,0,0,0,1,1,6
LANIGL,0,0,0,1,1,6
ANIGLE,0,0,0,1,1,6
NIGLEL,0,0,0,1,1,6
IGLELM,0,0,0,1,1,6
GAPLAR,0,0,0,1,1,6
APLARM,0,0,0,1,1,6
PLARME,0,0,0,1,1,6
LARMEV,0,0,0,1,1,6
ARMEVT,0,0,0,1,1,6
RMEVTL,0,0,0,1,1,6
MEVTLA,0,0,0,1,1,6
EVTLAL,0,0,0,1,1,6
VTLALE,0,0,0,1,1,6
TLALES,0,0,0,1,1,6
LALESL,0,0,0,1,1,6
ALESLF,0,0,0,1,1,6
LESLFG,0,0,0,1,1,6
ESLFGR,0,0,0,1,1,6
SLFGRF,0,0,0,1,1,6
GAQYIQ,0,0,0,1,1,6
AQYIQA,0,0,0,1,1,6
QYIQAA,0,0,0,1,1,6
YIQAAG,0,0,0,1,1,6
IQAAGV,0,0,0,1,1,6
QAAGVA,0,0,0,1,1,6
AAGVAL,0,0,0,1,1,6
AGVALG,0,0,0,1,1,6
GVALGL,0,0,0,1,1,6
VALGLK,0,0,0,1,1,6
ALGLKM,0,0,0,1,1,6
LGLKMR,0,0,0,1,1,6
GAVAIA,0,0,0,1,1,6
AVAIAR,0,0,0,1,1,6
VAIARV,0,0,0,1,1,6
AIARVF,0,0,0,1,1,6
IARVFS,0,0,0,1,1,6
ARVFSY,0,0,0,1,1,6
GEAEIA,0,0,0,1,1,6
EAEIAS,0,0,0,1,1,6
AEIASL,0,0,0,1,1,6
EIASLK,0,0,0,1,1,6
IASLKS,0,0,0,1,1,6
ASLKSQ,0,0,0,1,1,6
SLKSQI,0,0,0,1,1,6
LKSQIR,0,0,0,1,1,6
KSQIRA,0,0,0,1,1,6
GEAYLL,0,0,0,1,1,6
EAYLLL,0,0,0,1,1,6
AYLLLE,0,0,0,1,1,6
YLLLER,0,0,0,1,1,6
LLLERY,0,0,0,1,1,6
LLERYV,0,0,0,1,1,6
LERYVA,0,0,0,1,1,6
ERYVAF,0,0,0,1,1,6
RYVAFL,0,0,0,1,1,6
YVAFLR,0,0,0,1,1,6
VAFLRA,0,0,0,1,1,6
GEDAIL,0,0,0,1,1,6
EDAILK,0,0,0,1,1,6
DAILKK,0,0,0,1,1,6
AILKKV,0,0,0,1,1,6
ILKKVA,0,0,0,1,1,6
LKKVAE,0,0,0,1,1,6
KKVAEE,0,0,0,1,1,6
KVAEEA,0,0,0,1,1,6
VAEEAA,0,0,0,1,1,6
AEEAAE,0,0,0,1,1,6
EEAAET,0,0,0,1,1,6
EAAETL,0,0,0,1,1,6
AAETLM,0,0,0,1,1,6
AETLMA,0,0,0,1,1,6
ETLMAS,0,0,0,1,1,6
TLMASK,0,0,0,1,1,6
LMASKD,0,0,0,1,1,6
GEGWAK,0,0,0,1,1,6
EGWAKS,0,0,0,1,1,6
GWAKSI,0,0,0,1,1,6
WAKSIL,0,0,0,1,1,6
AKSILF,0,0,0,1,1,6
KSILFN,0,0,0,1,1,6
GEKRAE,0,0,0,1,1,6
EKRAEE,0,0,0,1,1,6
KRAEEI,0,0,0,1,1,6
RAEEIK,0,0,0,1,1,6
AEEIKK,0,0,0,1,1,6
EEIKKI,0,0,0,1,1,6
EIKKIL,0,0,0,1,1,6
IKKILM,0,0,0,1,1,6
KKILMT,0,0,0,1,1,6
GFFGWF,0,0,0,1,1,6
FFGWFN,0,0,0,1,1,6
FGWFNR,0,0,0,1,1,6
GWFNRM,0,0,0,1,1,6
WFNRMF,0,0,0,1,1,6
GFKNEV,0,0,0,1,1,6
FKNEVR,0,0,0,1,1,6
KNEVRT,0,0,0,1,1,6
NEVRTP,0,0,0,1,1,6
EVRTPV,0,0,0,1,1,6
VRTPVT,0,0,0,1,1,6
RTPVTK,0,0,0,1,1,6
TPVTKF,0,0,0,1,1,6
PVTKFR,0,0,0,1,1,6
VTKFRI,0,0,0,1,1,6
TKFRIV,0,0,0,1,1,6
KFRIVF,0,0,0,1,1,6
FRIVFF,0,0,0,1,1,6
RIVFFV,0,0,0,1,1,6
IVFFVV,0,0,0,1,1,6
GFMIWH,0,0,0,1,1,6
FMIWHP,0,0,0,1,1,6
MIWHPK,0,0,0,1,1,6
IWHPKM,0,0,0,1,1,6
WHPKMD,0,0,0,1,1,6
HPKMDE,0,0,0,1,1,6
PKMDEY,0,0,0,1,1,6
KMDEYM,0,0,0,1,1,6
MDEYME,0,0,0,1,1,6
DEYMEE,0,0,0,1,1,6
EYMEEI,0,0,0,1,1,6
YMEEID,0,0,0,1,1,6
MEEIDG,0,0,0,1,1,6
EEIDGY,0,0,0,1,1,6
EIDGYL,0,0,0,1,1,6
IDGYLD,0,0,0,1,1,6
DGYLDE,0,0,0,1,1,6
GYLDEM,0,0,0,1,1,6
YLDEMS,0,0,0,1,1,6
LDEMSE,0,0,0,1,1,6
DEMSER,0,0,0,1,1,6
EMSERL,0,0,0,1,1,6
MSERLI,0,0,0,1,1,6
SERLIT,0,0,0,1,1,6
ERLITL,0,0,0,1,1,6
GFSVQR,0,0,0,1,1,6
FSVQRR,0,0,0,1,1,6
SVQRRL,0,0,0,1,1,6
VQRRLW,0,0,0,1,1,6
QRRLWL,0,0,0,1,1,6
RRLWLA,0,0,0,1,1,6
RLWLAS,0,0,0,1,1,6
GFYPMV,0,0,0,1,1,6
FYPMVA,0,0,0,1,1,6
YPMVAA,0,0,0,1,1,6
PMVAAQ,0,0,0,1,1,6
MVAAQR,0,0,0,1,1,6
VAAQRI,0,0,0,1,1,6
GGFAAA,0,0,0,1,1,6
GFAAAI,0,0,0,1,1,6
FAAAIA,0,0,0,1,1,6
AAAIAR,0,0,0,1,1,6
AAIARR,0,0,0,1,1,6
AIARRA,0,0,0,1,1,6
GGKEAL,0,0,0,1,1,6
GKEALA,0,0,0,1,1,6
KEALAI,0,0,0,1,1,6
EALAIE,0,0,0,1,1,6
ALAIEN,0,0,0,1,1,6
LAIENF,0,0,0,1,1,6
AIENFA,0,0,0,1,1,6
IENFAD,0,0,0,1,1,6
ENFADA,0,0,0,1,1,6
NFADAL,0,0,0,1,1,6
GGSSGV,0,0,0,1,1,6
GSSGVL,0,0,0,1,1,6
SSGVLM,0,0,0,1,1,6
SGVLMS,0,0,0,1,1,6
GVLMSI,0,0,0,1,1,6
VLMSIF,0,0,0,1,1,6
LMSIFF,0,0,0,1,1,6
MSIFFT,0,0,0,1,1,6
SIFFTA,0,0,0,1,1,6
IFFTAA,0,0,0,1,1,6
FFTAAG,0,0,0,1,1,6
FTAAGQ,0,0,0,1,1,6
TAAGQK,0,0,0,1,1,6
AAGQKL,0,0,0,1,1,6
AGQKLE,0,0,0,1,1,6
GQKLEQ,0,0,0,1,1,6
GHNLIS,0,0,0,1,1,6
HNLISL,0,0,0,1,1,6
NLISLL,0,0,0,1,1,6
LISLLE,0,0,0,1,1,6
ISLLEV,0,0,0,1,1,6
SLLEVL,0,0,0,1,1,6
LLEVLS,0,0,0,1,1,6
LEVLSG,0,0,0,1,1,6
GIHELA,0,0,0,1,1,6
IHELAV,0,0,0,1,1,6
HELAVF,0,0,0,1,1,6
ELAVFA,0,0,0,1,1,6
LAVFAE,0,0,0,1,1,6
AVFAEE,0,0,0,1,1,6
VFAEEH,0,0,0,1,1,6
GKASLR,0,0,0,1,1,6
KASLRA,0,0,0,1,1,6
ASLRAA,0,0,0,1,1,6
SLRAAE,0,0,0,1,1,6
LRAAEL,0,0,0,1,1,6
RAAELY,0,0,0,1,1,6
AAELYS,0,0,0,1,1,6
AELYSK,0,0,0,1,1,6
ELYSKY,0,0,0,1,1,6
GKDAAA,0,0,0,1,1,6
KDAAAE,0,0,0,1,1,6
DAAAEE,0,0,0,1,1,6
AAAEEI,0,0,0,1,1,6
AAEEIS,0,0,0,1,1,6
AEEISQ,0,0,0,1,1,6
EEISQL,0,0,0,1,1,6
EISQLL,0,0,0,1,1,6
ISQLLY,0,0,0,1,1,6
SQLLYH,0,0,0,1,1,6
QLLYHV,0,0,0,1,1,6
LLYHVQ,0,0,0,1,1,6
LYHVQV,0,0,0,1,1,6
YHVQVM,0,0,0,1,1,6
HVQVMM,0,0,0,1,1,6
VQVMMV,0,0,0,1,1,6
QVMMVA,0,0,0,1,1,6
VMMVAR,0,0,0,1,1,6
MMVARG,0,0,0,1,1,6
GKKGPK,0,0,0,1,1,6
KKGPKF,0,0,0,1,1,6
KGPKFI,0,0,0,1,1,6
GPKFIQ,0,0,0,1,1,6
PKFIQA,0,0,0,1,1,6
KFIQAV,0,0,0,1,1,6
FIQAVA,0,0,0,1,1,6
IQAVAS,0,0,0,1,1,6
QAVASL,0,0,0,1,1,6
AVASLK,0,0,0,1,1,6
VASLKA,0,0,0,1,1,6
GKSNMM,0,0,0,1,1,6
KSNMMD,0,0,0,1,1,6
SNMMDA,0,0,0,1,1,6
NMMDAI,0,0,0,1,1,6
MMDAIS,0,0,0,1,1,6
MDAISF,0,0,0,1,1,6
DAISFV,0,0,0,1,1,6
AISFVL,0,0,0,1,1,6
GKTTAA,0,0,0,1,1,6
KTTAAL,0,0,0,1,1,6
TTAALA,0,0,0,1,1,6
AALALA,0,0,0,1,1,6
ALALAR,0,0,0,1,1,6
LALARE,0,0,0,1,1,6
ALAREL,0,0,0,1,1,6
LARELF,0,0,0,1,1,6
ARELFG,0,0,0,1,1,6
GKTTFV,0,0,0,1,1,6
KTTFVK,0,0,0,1,1,6
TTFVKR,0,0,0,1,1,6
TFVKRH,0,0,0,1,1,6
FVKRHL,0,0,0,1,1,6
VKRHLT,0,0,0,1,1,6
KRHLTG,0,0,0,1,1,6
GKTTIL,0,0,0,1,1,6
KTTILY,0,0,0,1,1,6
TTILYR,0,0,0,1,1,6
TILYRL,0,0,0,1,1,6
ILYRLQ,0,0,0,1,1,6
LYRLQV,0,0,0,1,1,6
YRLQVG,0,0,0,1,1,6
GLEKLE,0,0,0,1,1,6
LEKLEE,0,0,0,1,1,6
EKLEES,0,0,0,1,1,6
KLEESI,0,0,0,1,1,6
LEESIY,0,0,0,1,1,6
EESIYR,0,0,0,1,1,6
ESIYRE,0,0,0,1,1,6
GLFDKV,0,0,0,1,1,6
LFDKVK,0,0,0,1,1,6
FDKVKS,0,0,0,1,1,6
DKVKSL,0,0,0,1,1,6
KVKSLV,0,0,0,1,1,6
VKSLVP,0,0,0,1,1,6
KSLVPK,0,0,0,1,1,6
SLVPKI,0,0,0,1,1,6
LVPKIA,0,0,0,1,1,6
VPKIAK,0,0,0,1,1,6
PKIAKA,0,0,0,1,1,6
KIAKAV,0,0,0,1,1,6
LFDVIG,0,0,0,1,1,6
FDVIGS,0,0,0,1,1,6
DVIGSQ,0,0,0,1,1,6
VIGSQA,0,0,0,1,1,6
IGSQAG,0,0,0,1,1,6
GSQAGG,0,0,0,1,1,6
SQAGGA,0,0,0,1,1,6
QAGGAA,0,0,0,1,1,6
AGGAAP,0,0,0,1,1,6
GGAAPH,0,0,0,1,1,6
GAAPHF,0,0,0,1,1,6
AAPHFL,0,0,0,1,1,6
APHFLG,0,0,0,1,1,6
GLFKLI,0,0,0,1,1,6
LFKLIK,0,0,0,1,1,6
FKLIKF,0,0,0,1,1,6
KLIKFA,0,0,0,1,1,6
LIKFAK,0,0,0,1,1,6
IKFAKK,0,0,0,1,1,6
KFAKKK,0,0,0,1,1,6
FAKKKS,0,0,0,1,1,6
AKKKSP,0,0,0,1,1,6
KKKSPG,0,0,0,1,1,6
KKSPGA,0,0,0,1,1,6
KSPGAF,0,0,0,1,1,6
GLGKII,0,0,0,1,1,6
LGKIIG,0,0,0,1,1,6
GKIIGK,0,0,0,1,1,6
KIIGKV,0,0,0,1,1,6
IIGKVK,0,0,0,1,1,6
IGKVKK,0,0,0,1,1,6
GKVKKS,0,0,0,1,1,6
KVKKSL,0,0,0,1,1,6
VKKSLL,0,0,0,1,1,6
KKSLLK,0,0,0,1,1,6
KSLLKS,0,0,0,1,1,6
SLLKSI,0,0,0,1,1,6
GLGLVL,0,0,0,1,1,6
LGLVLK,0,0,0,1,1,6
GLVLKI,0,0,0,1,1,6
LVLKIA,0,0,0,1,1,6
VLKIAV,0,0,0,1,1,6
LKIAVN,0,0,0,1,1,6
KIAVNA,0,0,0,1,1,6
IAVNAF,0,0,0,1,1,6
AVNAFL,0,0,0,1,1,6
VNAFLK,0,0,0,1,1,6
NAFLKL,0,0,0,1,1,6
AFLKLV,0,0,0,1,1,6
FLKLVA,0,0,0,1,1,6
GLLDIA,0,0,0,1,1,6
LLDIAG,0,0,0,1,1,6
LDIAGG,0,0,0,1,1,6
DIAGGN,0,0,0,1,1,6
IAGGNA,0,0,0,1,1,6
AGGNAE,0,0,0,1,1,6
GGNAET,0,0,0,1,1,6
GNAETL,0,0,0,1,1,6
NAETLA,0,0,0,1,1,6
AETLAG,0,0,0,1,1,6
ETLAGH,0,0,0,1,1,6
TLAGHA,0,0,0,1,1,6
LAGHAV,0,0,0,1,1,6
GLNAEL,0,0,0,1,1,6
LNAELT,0,0,0,1,1,6
NAELTR,0,0,0,1,1,6
AELTRY,0,0,0,1,1,6
ELTRYT,0,0,0,1,1,6
LTRYTL,0,0,0,1,1,6
TRYTLS,0,0,0,1,1,6
RYTLSL,0,0,0,1,1,6
YTLSLM,0,0,0,1,1,6
TLSLMV,0,0,0,1,1,6
LSLMVL,0,0,0,1,1,6
SLMVLE,0,0,0,1,1,6
LMVLER,0,0,0,1,1,6
MVLERK,0,0,0,1,1,6
VLERKL,0,0,0,1,1,6
LERKLS,0,0,0,1,1,6
ERKLSS,0,0,0,1,1,6
RKLSSA,0,0,0,1,1,6
GLTSLM,0,0,0,1,1,6
LTSLMA,0,0,0,1,1,6
TSLMAI,0,0,0,1,1,6
SLMAID,0,0,0,1,1,6
LMAIDK,0,0,0,1,1,6
MAIDKL,0,0,0,1,1,6
GLWAIA,0,0,0,1,1,6
LWAIAV,0,0,0,1,1,6
WAIAVK,0,0,0,1,1,6
AIAVKA,0,0,0,1,1,6
IAVKAG,0,0,0,1,1,6
AVKAGK,0,0,0,1,1,6
VKAGKV,0,0,0,1,1,6
KAGKVI,0,0,0,1,1,6
AGKVIL,0,0,0,1,1,6
GKVILK,0,0,0,1,1,6
KVILKL,0,0,0,1,1,6
VILKLI,0,0,0,1,1,6
ILKLIV,0,0,0,1,1,6
LKLIVF,0,0,0,1,1,6
KLIVFI,0,0,0,1,1,6
LIVFIW,0,0,0,1,1,6
IVFIWI,0,0,0,1,1,6
VFIWIR,0,0,0,1,1,6
FIWIRV,0,0,0,1,1,6
GLWKSL,0,0,0,1,1,6
LWKSLG,0,0,0,1,1,6
WKSLGA,0,0,0,1,1,6
KSLGAV,0,0,0,1,1,6
SLGAVV,0,0,0,1,1,6
LGAVVK,0,0,0,1,1,6
GAVVKR,0,0,0,1,1,6
AVVKRV,0,0,0,1,1,6
VVKRVE,0,0,0,1,1,6
VKRVEG,0,0,0,1,1,6
KRVEGL,0,0,0,1,1,6
RVEGLW,0,0,0,1,1,6
VEGLWV,0,0,0,1,1,6
EGLWVG,0,0,0,1,1,6
GLWVGL,0,0,0,1,1,6
LWVGLF,0,0,0,1,1,6
GNFADL,0,0,0,1,1,6
NFADLL,0,0,0,1,1,6
FADLLA,0,0,0,1,1,6
ADLLAH,0,0,0,1,1,6
DLLAHS,0,0,0,1,1,6
LLAHSD,0,0,0,1,1,6
LAHSDG,0,0,0,1,1,6
AHSDGL,0,0,0,1,1,6
HSDGLI,0,0,0,1,1,6
SDGLIK,0,0,0,1,1,6
DGLIKN,0,0,0,1,1,6
GLIKNI,0,0,0,1,1,6
LIKNIS,0,0,0,1,1,6
IKNISD,0,0,0,1,1,6
KNISDD,0,0,0,1,1,6
NISDDL,0,0,0,1,1,6
ISDDLR,0,0,0,1,1,6
SDDLRA,0,0,0,1,1,6
DDLRAL,0,0,0,1,1,6
DLRALD,0,0,0,1,1,6
LRALDK,0,0,0,1,1,6
RALDKL,0,0,0,1,1,6
ALDKLI,0,0,0,1,1,6
GNYLRA,0,0,0,1,1,6
NYLRAE,0,0,0,1,1,6
YLRAEI,0,0,0,1,1,6
LRAEIL,0,0,0,1,1,6
RAEILY,0,0,0,1,1,6
AEILYR,0,0,0,1,1,6
EILYRL,0,0,0,1,1,6
ILYRLK,0,0,0,1,1,6
GPDMTA,0,0,0,1,1,6
PDMTAM,0,0,0,1,1,6
DMTAMV,0,0,0,1,1,6
MTAMVA,0,0,0,1,1,6
TAMVAL,0,0,0,1,1,6
AMVALI,0,0,0,1,1,6
MVALIA,0,0,0,1,1,6
VALIAS,0,0,0,1,1,6
ALIASV,0,0,0,1,1,6
GPKDAV,0,0,0,1,1,6
PKDAVV,0,0,0,1,1,6
KDAVVK,0,0,0,1,1,6
DAVVKV,0,0,0,1,1,6
AVVKVF,0,0,0,1,1,6
VVKVFN,0,0,0,1,1,6
VKVFNQ,0,0,0,1,1,6
KVFNQW,0,0,0,1,1,6
VFNQWG,0,0,0,1,1,6
GPKKAQ,0,0,0,1,1,6
PKKAQL,0,0,0,1,1,6
KKAQLI,0,0,0,1,1,6
KAQLIV,0,0,0,1,1,6
AQLIVG,0,0,0,1,1,6
QLIVGW,0,0,0,1,1,6
LIVGWR,0,0,0,1,1,6
IVGWRE,0,0,0,1,1,6
VGWREL,0,0,0,1,1,6
GWRELH,0,0,0,1,1,6
WRELHG,0,0,0,1,1,6
GSDFLI,0,0,0,1,1,6
SDFLIH,0,0,0,1,1,6
DFLIHF,0,0,0,1,1,6
FLIHFI,0,0,0,1,1,6
LIHFID,0,0,0,1,1,6
IHFIDE,0,0,0,1,1,6
GSHANE,0,0,0,1,1,6
SHANEF,0,0,0,1,1,6
HANEFF,0,0,0,1,1,6
ANEFFF,0,0,0,1,1,6
NEFFFR,0,0,0,1,1,6
EFFFRA,0,0,0,1,1,6
GTLRHA,0,0,0,1,1,6
TLRHAA,0,0,0,1,1,6
LRHAAN,0,0,0,1,1,6
RHAANA,0,0,0,1,1,6
HAANAA,0,0,0,1,1,6
AANAAF,0,0,0,1,1,6
ANAAFI,0,0,0,1,1,6
NAAFIM,0,0,0,1,1,6
AAFIML,0,0,0,1,1,6
AFIMLE,0,0,0,1,1,6
FIMLEA,0,0,0,1,1,6
IMLEAA,0,0,0,1,1,6
MLEAAE,0,0,0,1,1,6
LEAAEL,0,0,0,1,1,6
GTTTAV,0,0,0,1,1,6
TTTAVI,0,0,0,1,1,6
TTAVII,0,0,0,1,1,6
TAVIIA,0,0,0,1,1,6
AVIIAG,0,0,0,1,1,6
VIIAGG,0,0,0,1,1,6
IIAGGL,0,0,0,1,1,6
IAGGLL,0,0,0,1,1,6
AGGLLQ,0,0,0,1,1,6
GGLLQQ,0,0,0,1,1,6
GLLQQA,0,0,0,1,1,6
LLQQAQ,0,0,0,1,1,6
LQQAQG,0,0,0,1,1,6
QQAQGL,0,0,0,1,1,6
QAQGLI,0,0,0,1,1,6
AQGLIN,0,0,0,1,1,6
GVSGLA,0,0,0,1,1,6
VSGLAA,0,0,0,1,1,6
SGLAAA,0,0,0,1,1,6
GLAAAR,0,0,0,1,1,6
LAAARQ,0,0,0,1,1,6
AAARQL,0,0,0,1,1,6
AARQLQ,0,0,0,1,1,6
ARQLQS,0,0,0,1,1,6
RQLQSF,0,0,0,1,1,6
GWQNEL,0,0,0,1,1,6
WQNELL,0,0,0,1,1,6
QNELLL,0,0,0,1,1,6
NELLLL,0,0,0,1,1,6
ELLLLL,0,0,0,1,1,6
LLLLLR,0,0,0,1,1,6
LLLLRY,0,0,0,1,1,6
LLLRYL,0,0,0,1,1,6
LLRYLD,0,0,0,1,1,6
LRYLDE,0,0,0,1,1,6
RYLDEN,0,0,0,1,1,6
GYKKVS,0,0,0,1,1,6
YKKVSK,0,0,0,1,1,6
KKVSKS,0,0,0,1,1,6
KVSKSY,0,0,0,1,1,6
VSKSYT,0,0,0,1,1,6
SKSYTG,0,0,0,1,1,6
KSYTGE,0,0,0,1,1,6
SYTGEW,0,0,0,1,1,6
YTGEWK,0,0,0,1,1,6
TGEWKK,0,0,0,1,1,6
GEWKKY,0,0,0,1,1,6
EWKKYL,0,0,0,1,1,6
WKKYLN,0,0,0,1,1,6
KKYLNS,0,0,0,1,1,6
KYLNSL,0,0,0,1,1,6
HAHASA,0,0,0,1,1,6
AHASAI,0,0,0,1,1,6
HASAIA,0,0,0,1,1,6
ASAIAK,0,0,0,1,1,6
SAIAKA,0,0,0,1,1,6
AIAKAY,0,0,0,1,1,6
IAKAYA,0,0,0,1,1,6
AKAYAS,0,0,0,1,1,6
KAYASE,0,0,0,1,1,6
AYASEI,0,0,0,1,1,6
YASEIA,0,0,0,1,1,6
ASEIAF,0,0,0,1,1,6
SEIAFE,0,0,0,1,1,6
EIAFEA,0,0,0,1,1,6
IAFEAA,0,0,0,1,1,6
AFEAAN,0,0,0,1,1,6
FEAANQ,0,0,0,1,1,6
EAANQA,0,0,0,1,1,6
AANQAI,0,0,0,1,1,6
ANQAIQ,0,0,0,1,1,6
NQAIQI,0,0,0,1,1,6
QAIQIH,0,0,0,1,1,6
AIQIHG,0,0,0,1,1,6
HALRTI,0,0,0,1,1,6
ALRTIV,0,0,0,1,1,6
LRTIVF,0,0,0,1,1,6
RTIVFE,0,0,0,1,1,6
TIVFEL,0,0,0,1,1,6
IVFELL,0,0,0,1,1,6
VFELLT,0,0,0,1,1,6
FELLTR,0,0,0,1,1,6
ELLTRH,0,0,0,1,1,6
HDKHIE,0,0,0,1,1,6
DKHIEI,0,0,0,1,1,6
KHIEIV,0,0,0,1,1,6
HIEIVV,0,0,0,1,1,6
IEIVVR,0,0,0,1,1,6
EIVVRQ,0,0,0,1,1,6
IVVRQM,0,0,0,1,1,6
HDLVTD,0,0,0,1,1,6
DLVTDG,0,0,0,1,1,6
LVTDGL,0,0,0,1,1,6
VTDGLI,0,0,0,1,1,6
TDGLIT,0,0,0,1,1,6
DGLITL,0,0,0,1,1,6
GLITLY,0,0,0,1,1,6
LITLYI,0,0,0,1,1,6
ITLYIE,0,0,0,1,1,6
TLYIET,0,0,0,1,1,6
LYIETK,0,0,0,1,1,6
HFGSLL,0,0,0,1,1,6
FGSLLL,0,0,0,1,1,6
GSLLLL,0,0,0,1,1,6
SLLLLA,0,0,0,1,1,6
LLLLAA,0,0,0,1,1,6
LLLAAW,0,0,0,1,1,6
LLAAWL,0,0,0,1,1,6
LAAWLA,0,0,0,1,1,6
AAWLAE,0,0,0,1,1,6
AWLAEN,0,0,0,1,1,6
HGLVKA,0,0,0,1,1,6
GLVKAG,0,0,0,1,1,6
LVKAGH,0,0,0,1,1,6
VKAGHP,0,0,0,1,1,6
KAGHPL,0,0,0,1,1,6
AGHPLK,0,0,0,1,1,6
GHPLKR,0,0,0,1,1,6
HPLKRK,0,0,0,1,1,6
PLKRKL,0,0,0,1,1,6
LKRKLG,0,0,0,1,1,6
KRKLGH,0,0,0,1,1,6
HHKAYV,0,0,0,1,1,6
HKAYVD,0,0,0,1,1,6
KAYVDG,0,0,0,1,1,6
AYVDGA,0,0,0,1,1,6
YVDGAN,0,0,0,1,1,6
VDGANT,0,0,0,1,1,6
DGANTA,0,0,0,1,1,6
GANTAL,0,0,0,1,1,6
ANTALD,0,0,0,1,1,6
NTALDK,0,0,0,1,1,6
TALDKL,0,0,0,1,1,6
ALDKLA,0,0,0,1,1,6
LDKLAE,0,0,0,2,2,6
DKLAEA,0,0,0,1,1,6
KLAEAR,0,0,0,1,1,6
LAEARD,0,0,0,1,1,6
AEARDK,0,0,0,1,1,6
HKEMAK,0,0,0,1,1,6
KEMAKA,0,0,0,1,1,6
EMAKAF,0,0,0,1,1,6
MAKAFE,0,0,0,1,1,6
AKAFEE,0,0,0,1,1,6
KAFEEW,0,0,0,1,1,6
HLDLIN,0,0,0,1,1,6
LDLINM,0,0,0,1,1,6
DLINMM,0,0,0,1,1,6
LINMMS,0,0,0,1,1,6
INMMSR,0,0,0,1,1,6
NMMSRL,0,0,0,1,1,6
MMSRLA,0,0,0,1,1,6
MSRLAR,0,0,0,1,1,6
SRLARE,0,0,0,1,1,6
RLAREE,0,0,0,1,1,6
LAREEL,0,0,0,1,1,6
AREELV,0,0,0,1,1,6
REELVH,0,0,0,1,1,6
EELVHH,0,0,0,1,1,6
ELVHHE,0,0,0,1,1,6
LVHHEQ,0,0,0,1,1,6
VHHEQV,0,0,0,1,1,6
HHEQVL,0,0,0,1,1,6
HEQVLR,0,0,0,1,1,6
EQVLRL,0,0,0,1,1,6
QVLRLM,0,0,0,1,1,6
VLRLMK,0,0,0,1,1,6
LRLMKR,0,0,0,1,1,6
RLMKRR,0,0,0,1,1,6
HMKMRS,0,0,0,1,1,6
MKMRSQ,0,0,0,1,1,6
KMRSQL,0,0,0,1,1,6
MRSQLL,0,0,0,1,1,6
RSQLLI,0,0,0,1,1,6
SQLLIV,0,0,0,1,1,6
QLLIVL,0,0,0,1,1,6
LLIVLQ,0,0,0,1,1,6
LIVLQE,0,0,0,1,1,6
IVLQEH,0,0,0,1,1,6
VLQEHL,0,0,0,1,1,6
LQEHLR,0,0,0,1,1,6
QEHLRN,0,0,0,1,1,6
HPAFIA,0,0,0,1,1,6
PAFIAH,0,0,0,1,1,6
AFIAHA,0,0,0,1,1,6
FIAHAD,0,0,0,1,1,6
IAHADR,0,0,0,1,1,6
AHADRV,0,0,0,1,1,6
HADRVL,0,0,0,1,1,6
ADRVLG,0,0,0,1,1,6
DRVLGG,0,0,0,1,1,6
RVLGGL,0,0,0,1,1,6
VLGGLD,0,0,0,1,1,6
LGGLDI,0,0,0,1,1,6
GGLDIA,0,0,0,1,1,6
GLDIAI,0,0,0,1,1,6
LDIAIS,0,0,0,1,1,6
DIAIST,0,0,0,1,1,6
HPFYQA,0,0,0,1,1,6
PFYQAL,0,0,0,1,1,6
FYQALG,0,0,0,1,1,6
YQALGQ,0,0,0,1,1,6
QALGQL,0,0,0,1,1,6
ALGQLA,0,0,0,1,1,6
LGQLAR,0,0,0,1,1,6
GQLARL,0,0,0,1,1,6
QLARLT,0,0,0,1,1,6
LARLTL,0,0,0,1,1,6
ARLTLA,0,0,0,1,1,6
RLTLAQ,0,0,0,1,1,6
LTLAQW,0,0,0,1,1,6
TLAQWQ,0,0,0,1,1,6
LAQWQA,0,0,0,1,1,6
AQWQAQ,0,0,0,1,1,6
QWQAQL,0,0,0,1,1,6
HQAAMQ,0,0,0,1,1,6
QAAMQM,0,0,0,1,1,6
AAMQML,0,0,0,1,1,6
AMQMLK,0,0,0,1,1,6
MQMLKE,0,0,0,1,1,6
QMLKET,0,0,0,1,1,6
MLKETI,0,0,0,1,1,6
LKETIN,0,0,0,1,1,6
KETINE,0,0,0,1,1,6
ETINEE,0,0,0,1,1,6
TINEEA,0,0,0,1,1,6
INEEAA,0,0,0,1,1,6
NEEAAE,0,0,0,1,1,6
EEAAEW,0,0,0,1,1,6
EAAEWD,0,0,0,1,1,6
AAEWDR,0,0,0,1,1,6
AEWDRL,0,0,0,1,1,6
EWDRLH,0,0,0,1,1,6
HSATRA,0,0,0,1,1,6
SATRAA,0,0,0,1,1,6
ATRAAM,0,0,0,1,1,6
TRAAML,0,0,0,1,1,6
RAAMLV,0,0,0,1,1,6
AAMLVR,0,0,0,1,1,6
AMLVRI,0,0,0,1,1,6
MLVRIN,0,0,0,1,1,6
LVRINT,0,0,0,1,1,6
HSDWIS,0,0,0,1,1,6
SDWISN,0,0,0,1,1,6
DWISNA,0,0,0,1,1,6
WISNAN,0,0,0,1,1,6
ISNANK,0,0,0,1,1,6
SNANKV,0,0,0,1,1,6
NANKVR,0,0,0,1,1,6
ANKVRV,0,0,0,1,1,6
NKVRVI,0,0,0,1,1,6
KVRVIY,0,0,0,1,1,6
VRVIYW,0,0,0,1,1,6
RVIYWQ,0,0,0,1,1,6
VIYWQM,0,0,0,1,1,6
IYWQMT,0,0,0,1,1,6
HSRRGL,0,0,0,1,1,6
SRRGLL,0,0,0,1,1,6
RRGLLK,0,0,0,1,1,6
RGLLKM,0,0,0,1,1,6
GLLKMV,0,0,0,1,1,6
LLKMVG,0,0,0,1,1,6
LKMVGK,0,0,0,1,1,6
KMVGKR,0,0,0,1,1,6
MVGKRR,0,0,0,1,1,6
VGKRRR,0,0,0,1,1,6
GKRRRL,0,0,0,1,1,6
KRRRLL,0,0,0,1,1,6
RRRLLA,0,0,0,1,1,6
RRLLAY,0,0,0,1,1,6
RLLAYL,0,0,0,1,1,6
LLAYLR,0,0,0,1,1,6
LAYLRN,0,0,0,1,1,6
AYLRNK,0,0,0,1,1,6
HTFLDD,0,0,0,1,1,6
TFLDDI,0,0,0,1,1,6
FLDDIV,0,0,0,1,1,6
LDDIVG,0,0,0,1,1,6
DDIVGA,0,0,0,1,1,6
DIVGAI,0,0,0,1,1,6
IVGAIA,0,0,0,1,1,6
VGAIAA,0,0,0,1,1,6
GAIAAA,0,0,0,1,1,6
AIAAAA,0,0,0,1,1,6
IAAAAA,0,0,0,1,1,6
AAAAAS,0,0,0,1,1,6
AAAASR,0,0,0,1,1,6
AAASRL,0,0,0,1,1,6
AASRLA,0,0,0,1,1,6
ASRLAH,0,0,0,1,1,6
SRLAHS,0,0,0,1,1,6
RLAHSY,0,0,0,1,1,6
LAHSYH,0,0,0,1,1,6
AHSYHD,0,0,0,1,1,6
HVVDEK,0,0,0,1,1,6
VVDEKA,0,0,0,1,1,6
VDEKAR,0,0,0,1,1,6
DEKARL,0,0,0,1,1,6
EKARLI,0,0,0,1,1,6
KARLIY,0,0,0,1,1,6
ARLIYE,0,0,0,1,1,6
RLIYED,0,0,0,1,1,6
HWDKVA,0,0,0,1,1,6
WDKVAD,0,0,0,1,1,6
DKVADM,0,0,0,1,1,6
KVADMV,0,0,0,1,1,6
VADMVA,0,0,0,1,1,6
ADMVAN,0,0,0,1,1,6
DMVANF,0,0,0,1,1,6
MVANFA,0,0,0,1,1,6
VANFAH,0,0,0,1,1,6
ANFAHE,0,0,0,1,1,6
NFAHEI,0,0,0,1,1,6
FAHEID,0,0,0,1,1,6
AHEIDT,0,0,0,1,1,6
HEIDTY,0,0,0,1,1,6
EIDTYG,0,0,0,1,1,6
IAMVNG,0,0,0,1,1,6
AMVNGL,0,0,0,1,1,6
MVNGLM,0,0,0,1,1,6
VNGLMG,0,0,0,1,1,6
NGLMGV,0,0,0,1,1,6
GLMGVL,0,0,0,1,1,6
LMGVLD,0,0,0,1,1,6
MGVLDK,0,0,0,1,1,6
GVLDKL,0,0,0,1,1,6
VLDKLA,0,0,0,1,1,6
LDKLAH,0,0,0,1,1,6
DKLAHL,0,0,0,1,1,6
KLAHLI,0,0,0,1,1,6
LAHLID,0,0,0,1,1,6
AHLIDE,0,0,0,1,1,6
IASEFK,0,0,0,1,1,6
ASEFKN,0,0,0,1,1,6
SEFKNI,0,0,0,1,1,6
EFKNIA,0,0,0,1,1,6
FKNIAT,0,0,0,1,1,6
KNIATN,0,0,0,1,1,6
NIATNS,0,0,0,1,1,6
IDDLRV,0,0,0,1,1,6
DDLRVI,0,0,0,1,1,6
DLRVIA,0,0,0,1,1,6
LRVIAR,0,0,0,1,1,6
RVIARE,0,0,0,1,1,6
VIAREN,0,0,0,1,1,6
IARENL,0,0,0,1,1,6
ARENLE,0,0,0,1,1,6
RENLER,0,0,0,1,1,6
ENLERR,0,0,0,1,1,6
NLERRR,0,0,0,1,1,6
LERRRK,0,0,0,1,1,6
IDDSVN,0,0,0,1,1,6
DDSVNN,0,0,0,1,1,6
DSVNNL,0,0,0,1,1,6
SVNNLI,0,0,0,1,1,6
VNNLIP,0,0,0,1,1,6
NNLIPF,0,0,0,1,1,6
NLIPFM,0,0,0,1,1,6
LIPFMQ,0,0,0,1,1,6
IPFMQK,0,0,0,1,1,6
PFMQKH,0,0,0,1,1,6
IEEATE,0,0,0,1,1,6
EEATEF,0,0,0,1,1,6
EATEFY,0,0,0,1,1,6
ATEFYE,0,0,0,1,1,6
TEFYEN,0,0,0,1,1,6
EFYEND,0,0,0,1,1,6
FYENDV,0,0,0,1,1,6
IEFRKA,0,0,0,1,1,6
EFRKAF,0,0,0,1,1,6
FRKAFL,0,0,0,1,1,6
RKAFLK,0,0,0,1,1,6
KAFLKI,0,0,0,1,1,6
AFLKIL,0,0,0,1,1,6
IGVQQH,0,0,0,1,1,6
GVQQHA,0,0,0,1,1,6
VQQHAD,0,0,0,1,1,6
QQHADK,0,0,0,1,1,6
QHADKV,0,0,0,1,1,6
HADKVQ,0,0,0,1,1,6
ADKVQR,0,0,0,1,1,6
DKVQRA,0,0,0,1,1,6
KVQRAL,0,0,0,1,1,6
VQRALG,0,0,0,1,1,6
QRALGE,0,0,0,1,1,6
RALGEA,0,0,0,1,1,6
ALGEAI,0,0,0,1,1,6
LGEAID,0,0,0,1,1,6
GEAIDD,0,0,0,1,1,6
IHNVVG,0,0,0,1,1,6
HNVVGK,0,0,0,1,1,6
NVVGKL,0,0,0,1,1,6
IKPLNN,0,0,0,1,1,6
KPLNNF,0,0,0,1,1,6
PLNNFA,0,0,0,1,1,6
LNNFAA,0,0,0,1,1,6
NNFAAE,0,0,0,1,1,6
NFAAEV,0,0,0,1,1,6
FAAEVG,0,0,0,1,1,6
AAEVGK,0,0,0,1,1,6
AEVGKI,0,0,0,1,1,6
EVGKIR,0,0,0,1,1,6
VGKIRD,0,0,0,1,1,6
GKIRDS,0,0,0,1,1,6
IMELLG,0,0,0,1,1,6
MELLGT,0,0,0,1,1,6
ELLGTV,0,0,0,1,1,6
LLGTVI,0,0,0,1,1,6
LGTVIQ,0,0,0,1,1,6
GTVIQH,0,0,0,1,1,6
TVIQHE,0,0,0,1,1,6
VIQHEG,0,0,0,1,1,6
IQHEGI,0,0,0,1,1,6
QHEGIH,0,0,0,1,1,6
HEGIHQ,0,0,0,1,1,6
EGIHQG,0,0,0,1,1,6
GIHQGQ,0,0,0,1,1,6
IHQGQY,0,0,0,1,1,6
HQGQYY,0,0,0,1,1,6
QGQYYV,0,0,0,1,1,6
GQYYVA,0,0,0,1,1,6
QYYVAL,0,0,0,1,1,6
YYVALK,0,0,0,1,1,6
YVALKQ,0,0,0,1,1,6
VALKQS,0,0,0,1,1,6
ALKQSG,0,0,0,1,1,6
IPAAKI,0,0,0,1,1,6
PAAKIN,0,0,0,1,1,6
AAKINW,0,0,0,1,1,6
AKINWD,0,0,0,1,1,6
KINWDR,0,0,0,1,1,6
INWDRD,0,0,0,1,1,6
NWDRDI,0,0,0,1,1,6
WDRDIE,0,0,0,1,1,6
DRDIEY,0,0,0,1,1,6
RDIEYM,0,0,0,1,1,6
DIEYMA,0,0,0,1,1,6
IEYMAG,0,0,0,1,1,6
EYMAGI,0,0,0,1,1,6
YMAGIL,0,0,0,1,1,6
MAGILE,0,0,0,1,1,6
AGILEN,0,0,0,1,1,6
IPAVAN,0,0,0,1,1,6
PAVANW,0,0,0,1,1,6
AVANWI,0,0,0,1,1,6
VANWIK,0,0,0,1,1,6
ANWIKR,0,0,0,1,1,6
NWIKRR,0,0,0,1,1,6
IPEAKS,0,0,0,1,1,6
PEAKSF,0,0,0,1,1,6
EAKSFY,0,0,0,1,1,6
AKSFYG,0,0,0,1,1,6
KSFYGF,0,0,0,1,1,6
SFYGFQ,0,0,0,1,1,6
FYGFQI,0,0,0,1,1,6
YGFQIM,0,0,0,1,1,6
GFQIMI,0,0,0,1,1,6
FQIMIE,0,0,0,1,1,6
QIMIEN,0,0,0,1,1,6
IMIENI,0,0,0,1,1,6
MIENIH,0,0,0,1,1,6
IENIHS,0,0,0,1,1,6
ENIHSE,0,0,0,1,1,6
NIHSET,0,0,0,1,1,6
IHSETY,0,0,0,1,1,6
HSETYS,0,0,0,1,1,6
SETYSL,0,0,0,1,1,6
ETYSLL,0,0,0,1,1,6
TYSLLI,0,0,0,1,1,6
YSLLID,0,0,0,1,1,6
SLLIDT,0,0,0,1,1,6
LLIDTY,0,0,0,1,1,6
LIDTYI,0,0,0,1,1,6
IRVNAT,0,0,0,1,1,6
RVNATK,0,0,0,1,1,6
VNATKA,0,0,0,1,1,6
NATKAY,0,0,0,1,1,6
ATKAYE,0,0,0,1,1,6
TKAYEM,0,0,0,1,1,6
KAYEMA,0,0,0,1,1,6
AYEMAL,0,0,0,1,1,6
KDAENH,0,0,0,1,1,6
DAENHK,0,0,0,1,1,6
AENHKA,0,0,0,1,1,6
ENHKAY,0,0,0,1,1,6
NHKAYL,0,0,0,1,1,6
HKAYLK,0,0,0,1,1,6
KAYLKS,0,0,0,1,1,6
AYLKSH,0,0,0,1,1,6
KDFETL,0,0,0,1,1,6
DFETLK,0,0,0,1,1,6
FETLKV,0,0,0,1,1,6
ETLKVD,0,0,0,1,1,6
TLKVDF,0,0,0,1,1,6
LKVDFL,0,0,0,1,1,6
KVDFLS,0,0,0,1,1,6
VDFLSK,0,0,0,1,1,6
DFLSKL,0,0,0,1,1,6
FLSKLP,0,0,0,1,1,6
LSKLPE,0,0,0,1,1,6
SKLPEM,0,0,0,1,1,6
KLPEML,0,0,0,1,1,6
LPEMLK,0,0,0,1,1,6
PEMLKM,0,0,0,1,1,6
EMLKMF,0,0,0,1,1,6
MLKMFE,0,0,0,1,1,6
LKMFED,0,0,0,1,1,6
KMFEDR,0,0,0,1,1,6
MFEDRL,0,0,0,1,1,6
KDTVIE,0,0,0,1,1,6
DTVIED,0,0,0,1,1,6
TVIEDI,0,0,0,1,1,6
VIEDII,0,0,0,1,1,6
IEDIID,0,0,0,1,1,6
EDIIDK,0,0,0,1,1,6
DIIDKT,0,0,0,1,1,6
IIDKTF,0,0,0,1,1,6
IDKTFE,0,0,0,1,1,6
DKTFEE,0,0,0,1,1,6
KTFEEA,0,0,0,1,1,6
TFEEAD,0,0,0,1,1,6
KEDIHR,0,0,0,1,1,6
EDIHRS,0,0,0,1,1,6
DIHRSL,0,0,0,1,1,6
IHRSLV,0,0,0,1,1,6
HRSLVE,0,0,0,1,1,6
RSLVEE,0,0,0,1,1,6
LVEELT,0,0,0,1,1,6
VEELTK,0,0,0,1,1,6
EELTKI,0,0,0,1,1,6
ELTKIS,0,0,0,1,1,6
LTKISA,0,0,0,1,1,6
TKISAK,0,0,0,1,1,6
KISAKE,0,0,0,1,1,6
ISAKEK,0,0,0,1,1,6
KEEGYF,0,0,0,1,1,6
EEGYFY,0,0,0,1,1,6
EGYFYF,0,0,0,1,1,6
GYFYFR,0,0,0,1,1,6
YFYFRS,0,0,0,1,1,6
FYFRSR,0,0,0,1,1,6
YFRSRL,0,0,0,1,1,6
FRSRLS,0,0,0,1,1,6
RSRLSQ,0,0,0,1,1,6
KEEVQK,0,0,0,1,1,6
EEVQKV,0,0,0,1,1,6
EVQKVL,0,0,0,1,1,6
VQKVLE,0,0,0,1,1,6
QKVLED,0,0,0,1,1,6
KVLEDA,0,0,0,1,1,6
KEIAEK,0,0,0,1,1,6
EIAEKM,0,0,0,1,1,6
IAEKMV,0,0,0,1,1,6
AEKMVE,0,0,0,1,1,6
EKMVEG,0,0,0,1,1,6
KMVEGR,0,0,0,1,1,6
MVEGRM,0,0,0,1,1,6
VEGRMK,0,0,0,1,1,6
EGRMKK,0,0,0,1,1,6
GRMKKF,0,0,0,1,1,6
RMKKFT,0,0,0,1,1,6
MKKFTG,0,0,0,1,1,6
KKFTGE,0,0,0,1,1,6
KFTGEV,0,0,0,1,1,6
KFLKKW,0,0,0,1,1,6
FLKKWE,0,0,0,1,1,6
LKKWEG,0,0,0,1,1,6
KKWEGI,0,0,0,1,1,6
KWEGIW,0,0,0,1,1,6
WEGIWA,0,0,0,1,1,6
EGIWAT,0,0,0,1,1,6
GIWATF,0,0,0,1,1,6
IWATFK,0,0,0,1,1,6
WATFKP,0,0,0,1,1,6
ATFKPA,0,0,0,1,1,6
TFKPAL,0,0,0,1,1,6
FKPALS,0,0,0,1,1,6
KPALSA,0,0,0,1,1,6
PALSAV,0,0,0,1,1,6
ALSAVV,0,0,0,1,1,6
KFLRFI,0,0,0,1,1,6
FLRFIL,0,0,0,1,1,6
LRFILK,0,0,0,1,1,6
RFILKW,0,0,0,1,1,6
FILKWF,0,0,0,1,1,6
ILKWFK,0,0,0,1,1,6
LKWFKV,0,0,0,1,1,6
KWFKVI,0,0,0,1,1,6
WFKVIF,0,0,0,1,1,6
FKVIFQ,0,0,0,1,1,6
KFLTKL,0,0,0,1,1,6
FLTKLK,0,0,0,1,1,6
LTKLKN,0,0,0,1,1,6
TKLKNI,0,0,0,1,1,6
KLKNIV,0,0,0,1,1,6
LKNIVA,0,0,0,1,1,6
KNIVAN,0,0,0,1,1,6
NIVANI,0,0,0,1,1,6
IVANIR,0,0,0,1,1,6
VANIRI,0,0,0,1,1,6
ANIRIW,0,0,0,1,1,6
NIRIWW,0,0,0,1,1,6
IRIWWV,0,0,0,1,1,6
RIWWVI,0,0,0,1,1,6
IWWVIL,0,0,0,1,1,6
WWVILL,0,0,0,1,1,6
KGQEYI,0,0,0,1,1,6
GQEYIN,0,0,0,1,1,6
QEYINN,0,0,0,1,1,6
EYINNI,0,0,0,1,1,6
YINNIH,0,0,0,1,1,6
INNIHL,0,0,0,1,1,6
KHFDFL,0,0,0,1,1,6
HFDFLA,0,0,0,1,1,6
FDFLAE,0,0,0,1,1,6
DFLAEF,0,0,0,1,1,6
FLAEFN,0,0,0,1,1,6
LAEFNA,0,0,0,1,1,6
AEFNAK,0,0,0,1,1,6
EFNAKA,0,0,0,1,1,6
FNAKAN,0,0,0,1,1,6
NAKAND,0,0,0,1,1,6
KHHAAY,0,0,0,1,1,6
HHAAYV,0,0,0,1,1,6
HAAYVN,0,0,0,1,1,6
AAYVNN,0,0,0,1,1,6
AYVNNL,0,0,0,1,1,6
YVNNLN,0,0,0,1,1,6
VNNLNN,0,0,0,1,1,6
NNLNNA,0,0,0,1,1,6
NLNNAL,0,0,0,1,1,6
LNNALK,0,0,0,1,1,6
NNALKK,0,0,0,1,1,6
KIPDDL,0,0,0,1,1,6
IPDDLQ,0,0,0,1,1,6
PDDLQA,0,0,0,1,1,6
DDLQAD,0,0,0,1,1,6
DLQADF,0,0,0,1,1,6
LQADFN,0,0,0,1,1,6
QADFNK,0,0,0,1,1,6
ADFNKF,0,0,0,1,1,6
DFNKFR,0,0,0,1,1,6
KKAEAV,0,0,0,1,1,6
KAEAVA,0,0,0,1,1,6
AEAVAT,0,0,0,1,1,6
EAVATV,0,0,0,1,1,6
AVATVV,0,0,0,1,1,6
VATVVA,0,0,0,1,1,6
ATVVAA,0,0,0,1,1,6
TVVAAV,0,0,0,1,1,6
VVAAVD,0,0,0,1,1,6
VAAVDQ,0,0,0,1,1,6
AAVDQA,0,0,0,1,1,6
AVDQAR,0,0,0,1,1,6
VDQARV,0,0,0,1,1,6
DQARVR,0,0,0,1,1,6
KKDVKL,0,0,0,1,1,6
KDVKLI,0,0,0,1,1,6
DVKLIL,0,0,0,1,1,6
VKLILD,0,0,0,1,1,6
KLILDT,0,0,0,1,1,6
LILDTI,0,0,0,1,1,6
ILDTIL,0,0,0,1,1,6
LDTILE,0,0,0,1,1,6
DTILET,0,0,0,1,1,6
TILETI,0,0,0,1,1,6
ILETIT,0,0,0,1,1,6
LETITE,0,0,0,1,1,6
ETITEA,0,0,0,1,1,6
TITEAL,0,0,0,1,1,6
ITEALA,0,0,0,1,1,6
TEALAK,0,0,0,1,1,6
KKEELQ,0,0,0,1,1,6
KEELQR,0,0,0,1,1,6
EELQRS,0,0,0,1,1,6
ELQRSL,0,0,0,1,1,6
LQRSLN,0,0,0,1,1,6
QRSLNI,0,0,0,1,1,6
RSLNIL,0,0,0,1,1,6
SLNILT,0,0,0,1,1,6
LNILTA,0,0,0,1,1,6
NILTAF,0,0,0,1,1,6
KKQELL,0,0,0,1,1,6
KQELLE,0,0,0,1,1,6
QELLEA,0,0,0,1,1,6
ELLEAL,0,0,0,1,1,6
LLEALT,0,0,0,1,1,6
LEALTK,0,0,0,1,1,6
EALTKH,0,0,0,1,1,6
ALTKHF,0,0,0,1,1,6
LTKHFQ,0,0,0,1,1,6
KKTAER,0,0,0,1,1,6
KTAERL,0,0,0,1,1,6
TAERLI,0,0,0,1,1,6
AERLIV,0,0,0,1,1,6
ERLIVE,0,0,0,1,1,6
RLIVEM,0,0,0,1,1,6
LIVEMK,0,0,0,1,1,6
IVEMKD,0,0,0,1,1,6
VEMKDR,0,0,0,1,1,6
EMKDRF,0,0,0,1,1,6
MKDRFK,0,0,0,1,1,6
KDRFKG,0,0,0,1,1,6
KKVKGY,0,0,0,1,1,6
KVKGYK,0,0,0,1,1,6
VKGYKR,0,0,0,1,1,6
KGYKRA,0,0,0,1,1,6
GYKRAL,0,0,0,1,1,6
YKRALT,0,0,0,1,1,6
KRALTE,0,0,0,1,1,6
KLDSRF,0,0,0,1,1,6
LDSRFD,0,0,0,1,1,6
DSRFDN,0,0,0,1,1,6
SRFDNN,0,0,0,1,1,6
RFDNNL,0,0,0,1,1,6
FDNNLG,0,0,0,1,1,6
DNNLGK,0,0,0,1,1,6
NNLGKF,0,0,0,1,1,6
NLGKFR,0,0,0,1,1,6
LGKFRF,0,0,0,1,1,6
GKFRFV,0,0,0,1,1,6
KFRFVL,0,0,0,1,1,6
FRFVLL,0,0,0,1,1,6
RFVLLL,0,0,0,1,1,6
FVLLLF,0,0,0,1,1,6
VLLLFV,0,0,0,1,1,6
KLEEKF,0,0,0,1,1,6
LEEKFP,0,0,0,1,1,6
EEKFPQ,0,0,0,1,1,6
EKFPQV,0,0,0,1,1,6
KFPQVA,0,0,0,1,1,6
FPQVAA,0,0,0,1,1,6
PQVAAT,0,0,0,1,1,6
KLKELA,0,0,0,1,1,6
LKELAL,0,0,0,1,1,6
KELALI,0,0,0,1,1,6
ELALIF,0,0,0,1,1,6
LALIFI,0,0,0,1,1,6
ALIFIS,0,0,0,1,1,6
LIFISN,0,0,0,1,1,6
IFISNL,0,0,0,1,1,6
FISNLV,0,0,0,1,1,6
ISNLVA,0,0,0,1,1,6
SNLVAN,0,0,0,1,1,6
KNIKRN,0,0,0,1,1,6
NIKRNV,0,0,0,1,1,6
IKRNVE,0,0,0,1,1,6
KRNVEK,0,0,0,1,1,6
RNVEKI,0,0,0,1,1,6
NVEKII,0,0,0,1,1,6
VEKIIA,0,0,0,1,1,6
EKIIAQ,0,0,0,1,1,6
KIIAQW,0,0,0,1,1,6
IIAQWD,0,0,0,1,1,6
IAQWDE,0,0,0,1,1,6
AQWDER,0,0,0,1,1,6
QWDERT,0,0,0,1,1,6
WDERTR,0,0,0,1,1,6
DERTRK,0,0,0,1,1,6
KPEEVE,0,0,0,1,1,6
PEEVEQ,0,0,0,1,1,6
EEVEQI,0,0,0,1,1,6
EVEQIK,0,0,0,1,1,6
VEQIKL,0,0,0,1,1,6
EQIKLY,0,0,0,1,1,6
QIKLYV,0,0,0,1,1,6
IKLYVM,0,0,0,1,1,6
KLYVMS,0,0,0,1,1,6
LYVMSR,0,0,0,1,1,6
YVMSRE,0,0,0,1,1,6
VMSREY,0,0,0,1,1,6
MSREYE,0,0,0,1,1,6
SREYED,0,0,0,1,1,6
REYEDY,0,0,0,1,1,6
EYEDYM,0,0,0,1,1,6
YEDYMA,0,0,0,1,1,6
EDYMAR,0,0,0,1,1,6
KPEQYN,0,0,0,1,1,6
PEQYNI,0,0,0,1,1,6
EQYNIV,0,0,0,1,1,6
QYNIVG,0,0,0,1,1,6
YNIVGE,0,0,0,1,1,6
NIVGEH,0,0,0,1,1,6
IVGEHL,0,0,0,1,1,6
VGEHLL,0,0,0,1,1,6
GEHLLA,0,0,0,1,1,6
EHLLAT,0,0,0,1,1,6
HLLATL,0,0,0,1,1,6
LLATLD,0,0,0,1,1,6
LATLDE,0,0,0,1,1,6
ATLDEM,0,0,0,1,1,6
TLDEMF,0,0,0,1,1,6
LDEMFS,0,0,0,1,1,6
KPQELL,0,0,0,1,1,6
PQELLS,0,0,0,1,1,6
QELLSL,0,0,0,1,1,6
ELLSLI,0,0,0,1,1,6
LLSLII,0,0,0,1,1,6
LSLIIE,0,0,0,1,1,6
SLIIER,0,0,0,1,1,6
LIIERF,0,0,0,1,1,6
IIERFE,0,0,0,1,1,6
KPQERA,0,0,0,1,1,6
PQERAD,0,0,0,1,1,6
QERADL,0,0,0,1,1,6
ERADLI,0,0,0,1,1,6
RADLIS,0,0,0,1,1,6
ADLISY,0,0,0,1,1,6
DLISYL,0,0,0,1,1,6
LISYLK,0,0,0,1,1,6
ISYLKE,0,0,0,1,1,6
SYLKEA,0,0,0,1,1,6
YLKEAT,0,0,0,1,1,6
LKEATS,0,0,0,1,1,6
KPWLSV,0,0,0,1,1,6
PWLSVI,0,0,0,1,1,6
WLSVIL,0,0,0,1,1,6
LSVILF,0,0,0,1,1,6
SVILFL,0,0,0,1,1,6
VILFLI,0,0,0,1,1,6
ILFLIR,0,0,0,1,1,6
LFLIRE,0,0,0,1,1,6
FLIRER,0,0,0,1,1,6
LIRERS,0,0,0,1,1,6
IRERSR,0,0,0,1,1,6
KQAEAE,0,0,0,1,1,6
QAEAEE,0,0,0,1,1,6
AEAEEF,0,0,0,1,1,6
EAEEFV,0,0,0,1,1,6
AEEFVQ,0,0,0,1,1,6
EEFVQT,0,0,0,1,1,6
EFVQTL,0,0,0,1,1,6
FVQTLG,0,0,0,1,1,6
VQTLGQ,0,0,0,1,1,6
QTLGQS,0,0,0,1,1,6
TLGQSL,0,0,0,1,1,6
LGQSLA,0,0,0,1,1,6
KQLTAI,0,0,0,1,1,6
QLTAIA,0,0,0,1,1,6
LTAIAA,0,0,0,1,1,6
TAIAAL,0,0,0,1,1,6
AIAALA,0,0,0,1,1,6
IAALAE,0,0,0,1,1,6
KREIIH,0,0,0,1,1,6
REIIHA,0,0,0,1,1,6
EIIHAV,0,0,0,1,1,6
IIHAVL,0,0,0,1,1,6
IHAVLT,0,0,0,1,1,6
HAVLTG,0,0,0,1,1,6
AVLTGL,0,0,0,1,1,6
VLTGLA,0,0,0,1,1,6
LTGLAL,0,0,0,1,1,6
TGLALD,0,0,0,1,1,6
GLALDQ,0,0,0,1,1,6
LALDQL,0,0,0,1,1,6
ALDQLA,0,0,0,1,1,6
LDQLAE,0,0,0,1,1,6
DQLAEQ,0,0,0,1,1,6
KREVQN,0,0,0,1,1,6
REVQNA,0,0,0,1,1,6
EVQNAI,0,0,0,1,1,6
VQNAIL,0,0,0,1,1,6
QNAILT,0,0,0,1,1,6
NAILTG,0,0,0,1,1,6
AILTGI,0,0,0,1,1,6
ILTGIQ,0,0,0,1,1,6
LTGIQL,0,0,0,1,1,6
TGIQLD,0,0,0,1,1,6
GIQLDK,0,0,0,1,1,6
IQLDKL,0,0,0,1,1,6
QLDKLA,0,0,0,1,1,6
DKLAED,0,0,0,1,1,6
KSEALA,0,0,0,1,1,6
SEALAK,0,0,0,1,1,6
EALAKM,0,0,0,1,1,6
ALAKMW,0,0,0,1,1,6
LAKMWG,0,0,0,1,1,6
AKMWGQ,0,0,0,1,1,6
KMWGQR,0,0,0,1,1,6
MWGQRK,0,0,0,1,1,6
KTASTG,0,0,0,1,1,6
TASTGF,0,0,0,1,1,6
ASTGFA,0,0,0,1,1,6
STGFAE,0,0,0,1,1,6
TGFAEL,0,0,0,1,1,6
GFAELL,0,0,0,1,1,6
FAELLK,0,0,0,1,1,6
AELLKD,0,0,0,1,1,6
ELLKDR,0,0,0,1,1,6
LLKDRR,0,0,0,1,1,6
LKDRRE,0,0,0,1,1,6
KDRREQ,0,0,0,1,1,6
DRREQV,0,0,0,1,1,6
KTFRTT,0,0,0,1,1,6
TFRTTF,0,0,0,1,1,6
FRTTFK,0,0,0,1,1,6
RTTFKT,0,0,0,1,1,6
TTFKTL,0,0,0,1,1,6
TFKTLL,0,0,0,1,1,6
KVAEFE,0,0,0,1,1,6
VAEFER,0,0,0,1,1,6
AEFERL,0,0,0,1,1,6
EFERLF,0,0,0,1,1,6
FERLFR,0,0,0,1,1,6
ERLFRQ,0,0,0,1,1,6
RLFRQA,0,0,0,1,1,6
LFRQAA,0,0,0,1,1,6
FRQAAG,0,0,0,1,1,6
KVNRAV,0,0,0,1,1,6
VNRAVA,0,0,0,1,1,6
NRAVAA,0,0,0,1,1,6
RAVAAE,0,0,0,1,1,6
AVAAEI,0,0,0,1,1,6
VAAEIR,0,0,0,1,1,6
AAEIRN,0,0,0,1,1,6
AEIRNW,0,0,0,1,1,6
EIRNWT,0,0,0,1,1,6
IRNWTW,0,0,0,1,1,6
RNWTWV,0,0,0,1,1,6
NWTWVF,0,0,0,1,1,6
WTWVFL,0,0,0,1,1,6
TWVFLI,0,0,0,1,1,6
WVFLIW,0,0,0,1,1,6
KVRETR,0,0,0,1,1,6
VRETRE,0,0,0,1,1,6
RETREI,0,0,0,1,1,6
ETREIL,0,0,0,1,1,6
TREILD,0,0,0,1,1,6
REILDI,0,0,0,1,1,6
EILDII,0,0,0,1,1,6
ILDIID,0,0,0,1,1,6
LDIIDT,0,0,0,1,1,6
DIIDTV,0,0,0,1,1,6
IIDTVY,0,0,0,1,1,6
IDTVYN,0,0,0,1,1,6
DTVYNS,0,0,0,1,1,6
KVRGLI,0,0,0,1,1,6
VRGLIE,0,0,0,1,1,6
RGLIEI,0,0,0,1,1,6
GLIEII,0,0,0,1,1,6
LIEIIS,0,0,0,1,1,6
IEIISN,0,0,0,1,1,6
KVSDIL,0,0,0,1,1,6
VSDILT,0,0,0,1,1,6
SDILTV,0,0,0,1,1,6
DILTVA,0,0,0,1,1,6
ILTVAI,0,0,0,1,1,6
LTVAIR,0,0,0,1,1,6
TVAIRL,0,0,0,1,1,6
VAIRLE,0,0,0,1,1,6
AIRLEE,0,0,0,1,1,6
IRLEEE,0,0,0,1,1,6
RLEEEG,0,0,0,1,1,6
LEEEGE,0,0,0,1,1,6
EEEGER,0,0,0,1,1,6
EEGERF,0,0,0,1,1,6
EGERFY,0,0,0,1,1,6
GERFYR,0,0,0,1,1,6
ERFYRE,0,0,0,1,1,6
RFYREL,0,0,0,1,1,6
FYRELS,0,0,0,1,1,6
KVVDNF,0,0,0,1,1,6
VVDNFE,0,0,0,1,1,6
VDNFEN,0,0,0,1,1,6
DNFENI,0,0,0,1,1,6
NFENIL,0,0,0,1,1,6
FENILI,0,0,0,1,1,6
ENILII,0,0,0,1,1,6
KVWKGV,0,0,0,1,1,6
VWKGVK,0,0,0,1,1,6
WKGVKT,0,0,0,1,1,6
KGVKTI,0,0,0,1,1,6
GVKTII,0,0,0,1,1,6
VKTIIA,0,0,0,1,1,6
KTIIAD,0,0,0,1,1,6
TIIADV,0,0,0,1,1,6
IIADVW,0,0,0,1,1,6
IADVWQ,0,0,0,1,1,6
ADVWQV,0,0,0,1,1,6
KWEAEK,0,0,0,1,1,6
WEAEKI,0,0,0,1,1,6
EAEKIH,0,0,0,1,1,6
AEKIHI,0,0,0,1,1,6
EKIHIG,0,0,0,1,1,6
KIHIGF,0,0,0,1,1,6
IHIGFR,0,0,0,1,1,6
HIGFRQ,0,0,0,1,1,6
IGFRQA,0,0,0,1,1,6
GFRQAY,0,0,0,1,1,6
KWVRIW,0,0,0,1,1,6
WVRIWI,0,0,0,1,1,6
VRIWIK,0,0,0,1,1,6
RIWIKV,0,0,0,1,1,6
IWIKVL,0,0,0,1,1,6
WIKVLR,0,0,0,1,1,6
IKVLRG,0,0,0,1,1,6
KVLRGL,0,0,0,1,1,6
VLRGLF,0,0,0,1,1,6
LRGLFV,0,0,0,1,1,6
RGLFVW,0,0,0,1,1,6
GLFVWV,0,0,0,1,1,6
LFVWVW,0,0,0,1,1,6
FVWVWF,0,0,0,1,1,6
VWVWFF,0,0,0,1,1,6
KYDHFA,0,0,0,1,1,6
YDHFAG,0,0,0,1,1,6
DHFAGR,0,0,0,1,1,6
HFAGRA,0,0,0,1,1,6
FAGRAY,0,0,0,1,1,6
AGRAYV,0,0,0,1,1,6
GRAYVR,0,0,0,1,1,6
RAYVRL,0,0,0,1,1,6
AYVRLH,0,0,0,1,1,6
YVRLHQ,0,0,0,1,1,6
VRLHQD,0,0,0,1,1,6
LADLQE,0,0,0,1,1,6
ADLQEQ,0,0,0,1,1,6
DLQEQL,0,0,0,1,1,6
LQEQLY,0,0,0,1,1,6
QEQLYN,0,0,0,1,1,6
EQLYNG,0,0,0,1,1,6
LDAYIN,0,0,0,1,1,6
DAYINL,0,0,0,1,1,6
AYINLG,0,0,0,1,1,6
YINLGN,0,0,0,1,1,6
INLGNV,0,0,0,1,1,6
NLGNVL,0,0,0,1,1,6
LGNVLK,0,0,0,1,1,6
GNVLKE,0,0,0,1,1,6
NVLKEA,0,0,0,1,1,6
LDEAAT,0,0,0,1,1,6
DEAATR,0,0,0,1,1,6
EAATRS,0,0,0,1,1,6
AATRSK,0,0,0,1,1,6
ATRSKA,0,0,0,1,1,6
TRSKAW,0,0,0,1,1,6
RSKAWM,0,0,0,1,1,6
SKAWMV,0,0,0,1,1,6
KAWMVD,0,0,0,1,1,6
AWMVDA,0,0,0,1,1,6
WMVDAL,0,0,0,1,1,6
MVDALA,0,0,0,1,1,6
LEARMK,0,0,0,1,1,6
EARMKQ,0,0,0,1,1,6
ARMKQF,0,0,0,1,1,6
RMKQFK,0,0,0,1,1,6
MKQFKD,0,0,0,1,1,6
KQFKDM,0,0,0,1,1,6
QFKDML,0,0,0,1,1,6
FKDMLL,0,0,0,1,1,6
KDMLLE,0,0,0,1,1,6
DMLLER,0,0,0,1,1,6
LEEFDK,0,0,0,1,1,6
EEFDKV,0,0,0,1,1,6
EFDKVS,0,0,0,1,1,6
FDKVSK,0,0,0,1,1,6
DKVSKN,0,0,0,1,1,6
KVSKNV,0,0,0,1,1,6
VSKNVD,0,0,0,1,1,6
LEPIKA,0,0,0,1,1,6
EPIKAW,0,0,0,1,1,6
PIKAWI,0,0,0,1,1,6
IKAWIE,0,0,0,1,1,6
KAWIEK,0,0,0,1,1,6
AWIEKR,0,0,0,1,1,6
LEQVEF,0,0,0,1,1,6
EQVEFK,0,0,0,1,1,6
QVEFKL,0,0,0,1,1,6
VEFKLN,0,0,0,1,1,6
EFKLNQ,0,0,0,1,1,6
FKLNQL,0,0,0,1,1,6
KLNQLL,0,0,0,1,1,6
LNQLLE,0,0,0,1,1,6
NQLLEN,0,0,0,1,1,6
QLLENL,0,0,0,1,1,6
LHDAIH,0,0,0,1,1,6
HDAIHM,0,0,0,1,1,6
DAIHMA,0,0,0,1,1,6
AIHMAA,0,0,0,1,1,6
IHMAAD,0,0,0,1,1,6
HMAADN,0,0,0,1,1,6
MAADNA,0,0,0,1,1,6
AADNAV,0,0,0,1,1,6
LKRAEA,0,0,0,1,1,6
KRAEAL,0,0,0,1,1,6
RAEALI,0,0,0,1,1,6
AEALIH,0,0,0,1,1,6
EALIHL,0,0,0,1,1,6
ALIHLA,0,0,0,1,1,6
LIHLAN,0,0,0,1,1,6
IHLANA,0,0,0,1,1,6
HLANAA,0,0,0,1,1,6
LANAAL,0,0,0,1,1,6
ANAALE,0,0,0,1,1,6
LKYVGM,0,0,0,1,1,6
KYVGMV,0,0,0,1,1,6
YVGMVL,0,0,0,1,1,6
VGMVLN,0,0,0,1,1,6
GMVLNE,0,0,0,1,1,6
MVLNEA,0,0,0,1,1,6
VLNEAL,0,0,0,1,1,6
LNEALR,0,0,0,1,1,6
NEALRL,0,0,0,1,1,6
EALRLW,0,0,0,1,1,6
LLNIRR,0,0,0,1,1,6
LNIRRE,0,0,0,1,1,6
NIRREF,0,0,0,1,1,6
IRREFI,0,0,0,1,1,6
RREFIE,0,0,0,1,1,6
REFIEK,0,0,0,1,1,6
EFIEKY,0,0,0,1,1,6
LLPALL,0,0,0,1,1,6
LPALLQ,0,0,0,1,1,6
PALLQQ,0,0,0,1,1,6
ALLQQI,0,0,0,1,1,6
LLQQIG,0,0,0,1,1,6
LQQIGR,0,0,0,1,1,6
QQIGRE,0,0,0,1,1,6
QIGREN,0,0,0,1,1,6
LLTEVE,0,0,0,1,1,6
LTEVET,0,0,0,1,1,6
TEVETY,0,0,0,1,1,6
EVETYV,0,0,0,1,1,6
VETYVL,0,0,0,1,1,6
ETYVLS,0,0,0,1,1,6
TYVLSI,0,0,0,1,1,6
LMEPVR,0,0,0,1,1,6
MEPVRE,0,0,0,1,1,6
EPVREA,0,0,0,1,1,6
PVREAA,0,0,0,1,1,6
VREAAG,0,0,0,1,1,6
REAAGR,0,0,0,1,1,6
EAAGRL,0,0,0,1,1,6
AAGRLA,0,0,0,1,1,6
AGRLAD,0,0,0,1,1,6
GRLADA,0,0,0,1,1,6
LMGHQK,0,0,0,1,1,6
MGHQKK,0,0,0,1,1,6
GHQKKI,0,0,0,1,1,6
HQKKIL,0,0,0,1,1,6
QKKILG,0,0,0,1,1,6
KKILGS,0,0,0,1,1,6
KILGSI,0,0,0,1,1,6
ILGSIQ,0,0,0,1,1,6
LGSIQT,0,0,0,1,1,6
GSIQTM,0,0,0,1,1,6
SIQTMR,0,0,0,1,1,6
IQTMRA,0,0,0,1,1,6
QTMRAQ,0,0,0,1,1,6
TMRAQL,0,0,0,1,1,6
MRAQLT,0,0,0,1,1,6
LNNFSR,0,0,0,1,1,6
NNFSRY,0,0,0,1,1,6
NFSRYF,0,0,0,1,1,6
FSRYFL,0,0,0,1,1,6
SRYFLH,0,0,0,1,1,6
RYFLHQ,0,0,0,1,1,6
YFLHQS,0,0,0,1,1,6
FLHQSR,0,0,0,1,1,6
LHQSRE,0,0,0,1,1,6
HQSREE,0,0,0,1,1,6
QSREET,0,0,0,1,1,6
SREETE,0,0,0,1,1,6
REETEH,0,0,0,1,1,6
EETEHA,0,0,0,1,1,6
ETEHAE,0,0,0,1,1,6
TEHAEK,0,0,0,1,1,6
EHAEKL,0,0,0,1,1,6
HAEKLM,0,0,0,1,1,6
AEKLMR,0,0,0,1,1,6
EKLMRL,0,0,0,1,1,6
KLMRLQ,0,0,0,1,1,6
LMRLQN,0,0,0,1,1,6
MRLQNQ,0,0,0,1,1,6
RLQNQR,0,0,0,1,1,6
LQNQRG,0,0,0,1,1,6
LPEDQE,0,0,0,1,1,6
PEDQEL,0,0,0,1,1,6
EDQELL,0,0,0,1,1,6
DQELLF,0,0,0,1,1,6
QELLFQ,0,0,0,1,1,6
ELLFQS,0,0,0,1,1,6
LLFQSA,0,0,0,1,1,6
LFQSAS,0,0,0,1,1,6
FQSASL,0,0,0,1,1,6
QSASLE,0,0,0,1,1,6
SASLEL,0,0,0,1,1,6
ASLELF,0,0,0,1,1,6
SLELFV,0,0,0,1,1,6
LELFVL,0,0,0,1,1,6
ELFVLR,0,0,0,1,1,6
LFVLRL,0,0,0,1,1,6
FVLRLA,0,0,0,1,1,6
VLRLAY,0,0,0,1,1,6
LRLAYR,0,0,0,1,1,6
RLAYRA,0,0,0,1,1,6
LPHFYE,0,0,0,1,1,6
PHFYEL,0,0,0,1,1,6
HFYELF,0,0,0,1,1,6
FYELFS,0,0,0,1,1,6
YELFSL,0,0,0,1,1,6
ELFSLW,0,0,0,1,1,6
LFSLWA,0,0,0,1,1,6
LPIHYK,0,0,0,1,1,6
PIHYKL,0,0,0,1,1,6
IHYKLS,0,0,0,1,1,6
HYKLSQ,0,0,0,1,1,6
YKLSQE,0,0,0,1,1,6
KLSQEF,0,0,0,1,1,6
LSQEFF,0,0,0,1,1,6
SQEFFL,0,0,0,1,1,6
QEFFLK,0,0,0,1,1,6
EFFLKA,0,0,0,1,1,6
FFLKAY,0,0,0,1,1,6
FLKAYE,0,0,0,1,1,6
LKAYEN,0,0,0,1,1,6
LQAPLQ,0,0,0,1,1,6
QAPLQR,0,0,0,1,1,6
APLQRR,0,0,0,1,1,6
PLQRRI,0,0,0,1,1,6
LQRRIL,0,0,0,1,1,6
QRRILE,0,0,0,1,1,6
RRILEI,0,0,0,1,1,6
RILEIG,0,0,0,1,1,6
ILEIGK,0,0,0,1,1,6
LEIGKK,0,0,0,1,1,6
EIGKKH,0,0,0,1,1,6
LQMEFK,0,0,0,1,1,6
QMEFKY,0,0,0,1,1,6
MEFKYL,0,0,0,1,1,6
EFKYLA,0,0,0,1,1,6
FKYLAY,0,0,0,1,1,6
KYLAYL,0,0,0,1,1,6
YLAYLT,0,0,0,1,1,6
LAYLTG,0,0,0,1,1,6
LQNAII,0,0,0,1,1,6
QNAIIE,0,0,0,1,1,6
NAIIEF,0,0,0,1,1,6
AIIEFY,0,0,0,1,1,6
IIEFYT,0,0,0,1,1,6
IEFYTE,0,0,0,1,1,6
EFYTEY,0,0,0,1,1,6
FYTEYY,0,0,0,1,1,6
LQWYVS,0,0,0,1,1,6
QWYVSE,0,0,0,1,1,6
WYVSEQ,0,0,0,1,1,6
YVSEQH,0,0,0,1,1,6
VSEQHE,0,0,0,1,1,6
SEQHEE,0,0,0,1,1,6
EQHEEE,0,0,0,1,1,6
QHEEEA,0,0,0,1,1,6
HEEEAL,0,0,0,1,1,6
EEEALF,0,0,0,1,1,6
EEALFR,0,0,0,1,1,6
EALFRG,0,0,0,1,1,6
ALFRGI,0,0,0,1,1,6
LFRGIV,0,0,0,1,1,6
FRGIVD,0,0,0,1,1,6
RGIVDK,0,0,0,1,1,6
GIVDKI,0,0,0,1,1,6
IVDKIK,0,0,0,1,1,6
VDKIKL,0,0,0,1,1,6
DKIKLI,0,0,0,1,1,6
KIKLIG,0,0,0,1,1,6
LREIVE,0,0,0,1,1,6
REIVEN,0,0,0,1,1,6
EIVENM,0,0,0,1,1,6
IVENMI,0,0,0,1,1,6
VENMIK,0,0,0,1,1,6
ENMIKS,0,0,0,1,1,6
NMIKSS,0,0,0,1,1,6
MIKSSL,0,0,0,1,1,6
IKSSLE,0,0,0,1,1,6
KSSLER,0,0,0,1,1,6
SSLERA,0,0,0,1,1,6
SLERAI,0,0,0,1,1,6
LERAIA,0,0,0,1,1,6
ERAIAA,0,0,0,1,1,6
RAIAAY,0,0,0,1,1,6
LRSWFR,0,0,0,1,1,6
RSWFRE,0,0,0,1,1,6
SWFRER,0,0,0,1,1,6
WFRERL,0,0,0,1,1,6
FRERLI,0,0,0,1,1,6
RERLIA,0,0,0,1,1,6
ERLIAH,0,0,0,1,1,6
RLIAHR,0,0,0,1,1,6
LIAHRL,0,0,0,1,1,6
IAHRLA,0,0,0,1,1,6
AHRLAS,0,0,0,1,1,6
HRLASV,0,0,0,1,1,6
RLASVN,0,0,0,1,1,6
LASVNL,0,0,0,1,1,6
LRTYFM,0,0,0,1,1,6
RTYFME,0,0,0,1,1,6
TYFMER,0,0,0,1,1,6
YFMERL,0,0,0,1,1,6
FMERLR,0,0,0,1,1,6
MERLRH,0,0,0,1,1,6
ERLRHY,0,0,0,1,1,6
RLRHYR,0,0,0,1,1,6
LRHYRQ,0,0,0,1,1,6
RHYRQL,0,0,0,1,1,6
HYRQLS,0,0,0,1,1,6
YRQLSL,0,0,0,1,1,6
LSTVSN,0,0,0,1,1,6
STVSNF,0,0,0,1,1,6
TVSNFF,0,0,0,1,1,6
VSNFFM,0,0,0,1,1,6
SNFFMN,0,0,0,1,1,6
NFFMNA,0,0,0,1,1,6
LVGALM,0,0,0,1,1,6
VGALMH,0,0,0,1,1,6
GALMHV,0,0,0,1,1,6
ALMHVM,0,0,0,1,1,6
LMHVMQ,0,0,0,1,1,6
MHVMQK,0,0,0,1,1,6
HVMQKR,0,0,0,1,1,6
VMQKRS,0,0,0,1,1,6
MQKRSR,0,0,0,1,1,6
LVLPIA,0,0,0,1,1,6
VLPIAQ,0,0,0,1,1,6
LPIAQA,0,0,0,1,1,6
PIAQAL,0,0,0,1,1,6
IAQALK,0,0,0,1,1,6
AQALKV,0,0,0,1,1,6
QALKVL,0,0,0,1,1,6
ALKVLG,0,0,0,1,1,6
MEALKK,0,0,0,1,1,6
EALKKQ,0,0,0,1,1,6
ALKKQI,0,0,0,1,1,6
LKKQIL,0,0,0,1,1,6
KKQILQ,0,0,0,1,1,6
KQILQI,0,0,0,1,1,6
MEKLNQ,0,0,0,1,1,6
EKLNQL,0,0,0,1,1,6
KLNQLW,0,0,0,1,1,6
LNQLWE,0,0,0,1,1,6
NQLWEK,0,0,0,1,1,6
QLWEKA,0,0,0,1,1,6
LWEKAQ,0,0,0,1,1,6
WEKAQR,0,0,0,1,1,6
EKAQRL,0,0,0,1,1,6
KAQRLH,0,0,0,1,1,6
MLEEYR,0,0,0,1,1,6
LEEYRK,0,0,0,1,1,6
EEYRKH,0,0,0,1,1,6
EYRKHV,0,0,0,1,1,6
YRKHVA,0,0,0,1,1,6
RKHVAE,0,0,0,1,1,6
KHVAER,0,0,0,1,1,6
HVAERA,0,0,0,1,1,6
VAERAA,0,0,0,1,1,6
AERAAE,0,0,0,1,1,6
MPEVFN,0,0,0,1,1,6
PEVFNY,0,0,0,1,1,6
EVFNYL,0,0,0,1,1,6
VFNYLG,0,0,0,1,1,6
FNYLGI,0,0,0,1,1,6
NYLGIY,0,0,0,1,1,6
YLGIYL,0,0,0,1,1,6
LGIYLT,0,0,0,1,1,6
GIYLTQ,0,0,0,1,1,6
IYLTQA,0,0,0,1,1,6
MPGTAT,0,0,0,1,1,6
PGTATH,0,0,0,1,1,6
GTATHT,0,0,0,1,1,6
TATHTV,0,0,0,1,1,6
ATHTVK,0,0,0,1,1,6
THTVKM,0,0,0,1,1,6
HTVKMF,0,0,0,1,1,6
TVKMFS,0,0,0,1,1,6
MPYTDA,0,0,0,1,1,6
PYTDAV,0,0,0,1,1,6
YTDAVV,0,0,0,1,1,6
TDAVVH,0,0,0,1,1,6
DAVVHE,0,0,0,1,1,6
AVVHEV,0,0,0,1,1,6
VVHEVQ,0,0,0,1,1,6
VHEVQR,0,0,0,1,1,6
HEVQRY,0,0,0,1,1,6
EVQRYI,0,0,0,1,1,6
VQRYID,0,0,0,1,1,6
MTDQQA,0,0,0,1,1,6
TDQQAE,0,0,0,1,1,6
DQQAEA,0,0,0,1,1,6
QQAEAR,0,0,0,1,1,6
QAEARA,0,0,0,1,1,6
AEARAF,0,0,0,1,1,6
MVFKQM,0,0,0,1,1,6
VFKQME,0,0,0,1,1,6
FKQMEQ,0,0,0,1,1,6
KQMEQV,0,0,0,1,1,6
QMEQVA,0,0,0,1,1,6
MEQVAQ,0,0,0,1,1,6
EQVAQF,0,0,0,1,1,6
QVAQFL,0,0,0,1,1,6
VAQFLK,0,0,0,1,1,6
AQFLKA,0,0,0,1,1,6
QFLKAA,0,0,0,1,1,6
FLKAAE,0,0,0,1,1,6
LKAAED,0,0,0,1,1,6
KAAEDY,0,0,0,1,1,6
MYSNRM,0,0,0,1,1,6
YSNRMR,0,0,0,1,1,6
SNRMRS,0,0,0,1,1,6
NRMRSY,0,0,0,1,1,6
RMRSYK,0,0,0,1,1,6
MRSYKQ,0,0,0,1,1,6
RSYKQE,0,0,0,1,1,6
SYKQEM,0,0,0,1,1,6
YKQEMG,0,0,0,1,1,6
KQEMGK,0,0,0,1,1,6
QEMGKL,0,0,0,1,1,6
EMGKLE,0,0,0,1,1,6
MGKLET,0,0,0,1,1,6
GKLETD,0,0,0,1,1,6
KLETDF,0,0,0,1,1,6
LETDFK,0,0,0,1,1,6
ETDFKR,0,0,0,1,1,6
TDFKRS,0,0,0,1,1,6
DFKRSR,0,0,0,1,1,6
FKRSRI,0,0,0,1,1,6
NAAGWD,0,0,0,1,1,6
AAGWDL,0,0,0,1,1,6
AGWDLL,0,0,0,1,1,6
GWDLLL,0,0,0,1,1,6
WDLLLT,0,0,0,1,1,6
DLLLTL,0,0,0,1,1,6
LLLTLY,0,0,0,1,1,6
LLTLYR,0,0,0,1,1,6
LTLYRS,0,0,0,1,1,6
TLYRSA,0,0,0,1,1,6
NAAQLD,0,0,0,1,1,6
AAQLDA,0,0,0,1,1,6
AQLDAL,0,0,0,1,1,6
QLDALA,0,0,0,1,1,6
LDALAH,0,0,0,1,1,6
DALAHA,0,0,0,1,1,6
ALAHAL,0,0,0,1,1,6
LAHALL,0,0,0,1,1,6
AHALLE,0,0,0,1,1,6
HALLEI,0,0,0,1,1,6
ALLEIP,0,0,0,1,1,6
LLEIPR,0,0,0,1,1,6
LEIPRF,0,0,0,1,1,6
EIPRFS,0,0,0,1,1,6
IPRFSY,0,0,0,1,1,6
PRFSYA,0,0,0,1,1,6
RFSYAT,0,0,0,1,1,6
FSYATR,0,0,0,1,1,6
NAGQAN,0,0,0,1,1,6
AGQANE,0,0,0,1,1,6
GQANEF,0,0,0,1,1,6
QANEFF,0,0,0,1,1,6
ANEFFN,0,0,0,1,1,6
NEFFNE,0,0,0,1,1,6
EFFNEF,0,0,0,1,1,6
FFNEFW,0,0,0,1,1,6
FNEFWS,0,0,0,1,1,6
NAKIAR,0,0,0,1,1,6
AKIARI,0,0,0,1,1,6
KIARIN,0,0,0,1,1,6
IARINE,0,0,0,1,1,6
ARINEL,0,0,0,1,1,6
RINELA,0,0,0,1,1,6
INELAA,0,0,0,1,1,6
NELAAK,0,0,0,1,1,6
ELAAKA,0,0,0,1,1,6
LAAKAK,0,0,0,1,1,6
AAKAKA,0,0,0,1,1,6
AKAKAG,0,0,0,1,1,6
KAKAGV,0,0,0,1,1,6
NAKYVA,0,0,0,1,1,6
AKYVAE,0,0,0,1,1,6
KYVAEA,0,0,0,1,1,6
YVAEAT,0,0,0,1,1,6
VAEATG,0,0,0,1,1,6
AEATGN,0,0,0,1,1,6
EATGNF,0,0,0,1,1,6
ATGNFI,0,0,0,1,1,6
TGNFIT,0,0,0,1,1,6
GNFITV,0,0,0,1,1,6
NFITVM,0,0,0,1,1,6
FITVMD,0,0,0,1,1,6
ITVMDA,0,0,0,1,1,6
TVMDAL,0,0,0,1,1,6
VMDALK,0,0,0,1,1,6
MDALKL,0,0,0,1,1,6
NASRTV,0,0,0,1,1,6
ASRTVG,0,0,0,1,1,6
SRTVGV,0,0,0,1,1,6
RTVGVV,0,0,0,1,1,6
TVGVVA,0,0,0,1,1,6
VGVVAA,0,0,0,1,1,6
GVVAAL,0,0,0,1,1,6
VVAALL,0,0,0,1,1,6
NDAEVK,0,0,0,1,1,6
DAEVKK,0,0,0,1,1,6
AEVKKI,0,0,0,1,1,6
EVKKIA,0,0,0,1,1,6
VKKIAA,0,0,0,1,1,6
KKIAAQ,0,0,0,1,1,6
KIAAQY,0,0,0,1,1,6
IAAQYG,0,0,0,1,1,6
AAQYGK,0,0,0,1,1,6
AQYGKD,0,0,0,1,1,6
NDEETV,0,0,0,1,1,6
DEETVA,0,0,0,1,1,6
EETVAL,0,0,0,1,1,6
ETVALT,0,0,0,1,1,6
TVALTA,0,0,0,1,1,6
VALTAG,0,0,0,1,1,6
ALTAGG,0,0,0,1,1,6
LTAGGH,0,0,0,1,1,6
TAGGHT,0,0,0,1,1,6
NEEVRI,0,0,0,1,1,6
EEVRIE,0,0,0,1,1,6
EVRIEA,0,0,0,1,1,6
VRIEAI,0,0,0,1,1,6
RIEAII,0,0,0,1,1,6
IEAIIG,0,0,0,1,1,6
EAIIGL,0,0,0,1,1,6
AIIGLS,0,0,0,1,1,6
IIGLSY,0,0,0,1,1,6
IGLSYR,0,0,0,1,1,6
NEQDLG,0,0,0,1,1,6
EQDLGI,0,0,0,1,1,6
QDLGIQ,0,0,0,1,1,6
DLGIQY,0,0,0,1,1,6
LGIQYK,0,0,0,1,1,6
GIQYKA,0,0,0,1,1,6
IQYKAL,0,0,0,1,1,6
QYKALK,0,0,0,1,1,6
YKALKP,0,0,0,1,1,6
KALKPE,0,0,0,1,1,6
ALKPEV,0,0,0,1,1,6
LKPEVD,0,0,0,1,1,6
KPEVDK,0,0,0,1,1,6
PEVDKL,0,0,0,1,1,6
EVDKLN,0,0,0,1,1,6
VDKLNI,0,0,0,1,1,6
DKLNIM,0,0,0,1,1,6
KLNIMA,0,0,0,1,1,6
LNIMAA,0,0,0,1,1,6
NIMAAK,0,0,0,1,1,6
IMAAKR,0,0,0,1,1,6
MAAKRQ,0,0,0,1,1,6
AAKRQQ,0,0,0,1,1,6
AKRQQE,0,0,0,1,1,6
KRQQEL,0,0,0,1,1,6
NEYIMS,0,0,0,1,1,6
EYIMSL,0,0,0,1,1,6
YIMSLI,0,0,0,1,1,6
IMSLIS,0,0,0,1,1,6
MSLISD,0,0,0,1,1,6
SLISDN,0,0,0,1,1,6
NFKDVI,0,0,0,1,1,6
FKDVIE,0,0,0,1,1,6
KDVIET,0,0,0,1,1,6
DVIETA,0,0,0,1,1,6
VIETAK,0,0,0,1,1,6
IETAKK,0,0,0,1,1,6
ETAKKV,0,0,0,1,1,6
TAKKVM,0,0,0,1,1,6
AKKVMN,0,0,0,1,1,6
KKVMNF,0,0,0,1,1,6
NGETFL,0,0,0,1,1,6
GETFLT,0,0,0,1,1,6
ETFLTE,0,0,0,1,1,6
TFLTEL,0,0,0,1,1,6
FLTELL,0,0,0,1,1,6
LTELLD,0,0,0,1,1,6
NGLEVV,0,0,0,1,1,6
GLEVVK,0,0,0,1,1,6
LEVVKA,0,0,0,1,1,6
EVVKAL,0,0,0,1,1,6
VVKALA,0,0,0,1,1,6
VKALAQ,0,0,0,1,1,6
KALAQG,0,0,0,1,1,6
NIDEIE,0,0,0,1,1,6
IDEIER,0,0,0,1,1,6
DEIERK,0,0,0,1,1,6
EIERKI,0,0,0,1,1,6
IERKID,0,0,0,1,1,6
ERKIDE,0,0,0,1,1,6
RKIDEA,0,0,0,1,1,6
KIDEAI,0,0,0,1,1,6
IDEAIE,0,0,0,1,1,6
DEAIEK,0,0,0,1,1,6
EAIEKE,0,0,0,1,1,6
NIDSYL,0,0,0,1,1,6
IDSYLN,0,0,0,1,1,6
DSYLNA,0,0,0,1,1,6
SYLNAV,0,0,0,1,1,6
YLNAVN,0,0,0,1,1,6
LNAVNI,0,0,0,1,1,6
NAVNII,0,0,0,1,1,6
AVNIIN,0,0,0,1,1,6
VNIINI,0,0,0,1,1,6
NIINIF,0,0,0,1,1,6
IINIFK,0,0,0,1,1,6
INIFKI,0,0,0,1,1,6
NIFKII,0,0,0,1,1,6
IFKIIG,0,0,0,1,1,6
NIEQLW,0,0,0,1,1,6
IEQLWR,0,0,0,1,1,6
EQLWRD,0,0,0,1,1,6
QLWRDY,0,0,0,1,1,6
LWRDYN,0,0,0,1,1,6
WRDYNK,0,0,0,1,1,6
RDYNKY,0,0,0,1,1,6
DYNKYE,0,0,0,1,1,6
YNKYEE,0,0,0,1,1,6
NKYEEG,0,0,0,1,1,6
KYEEGI,0,0,0,1,1,6
YEEGIN,0,0,0,1,1,6
NILKQI,0,0,0,1,1,6
ILKQIF,0,0,0,1,1,6
LKQIFK,0,0,0,1,1,6
KQIFKL,0,0,0,1,1,6
QIFKLL,0,0,0,1,1,6
IFKLLQ,0,0,0,1,1,6
FKLLQA,0,0,0,1,1,6
NINELF,0,0,0,1,1,6
INELFI,0,0,0,1,1,6
NELFIE,0,0,0,1,1,6
ELFIEI,0,0,0,1,1,6
LFIEIS,0,0,0,1,1,6
FIEISR,0,0,0,1,1,6
IEISRR,0,0,0,1,1,6
EISRRI,0,0,0,1,1,6
NIPKHT,0,0,0,1,1,6
IPKHTH,0,0,0,1,1,6
PKHTHR,0,0,0,1,1,6
KHTHRF,0,0,0,1,1,6
HTHRFF,0,0,0,1,1,6
THRFFI,0,0,0,1,1,6
HRFFIL,0,0,0,1,1,6
RFFILV,0,0,0,1,1,6
FFILVL,0,0,0,1,1,6
FILVLE,0,0,0,1,1,6
ILVLEI,0,0,0,1,1,6
NKDQWE,0,0,0,1,1,6
KDQWEE,0,0,0,1,1,6
DQWEER,0,0,0,1,1,6
QWEERI,0,0,0,1,1,6
WEERIQ,0,0,0,1,1,6
EERIQV,0,0,0,1,1,6
ERIQVW,0,0,0,1,1,6
RIQVWH,0,0,0,1,1,6
IQVWHE,0,0,0,1,1,6
QVWHEE,0,0,0,1,1,6
VWHEEH,0,0,0,1,1,6
NKEEMM,0,0,0,1,1,6
KEEMMD,0,0,0,1,1,6
EEMMDI,0,0,0,1,1,6
EMMDIV,0,0,0,1,1,6
MMDIVK,0,0,0,1,1,6
MDIVKA,0,0,0,1,1,6
DIVKAI,0,0,0,1,1,6
IVKAIY,0,0,0,1,1,6
VKAIYD,0,0,0,1,1,6
KAIYDM,0,0,0,1,1,6
AIYDMM,0,0,0,1,1,6
IYDMMG,0,0,0,1,1,6
NKLVDR,0,0,0,1,1,6
KLVDRW,0,0,0,1,1,6
LVDRWL,0,0,0,1,1,6
VDRWLH,0,0,0,1,1,6
DRWLHV,0,0,0,1,1,6
RWLHVR,0,0,0,1,1,6
WLHVRK,0,0,0,1,1,6
LHVRKH,0,0,0,1,1,6
HVRKHL,0,0,0,1,1,6
VRKHLL,0,0,0,1,1,6
RKHLLV,0,0,0,1,1,6
KHLLVA,0,0,0,1,1,6
HLLVAY,0,0,0,1,1,6
LLVAYY,0,0,0,1,1,6
LVAYYN,0,0,0,1,1,6
VAYYNL,0,0,0,1,1,6
AYYNLV,0,0,0,1,1,6
YYNLVG,0,0,0,1,1,6
NKQADS,0,0,0,1,1,6
KQADSI,0,0,0,1,1,6
QADSIK,0,0,0,1,1,6
ADSIKQ,0,0,0,1,1,6
DSIKQM,0,0,0,1,1,6
SIKQME,0,0,0,1,1,6
IKQMEE,0,0,0,1,1,6
KQMEER,0,0,0,1,1,6
QMEERN,0,0,0,1,1,6
MEERNK,0,0,0,1,1,6
EERNKK,0,0,0,1,1,6
ERNKKR,0,0,0,1,1,6
RNKKRV,0,0,0,1,1,6
NKKRVE,0,0,0,1,1,6
KKRVEN,0,0,0,1,1,6
KRVENF,0,0,0,1,1,6
RVENFK,0,0,0,1,1,6
VENFKK,0,0,0,1,1,6
ENFKKT,0,0,0,1,1,6
NFKKTG,0,0,0,1,1,6
NKRAVD,0,0,0,1,1,6
KRAVDW,0,0,0,1,1,6
RAVDWA,0,0,0,1,1,6
AVDWAM,0,0,0,1,1,6
VDWAMR,0,0,0,1,1,6
DWAMRA,0,0,0,1,1,6
WAMRAA,0,0,0,1,1,6
AMRAAM,0,0,0,1,1,6
MRAAMA,0,0,0,1,1,6
RAAMAL,0,0,0,1,1,6
NKSVGA,0,0,0,1,1,6
KSVGAV,0,0,0,1,1,6
SVGAVY,0,0,0,1,1,6
VGAVYA,0,0,0,1,1,6
GAVYAI,0,0,0,1,1,6
AVYAIL,0,0,0,1,1,6
VYAILY,0,0,0,1,1,6
YAILYL,0,0,0,1,1,6
AILYLS,0,0,0,1,1,6
NLDSIQ,0,0,0,1,1,6
LDSIQE,0,0,0,1,1,6
DSIQEE,0,0,0,1,1,6
SIQEEL,0,0,0,1,1,6
IQEELA,0,0,0,1,1,6
QEELAD,0,0,0,1,1,6
EELADV,0,0,0,1,1,6
ELADVI,0,0,0,1,1,6
LADVIA,0,0,0,1,1,6
ADVIAW,0,0,0,1,1,6
DVIAWT,0,0,0,1,1,6
VIAWTV,0,0,0,1,1,6
IAWTVS,0,0,0,1,1,6
AWTVSI,0,0,0,1,1,6
WTVSIA,0,0,0,1,1,6
TVSIAN,0,0,0,1,1,6
VSIANL,0,0,0,1,1,6
SIANLE,0,0,0,1,1,6
IANLEG,0,0,0,1,1,6
NLEQTA,0,0,0,1,1,6
LEQTAR,0,0,0,1,1,6
EQTARR,0,0,0,1,1,6
QTARRW,0,0,0,1,1,6
TARRWL,0,0,0,1,1,6
ARRWLE,0,0,0,1,1,6
RRWLEE,0,0,0,1,1,6
RWLEER,0,0,0,1,1,6
WLEERG,0,0,0,1,1,6
NLESEI,0,0,0,1,1,6
LESEIH,0,0,0,1,1,6
ESEIHT,0,0,0,1,1,6
SEIHTV,0,0,0,1,1,6
EIHTVL,0,0,0,1,1,6
IHTVLK,0,0,0,1,1,6
HTVLKH,0,0,0,1,1,6
TVLKHL,0,0,0,1,1,6
VLKHLV,0,0,0,1,1,6
LKHLVE,0,0,0,1,1,6
KHLVEN,0,0,0,1,1,6
HLVENN,0,0,0,1,1,6
NLFDHF,0,0,0,1,1,6
LFDHFS,0,0,0,1,1,6
FDHFSA,0,0,0,1,1,6
DHFSAV,0,0,0,1,1,6
HFSAVA,0,0,0,1,1,6
FSAVAQ,0,0,0,1,1,6
SAVAQR,0,0,0,1,1,6
AVAQRL,0,0,0,1,1,6
NLFPIV,0,0,0,1,1,6
LFPIVF,0,0,0,1,1,6
FPIVFG,0,0,0,1,1,6
PIVFGV,0,0,0,1,1,6
IVFGVI,0,0,0,1,1,6
VFGVIF,0,0,0,1,1,6
FGVIFD,0,0,0,1,1,6
GVIFDA,0,0,0,1,1,6
NLLYDI,0,0,0,1,1,6
LLYDIV,0,0,0,1,1,6
LYDIVK,0,0,0,1,1,6
YDIVKE,0,0,0,1,1,6
DIVKEN,0,0,0,1,1,6
IVKENG,0,0,0,1,1,6
NLNQSI,0,0,0,1,1,6
LNQSID,0,0,0,1,1,6
NQSIDN,0,0,0,1,1,6
QSIDNF,0,0,0,1,1,6
SIDNFV,0,0,0,1,1,6
IDNFVN,0,0,0,1,1,6
DNFVNM,0,0,0,1,1,6
NFVNMA,0,0,0,1,1,6
FVNMAF,0,0,0,1,1,6
VNMAFF,0,0,0,1,1,6
NMAFFA,0,0,0,1,1,6
NLSTLA,0,0,0,1,1,6
LSTLAA,0,0,0,1,1,6
STLAAL,0,0,0,1,1,6
TLAALV,0,0,0,1,1,6
LAALVA,0,0,0,1,1,6
AALVAA,0,0,0,1,1,6
ALVAAA,0,0,0,1,1,6
LVAAAG,0,0,0,1,1,6
NLTQLK,0,0,0,1,1,6
LTQLKA,0,0,0,1,1,6
TQLKAS,0,0,0,1,1,6
QLKASF,0,0,0,1,1,6
LKASFA,0,0,0,1,1,6
KASFAV,0,0,0,1,1,6
ASFAVQ,0,0,0,1,1,6
NLVADM,0,0,0,1,1,6
LVADMR,0,0,0,1,1,6
VADMRF,0,0,0,1,1,6
ADMRFN,0,0,0,1,1,6
DMRFNV,0,0,0,1,1,6
MRFNVV,0,0,0,1,1,6
RFNVVR,0,0,0,1,1,6
FNVVRE,0,0,0,1,1,6
NVVRES,0,0,0,1,1,6
VVRESE,0,0,0,1,1,6
VRESEA,0,0,0,1,1,6
RESEAR,0,0,0,1,1,6
ESEARL,0,0,0,1,1,6
SEARLQ,0,0,0,1,1,6
EARLQV,0,0,0,1,1,6
ARLQVS,0,0,0,1,1,6
RLQVSR,0,0,0,1,1,6
LQVSRL,0,0,0,1,1,6
QVSRLY,0,0,0,1,1,6
VSRLYS,0,0,0,1,1,6
NNAITK,0,0,0,1,1,6
NAITKG,0,0,0,1,1,6
AITKGF,0,0,0,1,1,6
ITKGFT,0,0,0,1,1,6
TKGFTA,0,0,0,1,1,6
KGFTAL,0,0,0,1,1,6
GFTALE,0,0,0,1,1,6
FTALEK,0,0,0,1,1,6
TALEKL,0,0,0,1,1,6
ALEKLL,0,0,0,1,1,6
LEKLLV,0,0,0,1,1,6
NPAAEK,0,0,0,1,1,6
PAAEKM,0,0,0,1,1,6
AAEKMQ,0,0,0,1,1,6
AEKMQV,0,0,0,1,1,6
EKMQVL,0,0,0,1,1,6
KMQVLQ,0,0,0,1,1,6
MQVLQV,0,0,0,1,1,6
QVLQVL,0,0,0,1,1,6
VLQVLD,0,0,0,1,1,6
LQVLDR,0,0,0,1,1,6
QVLDRL,0,0,0,1,1,6
VLDRLR,0,0,0,1,1,6
LDRLRG,0,0,0,1,1,6
DRLRGK,0,0,0,1,1,6
RLRGKL,0,0,0,1,1,6
LRGKLQ,0,0,0,1,1,6
RGKLQE,0,0,0,1,1,6
GKLQEK,0,0,0,1,1,6
KLQEKG,0,0,0,1,1,6
NPAQYL,0,0,0,1,1,6
PAQYLA,0,0,0,1,1,6
AQYLAQ,0,0,0,1,1,6
QYLAQH,0,0,0,1,1,6
YLAQHE,0,0,0,1,1,6
LAQHEQ,0,0,0,1,1,6
AQHEQL,0,0,0,1,1,6
QHEQLL,0,0,0,1,1,6
NPARAL,0,0,0,1,1,6
PARALY,0,0,0,1,1,6
ARALYQ,0,0,0,1,1,6
RALYQT,0,0,0,1,1,6
ALYQTV,0,0,0,1,1,6
LYQTVR,0,0,0,1,1,6
YQTVRE,0,0,0,1,1,6
QTVREL,0,0,0,1,1,6
TVRELI,0,0,0,1,1,6
VRELIE,0,0,0,1,1,6
RELIEN,0,0,0,1,1,6
ELIENS,0,0,0,1,1,6
LIENSL,0,0,0,1,1,6
IENSLD,0,0,0,1,1,6
ENSLDA,0,0,0,1,1,6
NPEILL,0,0,0,1,1,6
PEILLA,0,0,0,1,1,6
EILLAR,0,0,0,1,1,6
ILLARV,0,0,0,1,1,6
LLARVK,0,0,0,1,1,6
LARVKR,0,0,0,1,1,6
ARVKRF,0,0,0,1,1,6
RVKRFL,0,0,0,1,1,6
VKRFLE,0,0,0,1,1,6
KRFLER,0,0,0,1,1,6
RFLERE,0,0,0,1,1,6
NPERVL,0,0,0,1,1,6
PERVLL,0,0,0,1,1,6
ERVLLQ,0,0,0,1,1,6
RVLLQL,0,0,0,1,1,6
VLLQLK,0,0,0,1,1,6
LLQLKY,0,0,0,1,1,6
LQLKYR,0,0,0,1,1,6
QLKYRY,0,0,0,1,1,6
LKYRYD,0,0,0,1,1,6
KYRYDV,0,0,0,1,1,6
YRYDVE,0,0,0,1,1,6
RYDVEI,0,0,0,1,1,6
NPGQAI,0,0,0,1,1,6
PGQAIW,0,0,0,1,1,6
GQAIWL,0,0,0,1,1,6
QAIWLG,0,0,0,1,1,6
AIWLGE,0,0,0,1,1,6
IWLGEF,0,0,0,1,1,6
WLGEFS,0,0,0,1,1,6
LGEFSK,0,0,0,1,1,6
GEFSKR,0,0,0,1,1,6
EFSKRH,0,0,0,1,1,6
NPMIIE,0,0,0,1,1,6
PMIIEG,0,0,0,1,1,6
MIIEGQ,0,0,0,1,1,6
IIEGQI,0,0,0,1,1,6
IEGQIH,0,0,0,1,1,6
EGQIHG,0,0,0,1,1,6
GQIHGG,0,0,0,1,1,6
QIHGGL,0,0,0,1,1,6
IHGGLT,0,0,0,1,1,6
HGGLTE,0,0,0,1,1,6
GGLTEG,0,0,0,1,1,6
GLTEGY,0,0,0,1,1,6
LTEGYA,0,0,0,1,1,6
TEGYAV,0,0,0,1,1,6
EGYAVA,0,0,0,1,1,6
GYAVAM,0,0,0,1,1,6
YAVAMG,0,0,0,1,1,6
NPQVLA,0,0,0,1,1,6
PQVLAD,0,0,0,1,1,6
QVLADI,0,0,0,1,1,6
VLADIG,0,0,0,1,1,6
LADIGA,0,0,0,1,1,6
ADIGAE,0,0,0,1,1,6
DIGAEA,0,0,0,1,1,6
IGAEAT,0,0,0,1,1,6
NPRWIG,0,0,0,1,1,6
PRWIGR,0,0,0,1,1,6
RWIGRH,0,0,0,1,1,6
WIGRHK,0,0,0,1,1,6
IGRHKH,0,0,0,1,1,6
GRHKHM,0,0,0,1,1,6
RHKHMF,0,0,0,1,1,6
HKHMFN,0,0,0,1,1,6
KHMFNF,0,0,0,1,1,6
HMFNFL,0,0,0,1,1,6
MFNFLD,0,0,0,1,1,6
NPVLQQ,0,0,0,1,1,6
PVLQQH,0,0,0,1,1,6
VLQQHF,0,0,0,1,1,6
LQQHFR,0,0,0,1,1,6
QQHFRN,0,0,0,1,1,6
QHFRNL,0,0,0,1,1,6
HFRNLE,0,0,0,1,1,6
FRNLEA,0,0,0,1,1,6
RNLEAL,0,0,0,1,1,6
NLEALA,0,0,0,1,1,6
LEALAL,0,0,0,1,1,6
NQDELE,0,0,0,1,1,6
QDELEG,0,0,0,1,1,6
DELEGY,0,0,0,1,1,6
ELEGYN,0,0,0,1,1,6
LEGYNL,0,0,0,1,1,6
EGYNLF,0,0,0,1,1,6
GYNLFK,0,0,0,1,1,6
YNLFKG,0,0,0,1,1,6
NLFKGS,0,0,0,1,1,6
LFKGSG,0,0,0,1,1,6
NQPFAL,0,0,0,1,1,6
QPFALE,0,0,0,1,1,6
PFALEM,0,0,0,1,1,6
FALEMI,0,0,0,1,1,6
ALEMIK,0,0,0,1,1,6
LEMIKS,0,0,0,1,1,6
EMIKSR,0,0,0,1,1,6
MIKSRQ,0,0,0,1,1,6
IKSRQK,0,0,0,1,1,6
KSRQKK,0,0,0,1,1,6
SRQKKD,0,0,0,1,1,6
NQRALL,0,0,0,1,1,6
QRALLK,0,0,0,1,1,6
RALLKS,0,0,0,1,1,6
ALLKSL,0,0,0,1,1,6
LLKSLQ,0,0,0,1,1,6
LKSLQD,0,0,0,1,1,6
KSLQDY,0,0,0,1,1,6
SLQDYR,0,0,0,1,1,6
LQDYRQ,0,0,0,1,1,6
QDYRQH,0,0,0,1,1,6
DYRQHL,0,0,0,1,1,6
YRQHLD,0,0,0,1,1,6
RQHLDQ,0,0,0,1,1,6
QHLDQL,0,0,0,1,1,6
HLDQLI,0,0,0,1,1,6
LDQLIT,0,0,0,1,1,6
DQLITL,0,0,0,1,1,6
QLITLI,0,0,0,1,1,6
LITLIS,0,0,0,1,1,6
ITLISN,0,0,0,1,1,6
NREANL,0,0,0,1,1,6
REANLQ,0,0,0,1,1,6
EANLQA,0,0,0,1,1,6
ANLQAL,0,0,0,1,1,6
NLQALI,0,0,0,1,1,6
LQALIA,0,0,0,1,1,6
QALIAT,0,0,0,1,1,6
ALIATG,0,0,0,1,1,6
NRKMAM,0,0,0,1,1,6
RKMAMG,0,0,0,1,1,6
KMAMGR,0,0,0,1,1,6
MAMGRK,0,0,0,1,1,6
AMGRKK,0,0,0,1,1,6
MGRKKF,0,0,0,1,1,6
GRKKFN,0,0,0,1,1,6
RKKFNM,0,0,0,1,1,6
KKFNMD,0,0,0,1,1,6
NSDQDA,0,0,0,1,1,6
SDQDAG,0,0,0,1,1,6
DQDAGI,0,0,0,1,1,6
QDAGIA,0,0,0,1,1,6
DAGIAI,0,0,0,1,1,6
AGIAII,0,0,0,1,1,6
GIAIIR,0,0,0,1,1,6
IAIIRR,0,0,0,1,1,6
AIIRRA,0,0,0,1,1,6
IIRRAL,0,0,0,1,1,6
NSNHQM,0,0,0,1,1,6
SNHQML,0,0,0,1,1,6
NHQMLL,0,0,0,1,1,6
HQMLLV,0,0,0,1,1,6
QMLLVQ,0,0,0,1,1,6
MLLVQQ,0,0,0,1,1,6
LLVQQA,0,0,0,1,1,6
LVQQAE,0,0,0,1,1,6
VQQAED,0,0,0,1,1,6
QQAEDK,0,0,0,1,1,6
QAEDKI,0,0,0,1,1,6
AEDKIK,0,0,0,1,1,6
EDKIKE,0,0,0,1,1,6
DKIKEL,0,0,0,1,1,6
KIKELL,0,0,0,1,1,6
IKELLN,0,0,0,1,1,6
KELLNT,0,0,0,1,1,6
NSNTFL,0,0,0,1,1,6
SNTFLT,0,0,0,1,1,6
NTFLTR,0,0,0,1,1,6
TFLTRL,0,0,0,1,1,6
FLTRLL,0,0,0,1,1,6
LTRLLV,0,0,0,1,1,6
TRLLVH,0,0,0,1,1,6
RLLVHM,0,0,0,1,1,6
NSRERE,0,0,0,1,1,6
SREREM,0,0,0,1,1,6
REREMF,0,0,0,1,1,6
EREMFV,0,0,0,1,1,6
REMFVQ,0,0,0,1,1,6
EMFVQE,0,0,0,1,1,6
MFVQEV,0,0,0,1,1,6
FVQEVR,0,0,0,1,1,6
VQEVRR,0,0,0,1,1,6
QEVRRY,0,0,0,1,1,6
EVRRYY,0,0,0,1,1,6
NSSDSI,0,0,0,1,1,6
SSDSID,0,0,0,1,1,6
SDSIDW,0,0,0,1,1,6
DSIDWL,0,0,0,1,1,6
SIDWLT,0,0,0,1,1,6
IDWLTS,0,0,0,1,1,6
DWLTSM,0,0,0,1,1,6
NSVLRA,0,0,0,1,1,6
SVLRAV,0,0,0,1,1,6
VLRAVA,0,0,0,1,1,6
LRAVAE,0,0,0,1,1,6
RAVAEV,0,0,0,1,1,6
AVAEVY,0,0,0,1,1,6
VAEVYA,0,0,0,1,1,6
NTDTLE,0,0,0,1,1,6
TDTLER,0,0,0,1,1,6
DTLERV,0,0,0,1,1,6
TLERVT,0,0,0,1,1,6
LERVTE,0,0,0,1,1,6
ERVTEI,0,0,0,1,1,6
RVTEIF,0,0,0,1,1,6
VTEIFK,0,0,0,1,1,6
TEIFKA,0,0,0,1,1,6
EIFKAL,0,0,0,1,1,6
IFKALG,0,0,0,1,1,6
NTEKLL,0,0,0,1,1,6
TEKLLK,0,0,0,1,1,6
EKLLKT,0,0,0,1,1,6
KLLKTV,0,0,0,1,1,6
LLKTVP,0,0,0,1,1,6
LKTVPI,0,0,0,1,1,6
KTVPII,0,0,0,1,1,6
TVPIIQ,0,0,0,1,1,6
VPIIQN,0,0,0,1,1,6
PIIQNQ,0,0,0,1,1,6
IIQNQM,0,0,0,1,1,6
IQNQMD,0,0,0,1,1,6
QNQMDA,0,0,0,1,1,6
NQMDAL,0,0,0,1,1,6
QMDALL,0,0,0,1,1,6
MDALLD,0,0,0,1,1,6
NTPEAY,0,0,0,1,1,6
TPEAYS,0,0,0,1,1,6
PEAYSV,0,0,0,1,1,6
EAYSVL,0,0,0,1,1,6
AYSVLF,0,0,0,1,1,6
YSVLFD,0,0,0,1,1,6
SVLFDM,0,0,0,1,1,6
VLFDMA,0,0,0,1,1,6
LFDMAR,0,0,0,1,1,6
FDMARE,0,0,0,1,1,6
DMAREV,0,0,0,1,1,6
MAREVN,0,0,0,1,1,6
AREVNR,0,0,0,1,1,6
REVNRL,0,0,0,1,1,6
EVNRLK,0,0,0,1,1,6
VNRLKA,0,0,0,1,1,6
NRLKAE,0,0,0,1,1,6
RLKAED,0,0,0,1,1,6
NVGKAW,0,0,0,1,1,6
VGKAWA,0,0,0,1,1,6
GKAWAE,0,0,0,1,1,6
KAWAED,0,0,0,1,1,6
AWAEDV,0,0,0,1,1,6
WAEDVL,0,0,0,1,1,6
AEDVLA,0,0,0,1,1,6
EDVLAL,0,0,0,1,1,6
DVLALV,0,0,0,1,1,6
VLALVK,0,0,0,1,1,6
LALVKH,0,0,0,1,1,6
NVKDLA,0,0,0,1,1,6
VKDLAD,0,0,0,1,1,6
KDLADA,0,0,0,1,1,6
DLADAA,0,0,0,1,1,6
LADAAK,0,0,0,1,1,6
ADAAKR,0,0,0,1,1,6
DAAKRT,0,0,0,1,1,6
NVKDVT,0,0,0,1,1,6
VKDVTK,0,0,0,1,1,6
KDVTKL,0,0,0,1,1,6
DVTKLV,0,0,0,1,1,6
VTKLVA,0,0,0,1,1,6
TKLVAN,0,0,0,1,1,6
NWDDME,0,0,0,1,1,6
WDDMEK,0,0,0,1,1,6
DDMEKI,0,0,0,1,1,6
DMEKIW,0,0,0,1,1,6
MEKIWH,0,0,0,1,1,6
EKIWHH,0,0,0,1,1,6
KIWHHT,0,0,0,1,1,6
IWHHTF,0,0,0,1,1,6
WHHTFY,0,0,0,1,1,6
HHTFYN,0,0,0,1,1,6
NYAHLN,0,0,0,1,1,6
YAHLNR,0,0,0,1,1,6
AHLNRG,0,0,0,1,1,6
HLNRGI,0,0,0,1,1,6
LNRGIA,0,0,0,1,1,6
NRGIAL,0,0,0,1,1,6
RGIALY,0,0,0,1,1,6
GIALYY,0,0,0,1,1,6
IALYYG,0,0,0,1,1,6
NYEEIY,0,0,0,1,1,6
YEEIYI,0,0,0,1,1,6
EEIYIL,0,0,0,1,1,6
EIYILN,0,0,0,1,1,6
IYILNH,0,0,0,1,1,6
YILNHI,0,0,0,1,1,6
ILNHIL,0,0,0,1,1,6
LNHILR,0,0,0,1,1,6
NYEKFS,0,0,0,1,1,6
YEKFSE,0,0,0,1,1,6
EKFSET,0,0,0,1,1,6
KFSETK,0,0,0,1,1,6
FSETKE,0,0,0,1,1,6
SETKER,0,0,0,1,1,6
ETKERL,0,0,0,1,1,6
TKERLL,0,0,0,1,1,6
KERLLE,0,0,0,1,1,6
ERLLEK,0,0,0,1,1,6
RLLEKF,0,0,0,1,1,6
PAERYY,0,0,0,1,1,6
AERYYR,0,0,0,1,1,6
ERYYRD,0,0,0,1,1,6
RYYRDA,0,0,0,1,1,6
YYRDAR,0,0,0,1,1,6
YRDARI,0,0,0,1,1,6
RDARIT,0,0,0,1,1,6
PALDIL,0,0,0,1,1,6
ALDILK,0,0,0,1,1,6
LDILKA,0,0,0,1,1,6
DILKAL,0,0,0,1,1,6
ILKALV,0,0,0,1,1,6
LKALVD,0,0,0,1,1,6
KALVDN,0,0,0,1,1,6
ALVDNL,0,0,0,1,1,6
LVDNLY,0,0,0,1,1,6
VDNLYV,0,0,0,1,1,6
DNLYVE,0,0,0,1,1,6
NLYVEN,0,0,0,1,1,6
PATSRK,0,0,0,1,1,6
ATSRKI,0,0,0,1,1,6
TSRKIF,0,0,0,1,1,6
SRKIFK,0,0,0,1,1,6
RKIFKY,0,0,0,1,1,6
KIFKYI,0,0,0,1,1,6
IFKYIR,0,0,0,1,1,6
FKYIRE,0,0,0,1,1,6
KYIREL,0,0,0,1,1,6
YIRELD,0,0,0,1,1,6
IRELDE,0,0,0,1,1,6
PDEVSA,0,0,0,1,1,6
DEVSAL,0,0,0,1,1,6
EVSALR,0,0,0,1,1,6
VSALRR,0,0,0,1,1,6
SALRRT,0,0,0,1,1,6
ALRRTT,0,0,0,1,1,6
LRRTTE,0,0,0,1,1,6
RRTTEK,0,0,0,1,1,6
RTTEKN,0,0,0,1,1,6
TTEKNT,0,0,0,1,1,6
TEKNTT,0,0,0,1,1,6
EKNTTT,0,0,0,1,1,6
KNTTTL,0,0,0,1,1,6
NTTTLI,0,0,0,1,1,6
TTTLIN,0,0,0,1,1,6
TTLINL,0,0,0,1,1,6
TLINLA,0,0,0,1,1,6
LINLAK,0,0,0,1,1,6
INLAKQ,0,0,0,1,1,6
NLAKQH,0,0,0,1,1,6
PDFRKA,0,0,0,1,1,6
DFRKAF,0,0,0,1,1,6
FRKAFK,0,0,0,1,1,6
RKAFKR,0,0,0,1,1,6
KAFKRL,0,0,0,1,1,6
AFKRLL,0,0,0,1,1,6
PDIKAQ,0,0,0,1,1,6
DIKAQY,0,0,0,1,1,6
IKAQYQ,0,0,0,1,1,6
KAQYQQ,0,0,0,1,1,6
AQYQQR,0,0,0,1,1,6
QYQQRW,0,0,0,1,1,6
YQQRWL,0,0,0,1,1,6
PDYREV,0,0,0,1,1,6
DYREVM,0,0,0,1,1,6
YREVME,0,0,0,1,1,6
REVMET,0,0,0,1,1,6
EVMETF,0,0,0,1,1,6
VMETFQ,0,0,0,1,1,6
METFQE,0,0,0,1,1,6
PEALTV,0,0,0,1,1,6
EALTVA,0,0,0,1,1,6
ALTVAA,0,0,0,1,1,6
LTVAAT,0,0,0,1,1,6
TVAATE,0,0,0,1,1,6
VAATEV,0,0,0,1,1,6
AATEVR,0,0,0,1,1,6
ATEVRR,0,0,0,1,1,6
TEVRRI,0,0,0,1,1,6
EVRRIR,0,0,0,1,1,6
VRRIRD,0,0,0,1,1,6
RRIRDR,0,0,0,1,1,6
RIRDRA,0,0,0,1,1,6
IRDRAI,0,0,0,1,1,6
RDRAIQ,0,0,0,1,1,6
DRAIQS,0,0,0,1,1,6
RAIQSD,0,0,0,1,1,6
AIQSDA,0,0,0,1,1,6
IQSDAQ,0,0,0,1,1,6
QSDAQV,0,0,0,1,1,6
SDAQVA,0,0,0,1,1,6
DAQVAP,0,0,0,1,1,6
AQVAPM,0,0,0,1,1,6
QVAPMT,0,0,0,1,1,6
VAPMTT,0,0,0,1,1,6
PEDFAN,0,0,0,1,1,6
EDFANH,0,0,0,1,1,6
DFANHL,0,0,0,1,1,6
FANHLF,0,0,0,1,1,6
ANHLFT,0,0,0,1,1,6
NHLFTV,0,0,0,1,1,6
HLFTVF,0,0,0,1,1,6
LFTVFD,0,0,0,1,1,6
PEKEAV,0,0,0,1,1,6
EKEAVT,0,0,0,1,1,6
KEAVTL,0,0,0,1,1,6
EAVTLG,0,0,0,1,1,6
AVTLGI,0,0,0,1,1,6
VTLGIK,0,0,0,1,1,6
TLGIKA,0,0,0,1,1,6
LGIKAL,0,0,0,1,1,6
GIKALK,0,0,0,1,1,6
IKALKS,0,0,0,1,1,6
KALKSS,0,0,0,1,1,6
ALKSSL,0,0,0,1,1,6
PEVQIA,0,0,0,1,1,6
EVQIAI,0,0,0,1,1,6
VQIAIL,0,0,0,1,1,6
QIAILT,0,0,0,1,1,6
IAILTE,0,0,0,1,1,6
AILTEQ,0,0,0,1,1,6
ILTEQI,0,0,0,1,1,6
LTEQIN,0,0,0,1,1,6
TEQINN,0,0,0,1,1,6
EQINNL,0,0,0,1,1,6
QINNLN,0,0,0,1,1,6
INNLNE,0,0,0,1,1,6
NNLNEH,0,0,0,1,1,6
NLNEHL,0,0,0,1,1,6
LNEHLR,0,0,0,1,1,6
NEHLRV,0,0,0,1,1,6
PEYEHL,0,0,0,1,1,6
EYEHLY,0,0,0,1,1,6
YEHLYT,0,0,0,1,1,6
EHLYTE,0,0,0,1,1,6
HLYTEL,0,0,0,1,1,6
LYTELT,0,0,0,1,1,6
YTELTG,0,0,0,1,1,6
TELTGT,0,0,0,1,1,6
ELTGTI,0,0,0,1,1,6
LTGTIV,0,0,0,1,1,6
TGTIVL,0,0,0,1,1,6
GTIVLL,0,0,0,1,1,6
TIVLLI,0,0,0,1,1,6
IVLLIE,0,0,0,1,1,6
VLLIES,0,0,0,1,1,6
PGLRRA,0,0,0,1,1,6
GLRRAW,0,0,0,1,1,6
LRRAWK,0,0,0,1,1,6
RRAWKR,0,0,0,1,1,6
RAWKRL,0,0,0,1,1,6
AWKRLQ,0,0,0,1,1,6
PGRIQR,0,0,0,1,1,6
GRIQRV,0,0,0,1,1,6
RIQRVA,0,0,0,1,1,6
IQRVAR,0,0,0,1,1,6
QRVARG,0,0,0,1,1,6
RVARGS,0,0,0,1,1,6
PIAFIH,0,0,0,1,1,6
IAFIHK,0,0,0,1,1,6
AFIHKA,0,0,0,1,1,6
FIHKAI,0,0,0,1,1,6
PIDIDY,0,0,0,1,1,6
IDIDYM,0,0,0,1,1,6
DIDYMI,0,0,0,1,1,6
IDYMIS,0,0,0,1,1,6
DYMISD,0,0,0,1,1,6
YMISDT,0,0,0,1,1,6
MISDTL,0,0,0,1,1,6
ISDTLE,0,0,0,1,1,6
SDTLEL,0,0,0,1,1,6
DTLELL,0,0,0,1,1,6
TLELLR,0,0,0,1,1,6
PIEAFL,0,0,0,1,1,6
IEAFLR,0,0,0,1,1,6
EAFLRL,0,0,0,1,1,6
AFLRLN,0,0,0,1,1,6
FLRLNE,0,0,0,1,1,6
LRLNEE,0,0,0,1,1,6
RLNEEL,0,0,0,1,1,6
LNEELE,0,0,0,1,1,6
NEELEE,0,0,0,1,1,6
EELEER,0,0,0,1,1,6
ELEERG,0,0,0,1,1,6
PIKFIR,0,0,0,1,1,6
IKFIRK,0,0,0,1,1,6
KFIRKA,0,0,0,1,1,6
PKAYAQ,0,0,0,1,1,6
KAYAQH,0,0,0,1,1,6
AYAQHV,0,0,0,1,1,6
YAQHVF,0,0,0,1,1,6
AQHVFR,0,0,0,1,1,6
QHVFRS,0,0,0,1,1,6
PKPLVS,0,0,0,1,1,6
KPLVSF,0,0,0,1,1,6
PLVSFF,0,0,0,1,1,6
LVSFFQ,0,0,0,1,1,6
VSFFQS,0,0,0,1,1,6
SFFQSL,0,0,0,1,1,6
FFQSLL,0,0,0,1,1,6
FQSLLQ,0,0,0,1,1,6
QSLLQL,0,0,0,1,1,6
SLLQLV,0,0,0,1,1,6
LLQLVN,0,0,0,1,1,6
LQLVNH,0,0,0,1,1,6
QLVNHD,0,0,0,1,1,6
LVNHDL,0,0,0,1,1,6
VNHDLL,0,0,0,1,1,6
NHDLLE,0,0,0,1,1,6
HDLLEQ,0,0,0,1,1,6
DLLEQQ,0,0,0,1,1,6
LLEQQN,0,0,0,1,1,6
PLEELF,0,0,0,1,1,6
LEELFL,0,0,0,1,1,6
EELFLE,0,0,0,1,1,6
ELFLEQ,0,0,0,1,1,6
LFLEQL,0,0,0,1,1,6
FLEQLE,0,0,0,1,1,6
LEQLEA,0,0,0,1,1,6
PLGRLI,0,0,0,1,1,6
LGRLIH,0,0,0,1,1,6
GRLIHM,0,0,0,1,1,6
RLIHMV,0,0,0,1,1,6
LIHMVN,0,0,0,1,1,6
IHMVNQ,0,0,0,1,1,6
HMVNQK,0,0,0,1,1,6
MVNQKK,0,0,0,1,1,6
VNQKKD,0,0,0,1,1,6
NQKKDR,0,0,0,1,1,6
QKKDRL,0,0,0,1,1,6
KKDRLL,0,0,0,1,1,6
KDRLLN,0,0,0,1,1,6
DRLLNE,0,0,0,1,1,6
RLLNEY,0,0,0,1,1,6
LLNEYL,0,0,0,1,1,6
LNEYLS,0,0,0,1,1,6
PLTKGI,0,0,0,1,1,6
LTKGIL,0,0,0,1,1,6
TKGILG,0,0,0,1,1,6
KGILGF,0,0,0,1,1,6
GILGFV,0,0,0,1,1,6
ILGFVF,0,0,0,1,1,6
LGFVFT,0,0,0,1,1,6
GFVFTL,0,0,0,1,1,6
FVFTLT,0,0,0,1,1,6
PNDMSR,0,0,0,1,1,6
NDMSRI,0,0,0,1,1,6
DMSRIF,0,0,0,1,1,6
MSRIFN,0,0,0,1,1,6
SRIFNI,0,0,0,1,1,6
RIFNIV,0,0,0,1,1,6
IFNIVK,0,0,0,1,1,6
FNIVKE,0,0,0,1,1,6
NIVKES,0,0,0,1,1,6
IVKESL,0,0,0,1,1,6
PNGPTH,0,0,0,1,1,6
NGPTHA,0,0,0,1,1,6
GPTHAP,0,0,0,1,1,6
PTHAPW,0,0,0,1,1,6
THAPWL,0,0,0,1,1,6
HAPWLL,0,0,0,1,1,6
APWLLA,0,0,0,1,1,6
PWLLAH,0,0,0,1,1,6
WLLAHK,0,0,0,1,1,6
LLAHKI,0,0,0,1,1,6
LAHKIQ,0,0,0,1,1,6
PQHERD,0,0,0,1,1,6
QHERDV,0,0,0,1,1,6
HERDVI,0,0,0,1,1,6
ERDVIY,0,0,0,1,1,6
RDVIYE,0,0,0,1,1,6
DVIYEE,0,0,0,1,1,6
VIYEEE,0,0,0,1,1,6
IYEEES,0,0,0,1,1,6
PQSYAM,0,0,0,1,1,6
QSYAMA,0,0,0,1,1,6
SYAMAI,0,0,0,1,1,6
YAMAIA,0,0,0,1,1,6
AMAIAR,0,0,0,1,1,6
MAIARQ,0,0,0,1,1,6
AIARQE,0,0,0,1,1,6
IARQES,0,0,0,1,1,6
ARQESA,0,0,0,1,1,6
PQYALE,0,0,0,1,1,6
QYALEL,0,0,0,1,1,6
YALELL,0,0,0,1,1,6
ALELLT,0,0,0,1,1,6
LELLTV,0,0,0,1,1,6
ELLTVY,0,0,0,1,1,6
LLTVYA,0,0,0,1,1,6
LTVYAW,0,0,0,1,1,6
TVYAWE,0,0,0,1,1,6
VYAWEQ,0,0,0,1,1,6
YAWEQG,0,0,0,1,1,6
AWEQGS,0,0,0,1,1,6
PQYSQA,0,0,0,1,1,6
QYSQAR,0,0,0,1,1,6
YSQARV,0,0,0,1,1,6
SQARVM,0,0,0,1,1,6
QARVML,0,0,0,1,1,6
ARVMLV,0,0,0,1,1,6
RVMLVK,0,0,0,1,1,6
VMLVKT,0,0,0,1,1,6
MLVKTI,0,0,0,1,1,6
LVKTIS,0,0,0,1,1,6
VKTISM,0,0,0,1,1,6
KTISMI,0,0,0,1,1,6
TISMIS,0,0,0,1,1,6
ISMISI,0,0,0,1,1,6
SMISIV,0,0,0,1,1,6
MISIVD,0,0,0,1,1,6
ISIVDD,0,0,0,1,1,6
SIVDDT,0,0,0,1,1,6
IVDDTF,0,0,0,1,1,6
VDDTFD,0,0,0,1,1,6
DDTFDA,0,0,0,1,1,6
PRESFA,0,0,0,1,1,6
RESFAV,0,0,0,1,1,6
ESFAVL,0,0,0,1,1,6
SFAVLA,0,0,0,1,1,6
FAVLAS,0,0,0,1,1,6
AVLASA,0,0,0,1,1,6
VLASAL,0,0,0,1,1,6
LASALA,0,0,0,1,1,6
ASALAL,0,0,0,1,1,6
SALALM,0,0,0,1,1,6
ALALMA,0,0,0,1,1,6
LALMAA,0,0,0,1,1,6
ALMAAV,0,0,0,1,1,6
LMAAVF,0,0,0,1,1,6
MAAVFE,0,0,0,1,1,6
AAVFER,0,0,0,1,1,6
AVFERL,0,0,0,1,1,6
VFERLA,0,0,0,1,1,6
FERLAV,0,0,0,1,1,6
ERLAVE,0,0,0,1,1,6
RLAVEI,0,0,0,1,1,6
LAVEIR,0,0,0,1,1,6
AVEIRE,0,0,0,1,1,6
VEIREL,0,0,0,1,1,6
EIRELS,0,0,0,1,1,6
PRRQQS,0,0,0,1,1,6
RRQQSL,0,0,0,1,1,6
RQQSLA,0,0,0,1,1,6
QQSLAL,0,0,0,1,1,6
QSLALR,0,0,0,1,1,6
SLALRW,0,0,0,1,1,6
LALRWL,0,0,0,1,1,6
ALRWLV,0,0,0,1,1,6
LRWLVQ,0,0,0,1,1,6
RWLVQA,0,0,0,1,1,6
WLVQAA,0,0,0,1,1,6
LVQAAN,0,0,0,1,1,6
VQAANQ,0,0,0,1,1,6
PSALID,0,0,0,1,1,6
SALIDQ,0,0,0,1,1,6
ALIDQE,0,0,0,1,1,6
LIDQEI,0,0,0,1,1,6
IDQEIN,0,0,0,1,1,6
DQEINV,0,0,0,1,1,6
QEINVL,0,0,0,1,1,6
EINVLR,0,0,0,1,1,6
INVLRQ,0,0,0,1,1,6
NVLRQQ,0,0,0,1,1,6
VLRQQA,0,0,0,1,1,6
LRQQAA,0,0,0,1,1,6
RQQAAQ,0,0,0,1,1,6
QQAAQR,0,0,0,1,1,6
QAAQRF,0,0,0,1,1,6
PSDQQN,0,0,0,1,1,6
SDQQNE,0,0,0,1,1,6
DQQNEM,0,0,0,1,1,6
QQNEMV,0,0,0,1,1,6
QNEMVR,0,0,0,1,1,6
NEMVRE,0,0,0,1,1,6
PSFFRL,0,0,0,1,1,6
SFFRLH,0,0,0,1,1,6
FFRLHK,0,0,0,1,1,6
FRLHKY,0,0,0,1,1,6
RLHKYM,0,0,0,1,1,6
LHKYMD,0,0,0,1,1,6
HKYMDN,0,0,0,1,1,6
KYMDNI,0,0,0,1,1,6
YMDNIF,0,0,0,1,1,6
MDNIFK,0,0,0,1,1,6
DNIFKK,0,0,0,1,1,6
NIFKKH,0,0,0,1,1,6
IFKKHT,0,0,0,1,1,6
FKKHTD,0,0,0,1,1,6
PSSQIV,0,0,0,1,1,6
SSQIVG,0,0,0,1,1,6
SQIVGT,0,0,0,1,1,6
QIVGTQ,0,0,0,1,1,6
IVGTQA,0,0,0,1,1,6
VGTQAV,0,0,0,1,1,6
GTQAVF,0,0,0,1,1,6
TQAVFN,0,0,0,1,1,6
QAVFNV,0,0,0,1,1,6
AVFNVM,0,0,0,1,1,6
VFNVMM,0,0,0,1,1,6
FNVMMG,0,0,0,1,1,6
PSVVAN,0,0,0,1,1,6
SVVANT,0,0,0,1,1,6
VVANTV,0,0,0,1,1,6
VANTVK,0,0,0,1,1,6
ANTVKG,0,0,0,1,1,6
NTVKGG,0,0,0,1,1,6
PTKERE,0,0,0,1,1,6
TKEREQ,0,0,0,1,1,6
KEREQV,0,0,0,1,1,6
EREQVI,0,0,0,1,1,6
REQVIA,0,0,0,1,1,6
EQVIAH,0,0,0,1,1,6
QVIAHL,0,0,0,1,1,6
VIAHLG,0,0,0,1,1,6
IAHLGL,0,0,0,1,1,6
PTLLDL,0,0,0,1,1,6
TLLDLF,0,0,0,1,1,6
LLDLFA,0,0,0,1,1,6
LDLFAE,0,0,0,1,1,6
DLFAED,0,0,0,1,1,6
LFAEDI,0,0,0,1,1,6
FAEDIG,0,0,0,1,1,6
AEDIGH,0,0,0,1,1,6
EDIGHA,0,0,0,1,1,6
DIGHAN,0,0,0,1,1,6
IGHANQ,0,0,0,1,1,6
GHANQL,0,0,0,1,1,6
HANQLL,0,0,0,1,1,6
ANQLLQ,0,0,0,1,1,6
NQLLQL,0,0,0,1,1,6
QLLQLV,0,0,0,1,1,6
LLQLVD,0,0,0,1,1,6
LQLVDE,0,0,0,1,1,6
QLVDEE,0,0,0,1,1,6
LVDEEF,0,0,0,1,1,6
VDEEFQ,0,0,0,1,1,6
DEEFQA,0,0,0,1,1,6
EEFQAL,0,0,0,1,1,6
EFQALE,0,0,0,1,1,6
FQALER,0,0,0,1,1,6
PVSDTM,0,0,0,1,1,6
VSDTMD,0,0,0,1,1,6
SDTMDM,0,0,0,1,1,6
DTMDML,0,0,0,1,1,6
TMDMLT,0,0,0,1,1,6
MDMLTK,0,0,0,1,1,6
DMLTKL,0,0,0,1,1,6
PWTQRF,0,0,0,1,1,6
WTQRFF,0,0,0,1,1,6
TQRFFE,0,0,0,1,1,6
QRFFES,0,0,0,1,1,6
RFFESF,0,0,0,1,1,6
FFESFG,0,0,0,1,1,6
QAGNYA,0,0,0,1,1,6
AGNYAS,0,0,0,1,1,6
GNYASM,0,0,0,1,1,6
NYASMF,0,0,0,1,1,6
YASMFW,0,0,0,1,1,6
ASMFWL,0,0,0,1,1,6
SMFWLT,0,0,0,1,1,6
QAKEVL,0,0,0,1,1,6
AKEVLK,0,0,0,1,1,6
KEVLKQ,0,0,0,1,1,6
EVLKQH,0,0,0,1,1,6
VLKQHF,0,0,0,1,1,6
LKQHFE,0,0,0,1,1,6
KQHFEK,0,0,0,1,1,6
QHFEKS,0,0,0,1,1,6
QARVWV,0,0,0,1,1,6
ARVWVA,0,0,0,1,1,6
RVWVAR,0,0,0,1,1,6
VWVARA,0,0,0,1,1,6
WVARAV,0,0,0,1,1,6
VARAVS,0,0,0,1,1,6
ARAVSE,0,0,0,1,1,6
RAVSEH,0,0,0,1,1,6
AVSEHQ,0,0,0,1,1,6
VSEHQR,0,0,0,1,1,6
SEHQRF,0,0,0,1,1,6
EHQRFT,0,0,0,1,1,6
HQRFTA,0,0,0,1,1,6
QASTGS,0,0,0,1,1,6
ASTGSL,0,0,0,1,1,6
STGSLL,0,0,0,1,1,6
TGSLLN,0,0,0,1,1,6
GSLLNI,0,0,0,1,1,6
SLLNIL,0,0,0,1,1,6
LLNILR,0,0,0,1,1,6
QDDVLE,0,0,0,1,1,6
DDVLEA,0,0,0,1,1,6
DVLEAL,0,0,0,1,1,6
VLEALS,0,0,0,1,1,6
LEALSA,0,0,0,1,1,6
EALSAA,0,0,0,1,1,6
ALSAAV,0,0,0,1,1,6
LSAAVR,0,0,0,1,1,6
QDELVW,0,0,0,1,1,6
DELVWG,0,0,0,1,1,6
ELVWGA,0,0,0,1,1,6
LVWGAY,0,0,0,1,1,6
VWGAYW,0,0,0,1,1,6
WGAYWL,0,0,0,1,1,6
GAYWLY,0,0,0,1,1,6
AYWLYK,0,0,0,1,1,6
YWLYKA,0,0,0,1,1,6
WLYKAT,0,0,0,1,1,6
QDLLDR,0,0,0,1,1,6
DLLDRV,0,0,0,1,1,6
LLDRVL,0,0,0,1,1,6
LDRVLA,0,0,0,1,1,6
DRVLAA,0,0,0,1,1,6
RVLAAH,0,0,0,1,1,6
VLAAHA,0,0,0,1,1,6
LAAHAY,0,0,0,1,1,6
AAHAYW,0,0,0,1,1,6
AHAYWS,0,0,0,1,1,6
HAYWSQ,0,0,0,1,1,6
QEWVEL,0,0,0,1,1,6
EWVELM,0,0,0,1,1,6
WVELMV,0,0,0,1,1,6
VELMVE,0,0,0,1,1,6
ELMVEA,0,0,0,1,1,6
LMVEAK,0,0,0,1,1,6
MVEAKE,0,0,0,1,1,6
QFRRGA,0,0,0,1,1,6
FRRGAN,0,0,0,1,1,6
RRGANF,0,0,0,1,1,6
RGANFK,0,0,0,1,1,6
GANFKF,0,0,0,1,1,6
ANFKFE,0,0,0,1,1,6
NFKFEL,0,0,0,1,1,6
FKFELG,0,0,0,1,1,6
KFELGE,0,0,0,1,1,6
FELGEI,0,0,0,1,1,6
ELGEIL,0,0,0,1,1,6
LGEILE,0,0,0,1,1,6
GEILEN,0,0,0,1,1,6
EILEND,0,0,0,1,1,6
QFSRQM,0,0,0,1,1,6
FSRQML,0,0,0,1,1,6
SRQMLD,0,0,0,1,1,6
RQMLDR,0,0,0,1,1,6
QMLDRK,0,0,0,1,1,6
MLDRKL,0,0,0,1,1,6
LDRKLL,0,0,0,1,1,6
DRKLLL,0,0,0,1,1,6
RKLLLG,0,0,0,1,1,6
QGLAEK,0,0,0,1,1,6
GLAEKI,0,0,0,1,1,6
LAEKIF,0,0,0,1,1,6
AEKIFW,0,0,0,1,1,6
EKIFWS,0,0,0,1,1,6
KIFWSL,0,0,0,1,1,6
IFWSLK,0,0,0,1,1,6
QHLAKL,0,0,0,1,1,6
HLAKLE,0,0,0,1,1,6
LAKLEM,0,0,0,1,1,6
AKLEMK,0,0,0,1,1,6
KLEMKI,0,0,0,1,1,6
LEMKIF,0,0,0,1,1,6
EMKIFF,0,0,0,1,1,6
MKIFFE,0,0,0,1,1,6
KIFFEE,0,0,0,1,1,6
IFFEEL,0,0,0,1,1,6
QIKQTN,0,0,0,1,1,6
IKQTNA,0,0,0,1,1,6
KQTNAG,0,0,0,1,1,6
QTNAGA,0,0,0,1,1,6
TNAGAV,0,0,0,1,1,6
NAGAVY,0,0,0,1,1,6
AGAVYR,0,0,0,1,1,6
GAVYRL,0,0,0,1,1,6
AVYRLI,0,0,0,1,1,6
VYRLID,0,0,0,1,1,6
YRLIDQ,0,0,0,1,1,6
RLIDQL,0,0,0,1,1,6
LIDQLG,0,0,0,1,1,6
QINEMH,0,0,0,1,1,6
INEMHL,0,0,0,1,1,6
NEMHLL,0,0,0,1,1,6
EMHLLI,0,0,0,1,1,6
MHLLIQ,0,0,0,1,1,6
HLLIQQ,0,0,0,1,1,6
LLIQQA,0,0,0,1,1,6
LIQQAR,0,0,0,1,1,6
QIPRIA,0,0,0,1,1,6
IPRIAR,0,0,0,1,1,6
PRIARE,0,0,0,1,1,6
RIAREK,0,0,0,1,1,6
IAREKI,0,0,0,1,1,6
AREKIR,0,0,0,1,1,6
REKIRG,0,0,0,1,1,6
EKIRGL,0,0,0,1,1,6
KIRGLT,0,0,0,1,1,6
IRGLTE,0,0,0,1,1,6
RGLTEY,0,0,0,1,1,6
GLTEYF,0,0,0,1,1,6
QLEESM,0,0,0,1,1,6
LEESML,0,0,0,1,1,6
EESMLY,0,0,0,1,1,6
ESMLYS,0,0,0,1,1,6
SMLYSL,0,0,0,1,1,6
MLYSLN,0,0,0,1,1,6
QLLRGV,0,0,0,1,1,6
LLRGVG,0,0,0,1,1,6
LRGVGA,0,0,0,1,1,6
RGVGAA,0,0,0,1,1,6
GVGAAA,0,0,0,1,1,6
VGAAAT,0,0,0,1,1,6
GAAATA,0,0,0,1,1,6
AAATAV,0,0,0,1,1,6
AATAVT,0,0,0,1,1,6
ATAVTQ,0,0,0,1,1,6
TAVTQA,0,0,0,1,1,6
AVTQAL,0,0,0,1,1,6
VTQALN,0,0,0,1,1,6
TQALNE,0,0,0,1,1,6
QALNEL,0,0,0,1,1,6
ALNELL,0,0,0,1,1,6
LNELLQ,0,0,0,1,1,6
NELLQH,0,0,0,1,1,6
ELLQHV,0,0,0,1,1,6
LLQHVK,0,0,0,1,1,6
LQHVKA,0,0,0,1,1,6
QLVDRL,0,0,0,1,1,6
LVDRLD,0,0,0,1,1,6
VDRLDQ,0,0,0,1,1,6
DRLDQS,0,0,0,1,1,6
RLDQSW,0,0,0,1,1,6
LDQSWQ,0,0,0,1,1,6
DQSWQY,0,0,0,1,1,6
QSWQYY,0,0,0,1,1,6
SWQYYQ,0,0,0,1,1,6
WQYYQD,0,0,0,1,1,6
QYYQDR,0,0,0,1,1,6
YYQDRL,0,0,0,1,1,6
YQDRLM,0,0,0,1,1,6
QDRLMA,0,0,0,1,1,6
QLVSFL,0,0,0,1,1,6
LVSFLI,0,0,0,1,1,6
VSFLIR,0,0,0,1,1,6
SFLIRL,0,0,0,1,1,6
FLIRLL,0,0,0,1,1,6
LIRLLK,0,0,0,1,1,6
IRLLKV,0,0,0,1,1,6
RLLKVW,0,0,0,1,1,6
LLKVWI,0,0,0,1,1,6
LKVWIR,0,0,0,1,1,6
KVWIRV,0,0,0,1,1,6
VWIRVV,0,0,0,1,1,6
WIRVVI,0,0,0,1,1,6
QMSFWG,0,0,0,1,1,6
MSFWGA,0,0,0,1,1,6
SFWGAT,0,0,0,1,1,6
FWGATV,0,0,0,1,1,6
WGATVI,0,0,0,1,1,6
GATVIT,0,0,0,1,1,6
ATVITG,0,0,0,1,1,6
TVITGL,0,0,0,1,1,6
VITGLF,0,0,0,1,1,6
ITGLFG,0,0,0,1,1,6
QPNAIL,0,0,0,1,1,6
PNAILE,0,0,0,1,1,6
NAILEK,0,0,0,1,1,6
AILEKV,0,0,0,1,1,6
ILEKVF,0,0,0,1,1,6
LEKVFT,0,0,0,1,1,6
EKVFTA,0,0,0,1,1,6
QRAFLK,0,0,0,1,1,6
RAFLKL,0,0,0,1,1,6
AFLKLY,0,0,0,1,1,6
FLKLYM,0,0,0,1,1,6
LKLYMI,0,0,0,1,1,6
KLYMIT,0,0,0,1,1,6
LYMITM,0,0,0,1,1,6
YMITMT,0,0,0,1,1,6
MITMTE,0,0,0,1,1,6
QTREHL,0,0,0,1,1,6
TREHLL,0,0,0,1,1,6
REHLLL,0,0,0,1,1,6
EHLLLA,0,0,0,1,1,6
HLLLAR,0,0,0,1,1,6
LLLARQ,0,0,0,1,1,6
LLARQI,0,0,0,1,1,6
QVIAKW,0,0,0,1,1,6
VIAKWG,0,0,0,1,1,6
IAKWGA,0,0,0,1,1,6
AKWGAW,0,0,0,1,1,6
KWGAWV,0,0,0,1,1,6
WGAWVK,0,0,0,1,1,6
GAWVKR,0,0,0,1,1,6
AWVKRI,0,0,0,1,1,6
WVKRIE,0,0,0,1,1,6
VKRIEA,0,0,0,1,1,6
KRIEAK,0,0,0,1,1,6
RIEAKF,0,0,0,1,1,6
IEAKFR,0,0,0,1,1,6
EAKFRS,0,0,0,1,1,6
AKFRSL,0,0,0,1,1,6
QVIEVL,0,0,0,1,1,6
VIEVLN,0,0,0,1,1,6
IEVLNK,0,0,0,1,1,6
EVLNKQ,0,0,0,1,1,6
VLNKQV,0,0,0,1,1,6
LNKQVA,0,0,0,1,1,6
NKQVAD,0,0,0,1,1,6
KQVADW,0,0,0,1,1,6
QVADWS,0,0,0,1,1,6
VADWSV,0,0,0,1,1,6
ADWSVL,0,0,0,1,1,6
DWSVLF,0,0,0,1,1,6
WSVLFT,0,0,0,1,1,6
SVLFTK,0,0,0,1,1,6
VLFTKL,0,0,0,1,1,6
LFTKLH,0,0,0,1,1,6
FTKLHN,0,0,0,1,1,6
TKLHNF,0,0,0,1,1,6
KLHNFH,0,0,0,1,1,6
LHNFHW,0,0,0,1,1,6
HNFHWY,0,0,0,1,1,6
NFHWYV,0,0,0,1,1,6
QVTQEL,0,0,0,1,1,6
VTQELR,0,0,0,1,1,6
TQELRA,0,0,0,1,1,6
QELRAL,0,0,0,1,1,6
ELRALM,0,0,0,1,1,6
LRALMD,0,0,0,1,1,6
RALMDE,0,0,0,1,1,6
ALMDET,0,0,0,1,1,6
LMDETM,0,0,0,1,1,6
MDETMK,0,0,0,1,1,6
DETMKE,0,0,0,1,1,6
ETMKEL,0,0,0,1,1,6
TMKELK,0,0,0,1,1,6
MKELKA,0,0,0,1,1,6
KELKAY,0,0,0,1,1,6
ELKAYK,0,0,0,1,1,6
LKAYKS,0,0,0,1,1,6
KAYKSE,0,0,0,1,1,6
AYKSEL,0,0,0,1,1,6
YKSELE,0,0,0,1,1,6
KSELEE,0,0,0,1,1,6
RAAAIE,0,0,0,1,1,6
AAAIEQ,0,0,0,1,1,6
AAIEQL,0,0,0,1,1,6
AIEQLK,0,0,0,1,1,6
IEQLKI,0,0,0,1,1,6
EQLKIW,0,0,0,1,1,6
QLKIWG,0,0,0,1,1,6
LKIWGE,0,0,0,1,1,6
KIWGER,0,0,0,1,1,6
IWGERV,0,0,0,1,1,6
WGERVG,0,0,0,1,1,6
RDIPEL,0,0,0,1,1,6
DIPELA,0,0,0,1,1,6
IPELAQ,0,0,0,1,1,6
PELAQL,0,0,0,1,1,6
ELAQLQ,0,0,0,1,1,6
LAQLQS,0,0,0,1,1,6
AQLQSE,0,0,0,1,1,6
QLQSEI,0,0,0,1,1,6
LQSEIL,0,0,0,1,1,6
QSEILD,0,0,0,1,1,6
SEILDA,0,0,0,1,1,6
EILDAI,0,0,0,1,1,6
ILDAIW,0,0,0,1,1,6
REEEKE,0,0,0,1,1,6
EEEKEA,0,0,0,1,1,6
EEKEAL,0,0,0,1,1,6
EKEALR,0,0,0,1,1,6
KEALRF,0,0,0,1,1,6
EALRFA,0,0,0,1,1,6
ALRFAE,0,0,0,1,1,6
LRFAEA,0,0,0,1,1,6
RFAEAQ,0,0,0,1,1,6
REEIYQ,0,0,0,1,1,6
EEIYQA,0,0,0,1,1,6
EIYQAF,0,0,0,1,1,6
IYQAFE,0,0,0,1,1,6
YQAFEA,0,0,0,1,1,6
QAFEAI,0,0,0,1,1,6
AFEAIY,0,0,0,1,1,6
FEAIYP,0,0,0,1,1,6
EAIYPV,0,0,0,1,1,6
AIYPVL,0,0,0,1,1,6
IYPVLS,0,0,0,1,1,6
YPVLSE,0,0,0,1,1,6
PVLSEF,0,0,0,1,1,6
REGFLS,0,0,0,1,1,6
EGFLSP,0,0,0,1,1,6
GFLSPL,0,0,0,1,1,6
FLSPLK,0,0,0,1,1,6
LSPLKA,0,0,0,1,1,6
SPLKAY,0,0,0,1,1,6
PLKAYL,0,0,0,1,1,6
LKAYLI,0,0,0,1,1,6
RFESAV,0,0,0,1,1,6
FESAVE,0,0,0,1,1,6
ESAVET,0,0,0,1,1,6
SAVETL,0,0,0,1,1,6
AVETLL,0,0,0,1,1,6
VETLLD,0,0,0,1,1,6
ETLLDI,0,0,0,1,1,6
TLLDIE,0,0,0,1,1,6
LLDIES,0,0,0,1,1,6
LDIESQ,0,0,0,1,1,6
DIESQL,0,0,0,1,1,6
IESQLE,0,0,0,1,1,6
ESQLED,0,0,0,1,1,6
SQLEDL,0,0,0,1,1,6
RFLIRV,0,0,0,1,1,6
FLIRVY,0,0,0,1,1,6
LIRVYH,0,0,0,1,1,6
IRVYHP,0,0,0,1,1,6
RVYHPL,0,0,0,1,1,6
VYHPLL,0,0,0,1,1,6
YHPLLL,0,0,0,1,1,6
HPLLLK,0,0,0,1,1,6
PLLLKV,0,0,0,1,1,6
LLLKVL,0,0,0,1,1,6
RFLKRV,0,0,0,1,1,6
FLKRVQ,0,0,0,1,1,6
LKRVQP,0,0,0,1,1,6
KRVQPL,0,0,0,1,1,6
RVQPLV,0,0,0,1,1,6
VQPLVN,0,0,0,1,1,6
QPLVNR,0,0,0,1,1,6
PLVNRW,0,0,0,1,1,6
LVNRWL,0,0,0,1,1,6
VNRWLL,0,0,0,1,1,6
NRWLLL,0,0,0,1,1,6
RWLLLI,0,0,0,1,1,6
RFSGKV,0,0,0,1,1,6
FSGKVR,0,0,0,1,1,6
SGKVRE,0,0,0,1,1,6
GKVRED,0,0,0,1,1,6
KVREDL,0,0,0,1,1,6
VREDLT,0,0,0,1,1,6
REDLTK,0,0,0,1,1,6
EDLTKI,0,0,0,1,1,6
DLTKIV,0,0,0,1,1,6
LTKIVW,0,0,0,1,1,6
TKIVWV,0,0,0,1,1,6
KIVWVF,0,0,0,1,1,6
IVWVFF,0,0,0,1,1,6
VWVFFW,0,0,0,1,1,6
RFVPRW,0,0,0,1,1,6
FVPRWR,0,0,0,1,1,6
VPRWRT,0,0,0,1,1,6
PRWRTV,0,0,0,1,1,6
RWRTVV,0,0,0,1,1,6
WRTVVG,0,0,0,1,1,6
RTVVGQ,0,0,0,1,1,6
TVVGQF,0,0,0,1,1,6
VVGQFK,0,0,0,1,1,6
VGQFKR,0,0,0,1,1,6
GQFKRD,0,0,0,1,1,6
QFKRDI,0,0,0,1,1,6
FKRDIL,0,0,0,1,1,6
KRDILV,0,0,0,1,1,6
RDILVI,0,0,0,1,1,6
DILVIF,0,0,0,1,1,6
ILVIFL,0,0,0,1,1,6
LVIFLW,0,0,0,1,1,6
RGEQMK,0,0,0,1,1,6
GEQMKG,0,0,0,1,1,6
EQMKGH,0,0,0,1,1,6
QMKGHA,0,0,0,1,1,6
MKGHAA,0,0,0,1,1,6
KGHAAT,0,0,0,1,1,6
GHAATI,0,0,0,1,1,6
HAATIE,0,0,0,1,1,6
AATIED,0,0,0,1,1,6
ATIEDQ,0,0,0,1,1,6
TIEDQV,0,0,0,1,1,6
IEDQVR,0,0,0,1,1,6
EDQVRR,0,0,0,1,1,6
DQVRRM,0,0,0,1,1,6
QVRRMI,0,0,0,1,1,6
VRRMIA,0,0,0,1,1,6
RGFRGW,0,0,0,1,1,6
GFRGWW,0,0,0,1,1,6
FRGWWL,0,0,0,1,1,6
RGWWLA,0,0,0,1,1,6
GWWLAS,0,0,0,1,1,6
WWLAST,0,0,0,1,1,6
WLASTI,0,0,0,1,1,6
LASTIL,0,0,0,1,1,6
ASTILL,0,0,0,1,1,6
STILLL,0,0,0,1,1,6
TILLLV,0,0,0,1,1,6
ILLLVA,0,0,0,1,1,6
LLLVAE,0,0,0,1,1,6
LLVAEK,0,0,0,1,1,6
RGQLIR,0,0,0,1,1,6
GQLIRE,0,0,0,1,1,6
QLIREA,0,0,0,1,1,6
LIREAY,0,0,0,1,1,6
IREAYE,0,0,0,1,1,6
REAYED,0,0,0,1,1,6
RHSDNI,0,0,0,1,1,6
HSDNIN,0,0,0,1,1,6
SDNINK,0,0,0,1,1,6
DNINKF,0,0,0,1,1,6
NINKFL,0,0,0,1,1,6
INKFLD,0,0,0,1,1,6
NKFLDF,0,0,0,1,1,6
KFLDFI,0,0,0,1,1,6
FLDFIH,0,0,0,1,1,6
LDFIHG,0,0,0,1,1,6
DFIHGI,0,0,0,1,1,6
RIENGL,0,0,0,1,1,6
IENGLR,0,0,0,1,1,6
ENGLRK,0,0,0,1,1,6
NGLRKR,0,0,0,1,1,6
GLRKRL,0,0,0,1,1,6
LRKRLQ,0,0,0,1,1,6
RKRLQS,0,0,0,1,1,6
KRLQSI,0,0,0,1,1,6
RLQSIY,0,0,0,1,1,6
LQSIYR,0,0,0,1,1,6
QSIYRH,0,0,0,1,1,6
SIYRHL,0,0,0,1,1,6
IYRHLE,0,0,0,1,1,6
YRHLEE,0,0,0,1,1,6
RILKNF,0,0,0,1,1,6
ILKNFD,0,0,0,1,1,6
LKNFDS,0,0,0,1,1,6
KNFDSW,0,0,0,1,1,6
NFDSWW,0,0,0,1,1,6
FDSWWG,0,0,0,1,1,6
DSWWGK,0,0,0,1,1,6
SWWGKV,0,0,0,1,1,6
WWGKVI,0,0,0,1,1,6
WGKVIV,0,0,0,1,1,6
GKVIVI,0,0,0,1,1,6
KVIVIL,0,0,0,1,1,6
RILQWI,0,0,0,1,1,6
ILQWII,0,0,0,1,1,6
LQWIIR,0,0,0,1,1,6
QWIIRL,0,0,0,1,1,6
WIIRLL,0,0,0,1,1,6
IIRLLL,0,0,0,1,1,6
IRLLLI,0,0,0,1,1,6
RLLLIV,0,0,0,1,1,6
LLLIVW,0,0,0,1,1,6
LLIVWW,0,0,0,1,1,6
RIWARL,0,0,0,1,1,6
IWARLQ,0,0,0,1,1,6
WARLQG,0,0,0,1,1,6
ARLQGV,0,0,0,1,1,6
RLQGVF,0,0,0,1,1,6
LQGVFR,0,0,0,1,1,6
QGVFRV,0,0,0,1,1,6
GVFRVV,0,0,0,1,1,6
VFRVVF,0,0,0,1,1,6
FRVVFW,0,0,0,1,1,6
RVVFWL,0,0,0,1,1,6
RKQSLE,0,0,0,1,1,6
KQSLEQ,0,0,0,1,1,6
QSLEQD,0,0,0,1,1,6
SLEQDL,0,0,0,1,1,6
LEQDLQ,0,0,0,1,1,6
EQDLQF,0,0,0,1,1,6
QDLQFY,0,0,0,1,1,6
DLQFYY,0,0,0,1,1,6
LQFYYG,0,0,0,1,1,6
RLDEAE,0,0,0,1,1,6
LDEAEA,0,0,0,1,1,6
DEAEAS,0,0,0,1,1,6
EAEASA,0,0,0,1,1,6
AEASAR,0,0,0,1,1,6
EASARS,0,0,0,1,1,6
ASARSG,0,0,0,1,1,6
SARSGI,0,0,0,1,1,6
ARSGIE,0,0,0,1,1,6
RSGIEV,0,0,0,1,1,6
SGIEVL,0,0,0,1,1,6
RLFEQA,0,0,0,1,1,6
LFEQAS,0,0,0,1,1,6
FEQASR,0,0,0,1,1,6
EQASRL,0,0,0,1,1,6
QASRLA,0,0,0,1,1,6
ASRLAE,0,0,0,1,1,6
SRLAEH,0,0,0,1,1,6
RLAEHY,0,0,0,1,1,6
RLKSGW,0,0,0,1,1,6
LKSGWR,0,0,0,1,1,6
KSGWRD,0,0,0,1,1,6
SGWRDA,0,0,0,1,1,6
GWRDAL,0,0,0,1,1,6
WRDALK,0,0,0,1,1,6
RDALKQ,0,0,0,1,1,6
DALKQI,0,0,0,1,1,6
ALKQIV,0,0,0,1,1,6
LKQIVF,0,0,0,1,1,6
KQIVFF,0,0,0,1,1,6
QIVFFF,0,0,0,1,1,6
IVFFFF,0,0,0,1,1,6
VFFFFL,0,0,0,1,1,6
RLLGKW,0,0,0,1,1,6
LLGKWS,0,0,0,1,1,6
LGKWSA,0,0,0,1,1,6
GKWSAI,0,0,0,1,1,6
KWSAIL,0,0,0,1,1,6
WSAILK,0,0,0,1,1,6
SAILKN,0,0,0,1,1,6
AILKNV,0,0,0,1,1,6
ILKNVR,0,0,0,1,1,6
LKNVRF,0,0,0,1,1,6
KNVRFF,0,0,0,1,1,6
NVRFFF,0,0,0,1,1,6
VRFFFF,0,0,0,1,1,6
RFFFFW,0,0,0,1,1,6
FFFFWL,0,0,0,1,1,6
RLVVLE,0,0,0,1,1,6
LVVLEA,0,0,0,1,1,6
VVLEAL,0,0,0,1,1,6
VLEALT,0,0,0,1,1,6
LEALTN,0,0,0,1,1,6
EALTNF,0,0,0,1,1,6
ALTNFL,0,0,0,1,1,6
LTNFLN,0,0,0,1,1,6
TNFLNH,0,0,0,1,1,6
RLWTQW,0,0,0,1,1,6
LWTQWQ,0,0,0,1,1,6
WTQWQA,0,0,0,1,1,6
TQWQAI,0,0,0,1,1,6
QWQAIV,0,0,0,1,1,6
WQAIVQ,0,0,0,1,1,6
QAIVQE,0,0,0,1,1,6
AIVQEI,0,0,0,1,1,6
IVQEIR,0,0,0,1,1,6
VQEIRF,0,0,0,1,1,6
QEIRFL,0,0,0,1,1,6
EIRFLW,0,0,0,1,1,6
IRFLWL,0,0,0,1,1,6
RFLWLL,0,0,0,1,1,6
FLWLLL,0,0,0,1,1,6
RMDEVR,0,0,0,1,1,6
MDEVRT,0,0,0,1,1,6
DEVRTL,0,0,0,1,1,6
EVRTLQ,0,0,0,1,1,6
VRTLQE,0,0,0,1,1,6
RTLQEN,0,0,0,1,1,6
TLQENL,0,0,0,1,1,6
LQENLR,0,0,0,1,1,6
QENLRQ,0,0,0,1,1,6
ENLRQL,0,0,0,1,1,6
NLRQLQ,0,0,0,1,1,6
LRQLQD,0,0,0,1,1,6
RQLQDE,0,0,0,1,1,6
QLQDEY,0,0,0,1,1,6
LQDEYD,0,0,0,1,1,6
QDEYDQ,0,0,0,1,1,6
DEYDQQ,0,0,0,1,1,6
EYDQQQ,0,0,0,1,1,6
YDQQQT,0,0,0,1,1,6
RNEVVS,0,0,0,1,1,6
NEVVSL,0,0,0,1,1,6
EVVSLM,0,0,0,1,1,6
VVSLMQ,0,0,0,1,1,6
VSLMQA,0,0,0,1,1,6
SLMQAN,0,0,0,1,1,6
LMQANG,0,0,0,1,1,6
RPEDKS,0,0,0,1,1,6
PEDKSK,0,0,0,1,1,6
EDKSKI,0,0,0,1,1,6
DKSKIV,0,0,0,1,1,6
KSKIVA,0,0,0,1,1,6
SKIVAE,0,0,0,1,1,6
KIVAEI,0,0,0,1,1,6
IVAEIR,0,0,0,1,1,6
RPEVQD,0,0,0,1,1,6
PEVQDA,0,0,0,1,1,6
EVQDAL,0,0,0,1,1,6
VQDALS,0,0,0,1,1,6
QDALSA,0,0,0,1,1,6
DALSAE,0,0,0,1,1,6
RPQLRN,0,0,0,1,1,6
PQLRNL,0,0,0,1,1,6
QLRNLL,0,0,0,1,1,6
LRNLLH,0,0,0,1,1,6
RNLLHE,0,0,0,1,1,6
NLLHEK,0,0,0,1,1,6
RPRIIA,0,0,0,1,1,6
PRIIAA,0,0,0,1,1,6
RIIAAI,0,0,0,1,1,6
IIAAIW,0,0,0,1,1,6
IAAIWH,0,0,0,1,1,6
AAIWHY,0,0,0,1,1,6
AIWHYV,0,0,0,1,1,6
IWHYVK,0,0,0,1,1,6
WHYVKA,0,0,0,1,1,6
HYVKAR,0,0,0,1,1,6
RRQELE,0,0,0,1,1,6
RQELEE,0,0,0,1,1,6
QELEEF,0,0,0,1,1,6
ELEEFS,0,0,0,1,1,6
LEEFSA,0,0,0,1,1,6
EEFSAA,0,0,0,1,1,6
EFSAAL,0,0,0,1,1,6
FSAALA,0,0,0,1,1,6
SAALAR,0,0,0,1,1,6
AALARR,0,0,0,1,1,6
RVIEGI,0,0,0,1,1,6
VIEGIK,0,0,0,1,1,6
IEGIKN,0,0,0,1,1,6
EGIKNV,0,0,0,1,1,6
GIKNVI,0,0,0,1,1,6
IKNVIP,0,0,0,1,1,6
KNVIPK,0,0,0,1,1,6
NVIPKL,0,0,0,1,1,6
VIPKLL,0,0,0,1,1,6
IPKLLT,0,0,0,1,1,6
PKLLTW,0,0,0,1,1,6
KLLTWW,0,0,0,1,1,6
LLTWWP,0,0,0,1,1,6
RVNAAI,0,0,0,1,1,6
VNAAIP,0,0,0,1,1,6
NAAIPN,0,0,0,1,1,6
AAIPNI,0,0,0,1,1,6
AIPNII,0,0,0,1,1,6
IPNIIV,0,0,0,1,1,6
RVWRWI,0,0,0,1,1,6
VWRWIV,0,0,0,1,1,6
WRWIVK,0,0,0,1,1,6
RWIVKW,0,0,0,1,1,6
WIVKWW,0,0,0,1,1,6
IVKWWL,0,0,0,1,1,6
VKWWLF,0,0,0,1,1,6
KWWLFV,0,0,0,1,1,6
RYGWRT,0,0,0,1,1,6
YGWRTA,0,0,0,1,1,6
GWRTAV,0,0,0,1,1,6
WRTAVD,0,0,0,1,1,6
RTAVDY,0,0,0,1,1,6
TAVDYS,0,0,0,1,1,6
AVDYSW,0,0,0,1,1,6
VDYSWF,0,0,0,1,1,6
DYSWFG,0,0,0,1,1,6
SAATAD,0,0,0,1,1,6
AATADF,0,0,0,1,1,6
ATADFV,0,0,0,1,1,6
TADFVA,0,0,0,1,1,6
ADFVAM,0,0,0,1,1,6
DFVAMT,0,0,0,1,1,6
FVAMTA,0,0,0,1,1,6
VAMTAM,0,0,0,1,1,6
AMTAMA,0,0,0,1,1,6
MTAMAA,0,0,0,1,1,6
TAMAAR,0,0,0,1,1,6
AMAARI,0,0,0,1,1,6
MAARIF,0,0,0,1,1,6
SAAWAE,0,0,0,1,1,6
AAWAEW,0,0,0,1,1,6
AWAEWQ,0,0,0,1,1,6
WAEWQK,0,0,0,1,1,6
AEWQKA,0,0,0,1,1,6
EWQKAR,0,0,0,1,1,6
SAEEMV,0,0,0,1,1,6
AEEMVQ,0,0,0,1,1,6
EEMVQT,0,0,0,1,1,6
EMVQTL,0,0,0,1,1,6
MVQTLV,0,0,0,1,1,6
VQTLVN,0,0,0,1,1,6
QTLVND,0,0,0,1,1,6
TLVNDY,0,0,0,1,1,6
LVNDYS,0,0,0,1,1,6
VNDYSA,0,0,0,1,1,6
NDYSAL,0,0,0,1,1,6
DYSALI,0,0,0,1,1,6
YSALIQ,0,0,0,1,1,6
SALIQE,0,0,0,1,1,6
ALIQEL,0,0,0,1,1,6
LIQELK,0,0,0,1,1,6
IQELKE,0,0,0,1,1,6
QELKEG,0,0,0,1,1,6
ELKEGM,0,0,0,1,1,6
LKEGME,0,0,0,1,1,6
KEGMEV,0,0,0,1,1,6
EGMEVA,0,0,0,1,1,6
GMEVAG,0,0,0,1,1,6
MEVAGE,0,0,0,1,1,6
EVAGEA,0,0,0,1,1,6
SANNII,0,0,0,1,1,6
ANNIIE,0,0,0,1,1,6
NNIIEE,0,0,0,1,1,6
NIIEEI,0,0,0,1,1,6
IIEEIQ,0,0,0,1,1,6
IEEIQM,0,0,0,1,1,6
EEIQMQ,0,0,0,1,1,6
EIQMQK,0,0,0,1,1,6
SASSQN,0,0,0,1,1,6
ASSQNA,0,0,0,1,1,6
SSQNAW,0,0,0,1,1,6
SQNAWL,0,0,0,1,1,6
QNAWLA,0,0,0,1,1,6
NAWLAA,0,0,0,1,1,6
AWLAAN,0,0,0,1,1,6
WLAANR,0,0,0,1,1,6
LAANRN,0,0,0,1,1,6
SAVKVL,0,0,0,1,1,6
AVKVLA,0,0,0,1,1,6
VKVLAE,0,0,0,1,1,6
KVLAEE,0,0,0,1,1,6
VLAEES,0,0,0,1,1,6
LAEESK,0,0,0,1,1,6
SDEFNT,0,0,0,1,1,6
DEFNTV,0,0,0,1,1,6
EFNTVA,0,0,0,1,1,6
FNTVAD,0,0,0,1,1,6
NTVADN,0,0,0,1,1,6
TVADNL,0,0,0,1,1,6
VADNLV,0,0,0,1,1,6
ADNLVT,0,0,0,1,1,6
DNLVTF,0,0,0,1,1,6
NLVTFG,0,0,0,1,1,6
LVTFGD,0,0,0,1,1,6
VTFGDS,0,0,0,1,1,6
TFGDSF,0,0,0,1,1,6
FGDSFL,0,0,0,1,1,6
GDSFLQ,0,0,0,1,1,6
DSFLQV,0,0,0,1,1,6
SFLQVI,0,0,0,1,1,6
FLQVIL,0,0,0,1,1,6
LQVILD,0,0,0,1,1,6
QVILDH,0,0,0,1,1,6
VILDHI,0,0,0,1,1,6
SDELSR,0,0,0,1,1,6
DELSRA,0,0,0,1,1,6
ELSRAW,0,0,0,1,1,6
LSRAWE,0,0,0,1,1,6
SRAWEV,0,0,0,1,1,6
RAWEVA,0,0,0,1,1,6
AWEVAY,0,0,0,1,1,6
WEVAYD,0,0,0,1,1,6
EVAYDE,0,0,0,1,1,6
VAYDEL,0,0,0,1,1,6
AYDELA,0,0,0,2,2,6
YDELAA,0,0,0,1,1,6
DELAAA,0,0,0,1,1,6
ELAAAI,0,0,0,1,1,6
LAAAIK,0,0,0,1,1,6
SDIFNK,0,0,0,1,1,6
DIFNKN,0,0,0,1,1,6
IFNKNM,0,0,0,1,1,6
FNKNMR,0,0,0,1,1,6
NKNMRA,0,0,0,1,1,6
KNMRAH,0,0,0,1,1,6
NMRAHA,0,0,0,1,1,6
MRAHAL,0,0,0,1,1,6
RAHALE,0,0,0,1,1,6
AHALEK,0,0,0,1,1,6
SDIKKL,0,0,0,1,1,6
DIKKLG,0,0,0,1,1,6
IKKLGS,0,0,0,1,1,6
KKLGSS,0,0,0,1,1,6
KLGSSW,0,0,0,1,1,6
LGSSWI,0,0,0,1,1,6
GSSWII,0,0,0,1,1,6
SSWIIN,0,0,0,1,1,6
SWIINW,0,0,0,1,1,6
WIINWF,0,0,0,1,1,6
IINWFF,0,0,0,1,1,6
INWFFG,0,0,0,1,1,6
SDSEIS,0,0,0,1,1,6
DSEIST,0,0,0,1,1,6
SEISTI,0,0,0,1,1,6
EISTIL,0,0,0,1,1,6
ISTILS,0,0,0,1,1,6
STILSD,0,0,0,1,1,6
TILSDV,0,0,0,1,1,6
ILSDVV,0,0,0,1,1,6
LSDVVT,0,0,0,1,1,6
SDVVTN,0,0,0,1,1,6
DVVTNE,0,0,0,1,1,6
VVTNER,0,0,0,1,1,6
SDWYLK,0,0,0,1,1,6
DWYLKG,0,0,0,1,1,6
WYLKGR,0,0,0,1,1,6
YLKGRL,0,0,0,1,1,6
LKGRLT,0,0,0,1,1,6
KGRLTS,0,0,0,1,1,6
GRLTSL,0,0,0,1,1,6
RLTSLE,0,0,0,1,1,6
LTSLES,0,0,0,1,1,6
TSLESQ,0,0,0,1,1,6
SLESQF,0,0,0,1,1,6
LESQFI,0,0,0,1,1,6
ESQFIN,0,0,0,1,1,6
SQFINA,0,0,0,1,1,6
QFINAL,0,0,0,1,1,6
FINALG,0,0,0,1,1,6
INALGI,0,0,0,1,1,6
NALGIL,0,0,0,1,1,6
ALGILE,0,0,0,1,1,6
LGILET,0,0,0,1,1,6
SEAAKA,0,0,0,1,1,6
EAAKAY,0,0,0,1,1,6
AAKAYM,0,0,0,1,1,6
AKAYMK,0,0,0,1,1,6
KAYMKG,0,0,0,1,1,6
AYMKGL,0,0,0,1,1,6
YMKGLE,0,0,0,1,1,6
MKGLEY,0,0,0,1,1,6
KGLEYQ,0,0,0,1,1,6
GLEYQM,0,0,0,1,1,6
LEYQMS,0,0,0,1,1,6
EYQMSG,0,0,0,1,1,6
YQMSGN,0,0,0,1,1,6
QMSGNE,0,0,0,1,1,6
MSGNEQ,0,0,0,1,1,6
SGNEQW,0,0,0,1,1,6
GNEQWS,0,0,0,1,1,6
NEQWSK,0,0,0,1,1,6
EQWSKT,0,0,0,1,1,6
SEEEEN,0,0,0,1,1,6
EEEENN,0,0,0,1,1,6
EEENNV,0,0,0,1,1,6
EENNVI,0,0,0,1,1,6
ENNVIE,0,0,0,1,1,6
NNVIEQ,0,0,0,1,1,6
NVIEQA,0,0,0,1,1,6
VIEQAK,0,0,0,1,1,6
IEQAKE,0,0,0,1,1,6
EQAKEE,0,0,0,1,1,6
QAKEEI,0,0,0,1,1,6
AKEEIK,0,0,0,1,1,6
KEEIKE,0,0,0,1,1,6
EEIKEA,0,0,0,1,1,6
EIKEAI,0,0,0,1,1,6
IKEAIK,0,0,0,1,1,6
KEAIKK,0,0,0,1,1,6
EAIKKA,0,0,0,1,1,6
AIKKAD,0,0,0,1,1,6
IKKADE,0,0,0,1,1,6
KKADET,0,0,0,1,1,6
SEELNS,0,0,0,1,1,6
EELNSA,0,0,0,1,1,6
ELNSAW,0,0,0,1,1,6
LNSAWT,0,0,0,1,1,6
NSAWTI,0,0,0,1,1,6
SAWTIA,0,0,0,1,1,6
AWTIAY,0,0,0,1,1,6
WTIAYD,0,0,0,1,1,6
TIAYDE,0,0,0,1,1,6
IAYDEL,0,0,0,1,1,6
YDELAI,0,0,0,1,1,6
DELAIV,0,0,0,1,1,6
ELAIVI,0,0,0,1,1,6
LAIVIK,0,0,0,1,1,6
AIVIKK,0,0,0,1,1,6
IVIKKE,0,0,0,1,1,6
VIKKEM,0,0,0,1,1,6
IKKEMD,0,0,0,1,1,6
KKEMDD,0,0,0,1,1,6
KEMDDA,0,0,0,1,1,6
SEERIR,0,0,0,1,1,6
EERIRS,0,0,0,1,1,6
ERIRSG,0,0,0,1,1,6
RIRSGV,0,0,0,1,1,6
IRSGVK,0,0,0,1,1,6
RSGVKR,0,0,0,1,1,6
SGVKRL,0,0,0,1,1,6
GVKRLS,0,0,0,1,1,6
VKRLSK,0,0,0,1,1,6
KRLSKS,0,0,0,1,1,6
RLSKSR,0,0,0,1,1,6
LSKSRQ,0,0,0,1,1,6
SEEVLA,0,0,0,1,1,6
EEVLAM,0,0,0,1,1,6
EVLAMV,0,0,0,1,1,6
VLAMVS,0,0,0,1,1,6
LAMVSR,0,0,0,1,1,6
AMVSRK,0,0,0,1,1,6
MVSRKM,0,0,0,1,1,6
SEEYIQ,0,0,0,1,1,6
EEYIQL,0,0,0,1,1,6
EYIQLL,0,0,0,1,1,6
YIQLLK,0,0,0,1,1,6
IQLLKK,0,0,0,1,1,6
QLLKKL,0,0,0,1,1,6
LLKKLI,0,0,0,1,1,6
SEREAV,0,0,0,1,1,6
EREAVE,0,0,0,1,1,6
REAVEI,0,0,0,1,1,6
EAVEII,0,0,0,1,1,6
AVEIIK,0,0,0,1,1,6
VEIIKK,0,0,0,1,1,6
EIIKKN,0,0,0,1,1,6
SESAVS,0,0,0,1,1,6
ESAVSH,0,0,0,1,1,6
SAVSHQ,0,0,0,1,1,6
AVSHQL,0,0,0,1,1,6
VSHQLR,0,0,0,1,1,6
SHQLRS,0,0,0,1,1,6
HQLRSL,0,0,0,1,1,6
QLRSLR,0,0,0,1,1,6
LRSLRN,0,0,0,1,1,6
RSLRNL,0,0,0,1,1,6
SESKLI,0,0,0,1,1,6
ESKLIE,0,0,0,1,1,6
SKLIEQ,0,0,0,1,1,6
KLIEQA,0,0,0,1,1,6
LIEQAF,0,0,0,1,1,6
IEQAFR,0,0,0,1,1,6
SFADFK,0,0,0,1,1,6
FADFKA,0,0,0,1,1,6
ADFKAQ,0,0,0,1,1,6
DFKAQF,0,0,0,1,1,6
FKAQFT,0,0,0,1,1,6
KAQFTD,0,0,0,1,1,6
AQFTDA,0,0,0,1,1,6
QFTDAA,0,0,0,1,1,6
FTDAAI,0,0,0,1,1,6
TDAAIK,0,0,0,1,1,6
DAAIKN,0,0,0,1,1,6
SFDRVM,0,0,0,1,1,6
FDRVMN,0,0,0,1,1,6
DRVMNA,0,0,0,1,1,6
RVMNAI,0,0,0,1,1,6
VMNAIE,0,0,0,1,1,6
MNAIEE,0,0,0,1,1,6
NAIEEN,0,0,0,1,1,6
SFSRII,0,0,0,1,1,6
FSRIIS,0,0,0,1,1,6
SRIISE,0,0,0,1,1,6
RIISEL,0,0,0,1,1,6
IISELG,0,0,0,1,1,6
ISELGT,0,0,0,1,1,6
SELGTR,0,0,0,1,1,6
ELGTRD,0,0,0,1,1,6
SGARRV,0,0,0,1,1,6
GARRVR,0,0,0,1,1,6
ARRVRI,0,0,0,1,1,6
RRVRIA,0,0,0,1,1,6
RVRIAQ,0,0,0,1,1,6
VRIAQT,0,0,0,1,1,6
RIAQTL,0,0,0,1,1,6
IAQTLT,0,0,0,1,1,6
AQTLTE,0,0,0,1,1,6
QTLTEN,0,0,0,1,1,6
SGDELY,0,0,0,1,1,6
GDELYE,0,0,0,1,1,6
DELYEL,0,0,0,1,1,6
ELYELL,0,0,0,1,1,6
LYELLQ,0,0,0,1,1,6
YELLQH,0,0,0,1,1,6
ELLQHI,0,0,0,1,1,6
LLQHIL,0,0,0,1,1,6
LQHILK,0,0,0,1,1,6
QHILKQ,0,0,0,1,1,6
HILKQR,0,0,0,1,1,6
ILKQRD,0,0,0,1,1,6
LKQRDH,0,0,0,1,1,6
KQRDHH,0,0,0,1,1,6
QRDHHH,0,0,0,1,1,6
RDHHHH,0,0,0,1,1,6
DHHHHH,0,0,0,1,1,6
SGPAYV,0,0,0,1,1,6
GPAYVF,0,0,0,1,1,6
PAYVFY,0,0,0,1,1,6
AYVFYL,0,0,0,1,1,6
YVFYLL,0,0,0,1,1,6
VFYLLD,0,0,0,1,1,6
FYLLDA,0,0,0,1,1,6
YLLDAL,0,0,0,1,1,6
LLDALQ,0,0,0,1,1,6
LDALQN,0,0,0,1,1,6
DALQNA,0,0,0,1,1,6
ALQNAA,0,0,0,1,1,6
LQNAAI,0,0,0,1,1,6
QNAAIR,0,0,0,1,1,6
NAAIRQ,0,0,0,1,1,6
SGRFWK,0,0,0,1,1,6
GRFWKL,0,0,0,1,1,6
RFWKLY,0,0,0,1,1,6
FWKLYI,0,0,0,1,1,6
WKLYIE,0,0,0,1,1,6
KLYIEA,0,0,0,1,1,6
LYIEAE,0,0,0,1,1,6
YIEAEI,0,0,0,1,1,6
IEAEIK,0,0,0,1,1,6
EAEIKA,0,0,0,1,1,6
SGTIKA,0,0,0,1,1,6
GTIKAA,0,0,0,1,1,6
TIKAAH,0,0,0,1,1,6
IKAAHE,0,0,0,1,1,6
KAAHEV,0,0,0,1,1,6
AAHEVL,0,0,0,1,1,6
AHEVLM,0,0,0,1,1,6
HEVLME,0,0,0,1,1,6
EVLMEM,0,0,0,1,1,6
VLMEMG,0,0,0,1,1,6
SHAQDI,0,0,0,1,1,6
HAQDIY,0,0,0,1,1,6
AQDIYK,0,0,0,1,1,6
QDIYKE,0,0,0,1,1,6
DIYKEA,0,0,0,1,1,6
IYKEAF,0,0,0,1,1,6
YKEAFN,0,0,0,1,1,6
KEAFNS,0,0,0,1,1,6
EAFNSA,0,0,0,1,1,6
AFNSAW,0,0,0,1,1,6
FNSAWD,0,0,0,1,1,6
NSAWDQ,0,0,0,1,1,6
SAWDQY,0,0,0,1,1,6
SIDEKY,0,0,0,1,1,6
IDEKYE,0,0,0,1,1,6
DEKYEA,0,0,0,1,1,6
EKYEAE,0,0,0,1,1,6
KYEAEV,0,0,0,1,1,6
YEAEVK,0,0,0,1,1,6
EAEVKK,0,0,0,1,1,6
AEVKKS,0,0,0,1,1,6
EVKKSE,0,0,0,1,1,6
VKKSEI,0,0,0,1,1,6
KKSEID,0,0,0,1,1,6
KSEIDH,0,0,0,1,1,6
SEIDHH,0,0,0,1,1,6
EIDHHK,0,0,0,1,1,6
SIERLL,0,0,0,1,1,6
IERLLE,0,0,0,1,1,6
ERLLEM,0,0,0,1,1,6
RLLEME,0,0,0,1,1,6
LLEMES,0,0,0,1,1,6
LEMESL,0,0,0,1,1,6
SIPHLA,0,0,0,1,1,6
IPHLAN,0,0,0,1,1,6
PHLANL,0,0,0,1,1,6
HLANLL,0,0,0,1,1,6
LANLLI,0,0,0,1,1,6
ANLLIE,0,0,0,1,1,6
NLLIER,0,0,0,1,1,6
LLIERS,0,0,0,1,1,6
LIERSQ,0,0,0,1,1,6
SISRYK,0,0,0,1,1,6
ISRYKT,0,0,0,1,1,6
SRYKTI,0,0,0,1,1,6
RYKTIE,0,0,0,1,1,6
YKTIEW,0,0,0,1,1,6
KTIEWL,0,0,0,1,1,6
TIEWLN,0,0,0,1,1,6
IEWLNY,0,0,0,1,1,6
EWLNYI,0,0,0,1,1,6
WLNYIA,0,0,0,1,1,6
LNYIAT,0,0,0,1,1,6
NYIATE,0,0,0,1,1,6
YIATEL,0,0,0,1,1,6
SKDALM,0,0,0,1,1,6
KDALML,0,0,0,1,1,6
DALMLE,0,0,0,1,1,6
ALMLEA,0,0,0,1,1,6
LMLEAF,0,0,0,1,1,6
MLEAFE,0,0,0,1,1,6
LEAFEQ,0,0,0,1,1,6
EAFEQL,0,0,0,1,1,6
AFEQLL,0,0,0,1,1,6
FEQLLG,0,0,0,1,1,6
EQLLGK,0,0,0,1,1,6
QLLGKR,0,0,0,1,1,6
LLGKRR,0,0,0,1,1,6
LGKRRE,0,0,0,1,1,6
GKRREL,0,0,0,1,1,6
KRRELL,0,0,0,1,1,6
RRELLG,0,0,0,1,1,6
RELLGE,0,0,0,1,1,6
SKDLAQ,0,0,0,1,1,6
KDLAQT,0,0,0,1,1,6
DLAQTS,0,0,0,1,1,6
LAQTSY,0,0,0,1,1,6
AQTSYF,0,0,0,1,1,6
QTSYFM,0,0,0,1,1,6
TSYFMA,0,0,0,1,1,6
SYFMAT,0,0,0,1,1,6
YFMATN,0,0,0,1,1,6
FMATNS,0,0,0,1,1,6
MATNSL,0,0,0,1,1,6
ATNSLH,0,0,0,1,1,6
TNSLHL,0,0,0,1,1,6
NSLHLT,0,0,0,1,1,6
SKEDID,0,0,0,1,1,6
KEDIDT,0,0,0,1,1,6
EDIDTA,0,0,0,1,1,6
DIDTAM,0,0,0,1,1,6
IDTAMK,0,0,0,1,1,6
DTAMKL,0,0,0,1,1,6
TAMKLG,0,0,0,1,1,6
AMKLGA,0,0,0,1,1,6
MKLGAG,0,0,0,1,1,6
SKEDVE,0,0,0,1,1,6
KEDVER,0,0,0,1,1,6
EDVERV,0,0,0,1,1,6
DVERVK,0,0,0,1,1,6
VERVKL,0,0,0,1,1,6
ERVKLR,0,0,0,1,1,6
RVKLRI,0,0,0,1,1,6
VKLRIN,0,0,0,1,1,6
KLRINL,0,0,0,1,1,6
LRINLA,0,0,0,1,1,6
RINLAR,0,0,0,1,1,6
INLARN,0,0,0,1,1,6
NLARNW,0,0,0,1,1,6
LARNWV,0,0,0,1,1,6
ARNWVK,0,0,0,1,1,6
RNWVKK,0,0,0,1,1,6
NWVKKY,0,0,0,1,1,6
SKEEQR,0,0,0,1,1,6
KEEQRD,0,0,0,1,1,6
EEQRDY,0,0,0,1,1,6
EQRDYV,0,0,0,1,1,6
QRDYVF,0,0,0,1,1,6
RDYVFY,0,0,0,1,1,6
DYVFYL,0,0,0,1,1,6
YVFYLA,0,0,0,1,1,6
VFYLAV,0,0,0,1,1,6
FYLAVG,0,0,0,1,1,6
YLAVGN,0,0,0,1,1,6
LAVGNY,0,0,0,1,1,6
AVGNYR,0,0,0,1,1,6
VGNYRL,0,0,0,1,1,6
SKIQKE,0,0,0,1,1,6
KIQKEL,0,0,0,1,1,6
IQKELV,0,0,0,1,1,6
QKELVA,0,0,0,1,1,6
KELVAI,0,0,0,1,1,6
ELVAIM,0,0,0,1,1,6
LVAIMN,0,0,0,1,1,6
SKPIQN,0,0,0,1,1,6
KPIQNV,0,0,0,1,1,6
PIQNVE,0,0,0,1,1,6
IQNVES,0,0,0,1,1,6
QNVESG,0,0,0,1,1,6
NVESGF,0,0,0,1,1,6
VESGFI,0,0,0,1,1,6
ESGFIF,0,0,0,1,1,6
SGFIFA,0,0,0,1,1,6
GFIFAL,0,0,0,1,1,6
FIFALV,0,0,0,1,1,6
IFALVS,0,0,0,1,1,6
SKYLKS,0,0,0,1,1,6
KYLKSL,0,0,0,1,1,6
YLKSLL,0,0,0,1,1,6
LKSLLS,0,0,0,1,1,6
KSLLSL,0,0,0,1,1,6
SLLSLM,0,0,0,1,1,6
SKYRLT,0,0,0,1,1,6
KYRLTV,0,0,0,1,1,6
YRLTVV,0,0,0,1,1,6
RLTVVV,0,0,0,1,1,6
LTVVVA,0,0,0,1,1,6
TVVVAK,0,0,0,1,1,6
VVVAKR,0,0,0,1,1,6
VVAKRA,0,0,0,1,1,6
VAKRAQ,0,0,0,1,1,6
AKRAQQ,0,0,0,1,1,6
KRAQQL,0,0,0,1,1,6
RAQQLL,0,0,0,1,1,6
AQQLLR,0,0,0,1,1,6
QQLLRH,0,0,0,1,1,6
SLAEAL,0,0,0,1,1,6
LAEALG,0,0,0,1,1,6
AEALGW,0,0,0,1,1,6
EALGWL,0,0,0,1,1,6
ALGWLF,0,0,0,1,1,6
LGWLFV,0,0,0,1,1,6
GWLFVS,0,0,0,1,1,6
WLFVSE,0,0,0,1,1,6
LFVSEG,0,0,0,1,1,6
FVSEGS,0,0,0,1,1,6
SLEQQF,0,0,0,1,1,6
LEQQFS,0,0,0,1,1,6
EQQFSI,0,0,0,1,1,6
QQFSIR,0,0,0,1,1,6
QFSIRS,0,0,0,1,1,6
FSIRSF,0,0,0,1,1,6
SIRSFA,0,0,0,1,1,6
IRSFAT,0,0,0,1,1,6
RSFATQ,0,0,0,1,1,6
SFATQV,0,0,0,1,1,6
FATQVQ,0,0,0,1,1,6
ATQVQN,0,0,0,1,1,6
TQVQNM,0,0,0,1,1,6
SLESLI,0,0,0,1,1,6
LESLID,0,0,0,1,1,6
ESLIDM,0,0,0,1,1,6
SLIDMI,0,0,0,1,1,6
LIDMIT,0,0,0,1,1,6
IDMITS,0,0,0,1,1,6
DMITSI,0,0,0,1,1,6
SLKDQL,0,0,0,1,1,6
LKDQLA,0,0,0,1,1,6
KDQLAL,0,0,0,1,1,6
DQLALA,0,0,0,1,1,6
QLALAI,0,0,0,1,1,6
LALAIG,0,0,0,1,1,6
ALAIGK,0,0,0,1,1,6
LAIGKL,0,0,0,1,1,6
AIGKLG,0,0,0,1,1,6
SLLPTL,0,0,0,1,1,6
LLPTLS,0,0,0,1,1,6
LPTLSA,0,0,0,1,1,6
PTLSAI,0,0,0,1,1,6
TLSAIA,0,0,0,1,1,6
LSAIAE,0,0,0,1,1,6
SAIAEL,0,0,0,1,1,6
SLPEMF,0,0,0,1,1,6
LPEMFD,0,0,0,1,1,6
PEMFDK,0,0,0,1,1,6
EMFDKM,0,0,0,1,1,6
MFDKMR,0,0,0,1,1,6
FDKMRP,0,0,0,1,1,6
DKMRPY,0,0,0,1,1,6
KMRPYY,0,0,0,1,1,6
MRPYYE,0,0,0,1,1,6
RPYYEE,0,0,0,1,1,6
PYYEES,0,0,0,1,1,6
YYEESK,0,0,0,1,1,6
YEESKK,0,0,0,1,1,6
EESKKR,0,0,0,1,1,6
ESKKRV,0,0,0,1,1,6
SKKRVK,0,0,0,1,1,6
KKRVKE,0,0,0,1,1,6
SMDHRI,0,0,0,1,1,6
MDHRIE,0,0,0,1,1,6
DHRIER,0,0,0,1,1,6
HRIERL,0,0,0,1,1,6
RIERLE,0,0,0,1,1,6
IERLEY,0,0,0,1,1,6
ERLEYY,0,0,0,1,1,6
RLEYYI,0,0,0,1,1,6
LEYYIQ,0,0,0,1,1,6
EYYIQL,0,0,0,1,1,6
YYIQLL,0,0,0,1,1,6
YIQLLV,0,0,0,1,1,6
IQLLVK,0,0,0,1,1,6
SNEQRQ,0,0,0,1,1,6
NEQRQD,0,0,0,1,1,6
EQRQDI,0,0,0,1,1,6
QRQDIA,0,0,0,1,1,6
RQDIAF,0,0,0,1,1,6
QDIAFA,0,0,0,1,1,6
DIAFAY,0,0,0,1,1,6
IAFAYQ,0,0,0,1,1,6
AFAYQR,0,0,0,1,1,6
FAYQRR,0,0,0,1,1,6
AYQRRT,0,0,0,1,1,6
YQRRTK,0,0,0,1,1,6
SNEVMR,0,0,0,1,1,6
NEVMRI,0,0,0,1,1,6
EVMRIL,0,0,0,1,1,6
VMRILI,0,0,0,1,1,6
MRILIS,0,0,0,1,1,6
RILISR,0,0,0,1,1,6
ILISRS,0,0,0,1,1,6
LISRSL,0,0,0,1,1,6
ISRSLL,0,0,0,1,1,6
SRSLLQ,0,0,0,1,1,6
RSLLQE,0,0,0,1,1,6
SNTELQ,0,0,0,1,1,6
NTELQA,0,0,0,1,1,6
TELQAV,0,0,0,1,1,6
ELQAVD,0,0,0,1,1,6
LQAVDG,0,0,0,1,1,6
QAVDGR,0,0,0,1,1,6
AVDGRF,0,0,0,1,1,6
VDGRFK,0,0,0,1,1,6
DGRFKR,0,0,0,1,1,6
GRFKRA,0,0,0,1,1,6
RFKRAV,0,0,0,1,1,6
FKRAVA,0,0,0,1,1,6
KRAVAS,0,0,0,1,1,6
RAVASM,0,0,0,1,1,6
AVASME,0,0,0,1,1,6
VASMEA,0,0,0,1,1,6
ASMEAA,0,0,0,1,1,6
SMEAAR,0,0,0,1,1,6
MEAARA,0,0,0,1,1,6
EAARAL,0,0,0,1,1,6
AARALT,0,0,0,1,1,6
ARALTN,0,0,0,1,1,6
RALTNN,0,0,0,1,1,6
SPAEVR,0,0,0,1,1,6
PAEVRD,0,0,0,1,1,6
AEVRDL,0,0,0,1,1,6
EVRDLD,0,0,0,1,1,6
VRDLDF,0,0,0,1,1,6
RDLDFA,0,0,0,1,1,6
DLDFAN,0,0,0,1,1,6
LDFAND,0,0,0,1,1,6
DFANDA,0,0,0,1,1,6
FANDAS,0,0,0,1,1,6
ANDASK,0,0,0,1,1,6
NDASKV,0,0,0,1,1,6
DASKVL,0,0,0,1,1,6
ASKVLG,0,0,0,1,1,6
SKVLGS,0,0,0,1,1,6
KVLGSI,0,0,0,1,1,6
VLGSIA,0,0,0,1,1,6
LGSIAG,0,0,0,1,1,6
GSIAGK,0,0,0,1,1,6
SIAGKL,0,0,0,1,1,6
IAGKLE,0,0,0,1,1,6
AGKLEK,0,0,0,1,1,6
SPAQAE,0,0,0,1,1,6
PAQAEA,0,0,0,1,1,6
AQAEAL,0,0,0,1,1,6
QAEALG,0,0,0,1,1,6
AEALGV,0,0,0,1,1,6
EALGVW,0,0,0,1,1,6
ALGVWR,0,0,0,1,1,6
LGVWRR,0,0,0,1,1,6
GVWRRY,0,0,0,1,1,6
VWRRYR,0,0,0,1,1,6
WRRYRA,0,0,0,1,1,6
RRYRAY,0,0,0,1,1,6
RYRAYF,0,0,0,1,1,6
YRAYFD,0,0,0,1,1,6
RAYFDA,0,0,0,1,1,6
SPAVID,0,0,0,1,1,6
PAVIDY,0,0,0,1,1,6
AVIDYV,0,0,0,1,1,6
VIDYVN,0,0,0,1,1,6
IDYVNR,0,0,0,1,1,6
DYVNRL,0,0,0,1,1,6
YVNRLE,0,0,0,1,1,6
VNRLEE,0,0,0,1,1,6
NRLEEI,0,0,0,1,1,6
RLEEIR,0,0,0,1,1,6
LEEIRD,0,0,0,1,1,6
EEIRDN,0,0,0,1,1,6
EIRDNV,0,0,0,1,1,6
SPAVQM,0,0,0,1,1,6
PAVQMK,0,0,0,1,1,6
AVQMKI,0,0,0,1,1,6
VQMKIK,0,0,0,1,1,6
QMKIKE,0,0,0,1,1,6
MKIKEL,0,0,0,1,1,6
KIKELY,0,0,0,1,1,6
IKELYR,0,0,0,1,1,6
KELYRR,0,0,0,1,1,6
ELYRRR,0,0,0,1,1,6
SPEEAA,0,0,0,1,1,6
PEEAAA,0,0,0,1,1,6
EEAAAL,0,0,0,1,1,6
EAAALV,0,0,0,1,1,6
AAALVD,0,0,0,1,1,6
AALVDG,0,0,0,1,1,6
ALVDGL,0,0,0,1,1,6
LVDGLR,0,0,0,1,1,6
SPEEKE,0,0,0,1,1,6
PEEKEE,0,0,0,1,1,6
EEKEEW,0,0,0,1,1,6
EKEEWM,0,0,0,1,1,6
KEEWMK,0,0,0,1,1,6
EEWMKS,0,0,0,1,1,6
EWMKSI,0,0,0,1,1,6
WMKSIK,0,0,0,1,1,6
MKSIKA,0,0,0,1,1,6
KSIKAS,0,0,0,1,1,6
SIKASI,0,0,0,1,1,6
IKASIS,0,0,0,1,1,6
KASISR,0,0,0,1,1,6
SPEHRQ,0,0,0,1,1,6
PEHRQE,0,0,0,1,1,6
EHRQEL,0,0,0,1,1,6
HRQELI,0,0,0,1,1,6
RQELIE,0,0,0,1,1,6
QELIER,0,0,0,1,1,6
SPEIAS,0,0,0,1,1,6
PEIASG,0,0,0,1,1,6
EIASGL,0,0,0,1,1,6
IASGLK,0,0,0,1,1,6
ASGLKK,0,0,0,1,1,6
SGLKKL,0,0,0,1,1,6
GLKKLI,0,0,0,1,1,6
LKKLIR,0,0,0,1,1,6
KKLIRE,0,0,0,1,1,6
SPEQMQ,0,0,0,1,1,6
PEQMQV,0,0,0,1,1,6
EQMQVL,0,0,0,1,1,6
QMQVLL,0,0,0,1,1,6
MQVLLD,0,0,0,1,1,6
QVLLDQ,0,0,0,1,1,6
VLLDQA,0,0,0,1,1,6
LLDQAG,0,0,0,1,1,6
SPEVVV,0,0,0,1,1,6
PEVVVA,0,0,0,1,1,6
EVVVAR,0,0,0,1,1,6
VVVARG,0,0,0,1,1,6
VVARGE,0,0,0,1,1,6
VARGEQ,0,0,0,1,1,6
ARGEQE,0,0,0,1,1,6
SPKEAY,0,0,0,1,1,6
PKEAYA,0,0,0,1,1,6
KEAYAY,0,0,0,1,1,6
EAYAYL,0,0,0,1,1,6
AYAYLE,0,0,0,1,1,6
YAYLEK,0,0,0,1,1,6
AYLEKL,0,0,0,1,1,6
YLEKLR,0,0,0,1,1,6
LEKLRS,0,0,0,1,1,6
EKLRSI,0,0,0,1,1,6
KLRSII,0,0,0,1,1,6
LRSIIQ,0,0,0,1,1,6
RSIIQY,0,0,0,1,1,6
SIIQYT,0,0,0,1,1,6
IIQYTG,0,0,0,1,1,6
SPKESE,0,0,0,1,1,6
PKESEV,0,0,0,1,1,6
KESEVL,0,0,0,1,1,6
ESEVLR,0,0,0,1,1,6
SEVLRL,0,0,0,1,1,6
EVLRLF,0,0,0,1,1,6
VLRLFA,0,0,0,1,1,6
LRLFAE,0,0,0,1,1,6
RLFAEG,0,0,0,1,1,6
SPKSTY,0,0,0,1,1,6
PKSTYS,0,0,0,1,1,6
KSTYSY,0,0,0,1,1,6
STYSYW,0,0,0,1,1,6
TYSYWA,0,0,0,1,1,6
YSYWAS,0,0,0,1,1,6
SYWASV,0,0,0,1,1,6
YWASVL,0,0,0,1,1,6
WASVLN,0,0,0,1,1,6
SPSKSL,0,0,0,1,1,6
PSKSLQ,0,0,0,1,1,6
SKSLQM,0,0,0,1,1,6
KSLQMI,0,0,0,1,1,6
SLQMIL,0,0,0,1,1,6
LQMILR,0,0,0,1,1,6
QMILRR,0,0,0,1,1,6
MILRRA,0,0,0,1,1,6
ILRRAL,0,0,0,1,1,6
LRRALG,0,0,0,1,1,6
RRALGD,0,0,0,1,1,6
RALGDF,0,0,0,1,1,6
ALGDFE,0,0,0,1,1,6
LGDFEN,0,0,0,1,1,6
GDFENM,0,0,0,1,1,6
DFENML,0,0,0,1,1,6
FENMLA,0,0,0,1,1,6
ENMLAD,0,0,0,1,1,6
SPVVIK,0,0,0,1,1,6
PVVIKK,0,0,0,1,1,6
VVIKKR,0,0,0,1,1,6
VIKKRI,0,0,0,1,1,6
IKKRIE,0,0,0,1,1,6
KKRIEG,0,0,0,1,1,6
KRIEGL,0,0,0,1,1,6
RIEGLI,0,0,0,1,1,6
IEGLIE,0,0,0,1,1,6
EGLIER,0,0,0,1,1,6
SQESIN,0,0,0,1,1,6
QESINQ,0,0,0,1,1,6
ESINQL,0,0,0,1,1,6
SINQLV,0,0,0,1,1,6
INQLVY,0,0,0,1,1,6
NQLVYM,0,0,0,1,1,6
QLVYMG,0,0,0,1,1,6
SQRQRD,0,0,0,1,1,6
QRQRDE,0,0,0,1,1,6
RQRDEL,0,0,0,1,1,6
QRDELN,0,0,0,1,1,6
RDELNR,0,0,0,1,1,6
DELNRA,0,0,0,1,1,6
ELNRAI,0,0,0,1,1,6
LNRAIA,0,0,0,1,1,6
NRAIAD,0,0,0,1,1,6
RAIADY,0,0,0,1,1,6
AIADYL,0,0,0,1,1,6
IADYLR,0,0,0,1,1,6
ADYLRS,0,0,0,1,1,6
DYLRSN,0,0,0,1,1,6
SRAITQ,0,0,0,1,1,6
RAITQY,0,0,0,1,1,6
AITQYI,0,0,0,1,1,6
ITQYIA,0,0,0,1,1,6
TQYIAH,0,0,0,1,1,6
QYIAHR,0,0,0,1,1,6
SRAKAS,0,0,0,1,1,6
RAKASF,0,0,0,1,1,6
AKASFD,0,0,0,1,1,6
KASFDT,0,0,0,1,1,6
ASFDTR,0,0,0,1,1,6
SFDTRV,0,0,0,1,1,6
FDTRVA,0,0,0,1,1,6
DTRVAA,0,0,0,1,1,6
TRVAAA,0,0,0,1,1,6
RVAAAE,0,0,0,1,1,6
VAAAEL,0,0,0,1,1,6
AAAELA,0,0,0,1,1,6
AAELAL,0,0,0,1,1,6
AELALN,0,0,0,1,1,6
ELALNR,0,0,0,1,1,6
SRDLQE,0,0,0,1,1,6
RDLQEK,0,0,0,1,1,6
DLQEKY,0,0,0,1,1,6
LQEKYE,0,0,0,1,1,6
QEKYER,0,0,0,1,1,6
EKYERH,0,0,0,1,1,6
KYERHM,0,0,0,1,1,6
YERHME,0,0,0,1,1,6
ERHMEK,0,0,0,1,1,6
RHMEKL,0,0,0,1,1,6
HMEKLI,0,0,0,1,1,6
MEKLIE,0,0,0,1,1,6
EKLIEL,0,0,0,1,1,6
KLIELA,0,0,0,1,1,6
LIELAN,0,0,0,1,1,6
IELANK,0,0,0,1,1,6
ELANKE,0,0,0,1,1,6
LANKEV,0,0,0,1,1,6
ANKEVE,0,0,0,1,1,6
NKEVER,0,0,0,1,1,6
KEVERT,0,0,0,1,1,6
SRKALT,0,0,0,1,1,6
RKALTE,0,0,0,1,1,6
KALTEG,0,0,0,1,1,6
ALTEGN,0,0,0,1,1,6
LTEGNI,0,0,0,1,1,6
TEGNIM,0,0,0,1,1,6
EGNIMA,0,0,0,1,1,6
GNIMAV,0,0,0,1,1,6
NIMAVQ,0,0,0,1,1,6
IMAVQA,0,0,0,1,1,6
MAVQAM,0,0,0,1,1,6
AVQAMA,0,0,0,1,1,6
VQAMAY,0,0,0,1,1,6
QAMAYF,0,0,0,1,1,6
AMAYFK,0,0,0,1,1,6
MAYFKE,0,0,0,1,1,6
AYFKEL,0,0,0,1,1,6
YFKELI,0,0,0,1,1,6
FKELIQ,0,0,0,1,1,6
KELIQK,0,0,0,1,1,6
ELIQKR,0,0,0,1,1,6
LIQKRK,0,0,0,1,1,6
IQKRKR,0,0,0,1,1,6
QKRKRH,0,0,0,1,1,6
SRPLHI,0,0,0,1,1,6
RPLHIS,0,0,0,1,1,6
PLHIST,0,0,0,1,1,6
LHISTF,0,0,0,1,1,6
HISTFI,0,0,0,1,1,6
ISTFIN,0,0,0,1,1,6
STFINE,0,0,0,1,1,6
TFINEL,0,0,0,1,1,6
FINELD,0,0,0,1,1,6
INELDS,0,0,0,1,1,6
NELDSG,0,0,0,1,1,6
ELDSGF,0,0,0,1,1,6
LDSGFR,0,0,0,1,1,6
DSGFRL,0,0,0,1,1,6
SGFRLL,0,0,0,1,1,6
SRWGVL,0,0,0,1,1,6
RWGVLI,0,0,0,1,1,6
WGVLIL,0,0,0,1,1,6
GVLILV,0,0,0,1,1,6
VLILVA,0,0,0,1,1,6
LILVAL,0,0,0,1,1,6
SSAVSR,0,0,0,1,1,6
SAVSRI,0,0,0,1,1,6
AVSRII,0,0,0,1,1,6
VSRIIS,0,0,0,1,1,6
SRIISK,0,0,0,1,1,6
RIISKL,0,0,0,1,1,6
IISKLK,0,0,0,1,1,6
ISKLKQ,0,0,0,1,1,6
SSQNWQ,0,0,0,1,1,6
SQNWQR,0,0,0,1,1,6
QNWQRF,0,0,0,1,1,6
NWQRFY,0,0,0,1,1,6
WQRFYQ,0,0,0,1,1,6
QRFYQL,0,0,0,1,1,6
RFYQLT,0,0,0,1,1,6
FYQLTK,0,0,0,1,1,6
YQLTKL,0,0,0,1,1,6
QLTKLL,0,0,0,1,1,6
LTKLLD,0,0,0,1,1,6
TKLLDS,0,0,0,1,1,6
KLLDSM,0,0,0,1,1,6
LLDSMH,0,0,0,1,1,6
LDSMHE,0,0,0,1,1,6
DSMHEV,0,0,0,1,1,6
SMHEVV,0,0,0,1,1,6
MHEVVE,0,0,0,1,1,6
HEVVEN,0,0,0,1,1,6
EVVENL,0,0,0,1,1,6
VVENLL,0,0,0,1,1,6
SSREWF,0,0,0,1,1,6
SREWFS,0,0,0,1,1,6
REWFST,0,0,0,1,1,6
EWFSTL,0,0,0,1,1,6
WFSTLY,0,0,0,1,1,6
FSTLYR,0,0,0,1,1,6
STLYRL,0,0,0,1,1,6
TLYRLF,0,0,0,1,1,6
LYRLFI,0,0,0,1,1,6
YRLFIG,0,0,0,1,1,6
STATFY,0,0,0,1,1,6
TATFYD,0,0,0,1,1,6
ATFYDA,0,0,0,1,1,6
TFYDAK,0,0,0,1,1,6
FYDAKK,0,0,0,1,1,6
YDAKKF,0,0,0,1,1,6
DAKKFL,0,0,0,1,1,6
AKKFLI,0,0,0,1,1,6
KKFLIQ,0,0,0,1,1,6
KFLIQE,0,0,0,1,1,6
STEVVA,0,0,0,1,1,6
TEVVAL,0,0,0,1,1,6
EVVALS,0,0,0,1,1,6
VVALSR,0,0,0,1,1,6
VALSRL,0,0,0,1,1,6
ALSRLQ,0,0,0,1,1,6
LSRLQG,0,0,0,1,1,6
SRLQGS,0,0,0,1,1,6
RLQGSL,0,0,0,1,1,6
LQGSLQ,0,0,0,1,1,6
QGSLQD,0,0,0,1,1,6
GSLQDM,0,0,0,1,1,6
SLQDML,0,0,0,1,1,6
LQDMLW,0,0,0,1,1,6
QDMLWQ,0,0,0,1,1,6
DMLWQL,0,0,0,1,1,6
MLWQLD,0,0,0,1,1,6
LWQLDL,0,0,0,1,1,6
WQLDLS,0,0,0,1,1,6
STLVQT,0,0,0,1,1,6
TLVQTP,0,0,0,1,1,6
LVQTPA,0,0,0,1,1,6
VQTPAL,0,0,0,1,1,6
QTPALR,0,0,0,1,1,6
TPALRA,0,0,0,1,1,6
PALRAV,0,0,0,1,1,6
ALRAVG,0,0,0,1,1,6
LRAVGN,0,0,0,1,1,6
RAVGNI,0,0,0,1,1,6
AVGNIV,0,0,0,1,1,6
STLVSV,0,0,0,1,1,6
TLVSVA,0,0,0,1,1,6
LVSVAV,0,0,0,1,1,6
VSVAVA,0,0,0,1,1,6
SVAVAL,0,0,0,1,1,6
VAVALA,0,0,0,1,1,6
AVALAA,0,0,0,1,1,6
VALAAY,0,0,0,1,1,6
ALAAYK,0,0,0,1,1,6
LAAYKT,0,0,0,1,1,6
AAYKTG,0,0,0,1,1,6
SVADHS,0,0,0,1,1,6
VADHSY,0,0,0,1,1,6
ADHSYR,0,0,0,1,1,6
DHSYRV,0,0,0,1,1,6
HSYRVA,0,0,0,1,1,6
SYRVAF,0,0,0,1,1,6
YRVAFI,0,0,0,1,1,6
RVAFIT,0,0,0,1,1,6
VAFITL,0,0,0,1,1,6
AFITLL,0,0,0,1,1,6
FITLLL,0,0,0,1,1,6
ITLLLA,0,0,0,1,1,6
TLLLAE,0,0,0,1,1,6
LLLAEE,0,0,0,1,1,6
LLAEEL,0,0,0,1,1,6
LAEELK,0,0,0,1,1,6
AEELKK,0,0,0,1,1,6
EELKKK,0,0,0,1,1,6
SVEGLQ,0,0,0,1,1,6
VEGLQE,0,0,0,1,1,6
EGLQEF,0,0,0,1,1,6
GLQEFV,0,0,0,1,1,6
LQEFVK,0,0,0,1,1,6
QEFVKN,0,0,0,1,1,6
EFVKNL,0,0,0,1,1,6
FVKNLV,0,0,0,1,1,6
VKNLVG,0,0,0,1,1,6
KNLVGY,0,0,0,1,1,6
NLVGYY,0,0,0,1,1,6
LVGYYI,0,0,0,1,1,6
SVEKKV,0,0,0,1,1,6
VEKKVP,0,0,0,1,1,6
EKKVPL,0,0,0,1,1,6
KKVPLL,0,0,0,1,1,6
KVPLLH,0,0,0,1,1,6
VPLLHN,0,0,0,1,1,6
PLLHNF,0,0,0,1,1,6
LLHNFH,0,0,0,1,1,6
LHNFHS,0,0,0,1,1,6
HNFHSF,0,0,0,1,1,6
NFHSFL,0,0,0,1,1,6
SVEVAE,0,0,0,1,1,6
VEVAEL,0,0,0,1,1,6
EVAELW,0,0,0,1,1,6
VAELWS,0,0,0,1,1,6
AELWST,0,0,0,1,1,6
ELWSTF,0,0,0,1,1,6
LWSTFM,0,0,0,1,1,6
WSTFMQ,0,0,0,1,1,6
STFMQK,0,0,0,1,1,6
TFMQKW,0,0,0,1,1,6
FMQKWI,0,0,0,1,1,6
MQKWIA,0,0,0,1,1,6
QKWIAY,0,0,0,1,1,6
KWIAYT,0,0,0,1,1,6
WIAYTA,0,0,0,1,1,6
IAYTAA,0,0,0,1,1,6
AYTAAV,0,0,0,1,1,6
YTAAVI,0,0,0,1,1,6
TAAVID,0,0,0,1,1,6
AAVIDA,0,0,0,1,1,6
AVIDAE,0,0,0,1,1,6
VIDAER,0,0,0,1,1,6
IDAERD,0,0,0,1,1,6
DAERDR,0,0,0,1,1,6
SVLENH,0,0,0,1,1,6
VLENHH,0,0,0,1,1,6
LENHHL,0,0,0,1,1,6
ENHHLA,0,0,0,1,1,6
NHHLAV,0,0,0,1,1,6
HHLAVG,0,0,0,1,1,6
HLAVGF,0,0,0,1,1,6
LAVGFK,0,0,0,1,1,6
AVGFKL,0,0,0,1,1,6
SVNSEI,0,0,0,1,1,6
VNSEIY,0,0,0,1,1,6
NSEIYQ,0,0,0,1,1,6
SEIYQR,0,0,0,1,1,6
EIYQRV,0,0,0,1,1,6
IYQRVM,0,0,0,1,1,6
YQRVME,0,0,0,1,1,6
QRVMES,0,0,0,1,1,6
RVMESF,0,0,0,1,1,6
VMESFK,0,0,0,1,1,6
MESFKK,0,0,0,1,1,6
ESFKKE,0,0,0,1,1,6
SFKKEG,0,0,0,1,1,6
SVPYFI,0,0,0,1,1,6
VPYFIE,0,0,0,1,1,6
PYFIEN,0,0,0,1,1,6
YFIENL,0,0,0,1,1,6
FIENLK,0,0,0,1,1,6
IENLKQ,0,0,0,1,1,6
ENLKQH,0,0,0,1,1,6
NLKQHI,0,0,0,1,1,6
LKQHIE,0,0,0,1,1,6
KQHIEM,0,0,0,1,1,6
QHIEMN,0,0,0,1,1,6
SVRKVF,0,0,0,1,1,6
VRKVFH,0,0,0,1,1,6
RKVFHL,0,0,0,1,1,6
KVFHLV,0,0,0,1,1,6
VFHLVR,0,0,0,1,1,6
FHLVRI,0,0,0,1,1,6
HLVRIK,0,0,0,1,1,6
LVRIKQ,0,0,0,1,1,6
VRIKQV,0,0,0,1,1,6
RIKQVA,0,0,0,1,1,6
IKQVAW,0,0,0,1,1,6
KQVAWA,0,0,0,1,1,6
QVAWAN,0,0,0,1,1,6
VAWANE,0,0,0,1,1,6
AWANEG,0,0,0,1,1,6
SVSRAA,0,0,0,1,1,6
VSRAAI,0,0,0,1,1,6
SRAAIT,0,0,0,1,1,6
RAAITA,0,0,0,1,1,6
AAITAA,0,0,0,1,1,6
AITAAY,0,0,0,1,1,6
SVSSIK,0,0,0,1,1,6
VSSIKQ,0,0,0,1,1,6
SSIKQA,0,0,0,1,1,6
SIKQAV,0,0,0,1,1,6
IKQAVD,0,0,0,1,1,6
KQAVDF,0,0,0,1,1,6
QAVDFL,0,0,0,1,1,6
AVDFLS,0,0,0,1,1,6
VDFLSN,0,0,0,1,1,6
DFLSNE,0,0,0,1,1,6
SVTELI,0,0,0,1,1,6
VTELIT,0,0,0,1,1,6
TELITK,0,0,0,1,1,6
ELITKA,0,0,0,1,1,6
LITKAV,0,0,0,1,1,6
ITKAVS,0,0,0,1,1,6
TKAVSA,0,0,0,1,1,6
SVTKIL,0,0,0,1,1,6
VTKILQ,0,0,0,1,1,6
TKILQR,0,0,0,1,1,6
KILQRF,0,0,0,1,1,6
ILQRFE,0,0,0,1,1,6
LQRFED,0,0,0,1,1,6
QRFEDA,0,0,0,1,1,6
RFEDAG,0,0,0,1,1,6
FEDAGG,0,0,0,1,1,6
SVWASI,0,0,0,1,1,6
VWASIS,0,0,0,1,1,6
WASISS,0,0,0,1,1,6
ASISSY,0,0,0,1,1,6
SISSYL,0,0,0,1,1,6
ISSYLD,0,0,0,1,1,6
SSYLDE,0,0,0,1,1,6
SYLDEL,0,0,0,1,1,6
YLDELT,0,0,0,1,1,6
LDELTE,0,0,0,1,1,6
DELTEG,0,0,0,1,1,6
ELTEGL,0,0,0,1,1,6
SWQSLK,0,0,0,1,1,6
WQSLKD,0,0,0,1,1,6
QSLKDR,0,0,0,1,1,6
SLKDRY,0,0,0,1,1,6
LKDRYL,0,0,0,1,1,6
KDRYLK,0,0,0,1,1,6
DRYLKH,0,0,0,1,1,6
RYLKHL,0,0,0,1,1,6
SYKDLF,0,0,0,1,1,6
YKDLFL,0,0,0,1,1,6
KDLFLE,0,0,0,1,1,6
DLFLEL,0,0,0,1,1,6
LFLELY,0,0,0,1,1,6
FLELYG,0,0,0,1,1,6
LELYGK,0,0,0,1,1,6
ELYGKI,0,0,0,1,1,6
LYGKIK,0,0,0,1,1,6
YGKIKD,0,0,0,1,1,6
TAAQEL,0,0,0,1,1,6
AAQELM,0,0,0,1,1,6
AQELMI,0,0,0,1,1,6
QELMIQ,0,0,0,1,1,6
ELMIQQ,0,0,0,1,1,6
LMIQQL,0,0,0,1,1,6
MIQQLV,0,0,0,1,1,6
IQQLVA,0,0,0,1,1,6
QQLVAA,0,0,0,1,1,6
QLVAAQ,0,0,0,1,1,6
LVAAQL,0,0,0,1,1,6
VAAQLQ,0,0,0,1,1,6
TAEQRR,0,0,0,1,1,6
AEQRRE,0,0,0,1,1,6
EQRREM,0,0,0,1,1,6
QRREML,0,0,0,1,1,6
RREMLE,0,0,0,1,1,6
REMLEA,0,0,0,1,1,6
EMLEAK,0,0,0,1,1,6
MLEAKR,0,0,0,1,1,6
LEAKRK,0,0,0,1,1,6
EAKRKQ,0,0,0,1,1,6
AKRKQI,0,0,0,1,1,6
KRKQII,0,0,0,1,1,6
RKQIIN,0,0,0,1,1,6
KQIINF,0,0,0,1,1,6
QIINFI,0,0,0,1,1,6
IINFIS,0,0,0,1,1,6
INFISR,0,0,0,1,1,6
NFISRN,0,0,0,1,1,6
TAESFY,0,0,0,1,1,6
AESFYN,0,0,0,1,1,6
ESFYNQ,0,0,0,1,1,6
SFYNQG,0,0,0,1,1,6
FYNQGI,0,0,0,1,1,6
YNQGIR,0,0,0,1,1,6
NQGIRL,0,0,0,1,1,6
QGIRLS,0,0,0,1,1,6
GIRLSF,0,0,0,1,1,6
IRLSFE,0,0,0,1,1,6
RLSFEQ,0,0,0,1,1,6
LSFEQW,0,0,0,1,1,6
SFEQWG,0,0,0,1,1,6
TAHEAV,0,0,0,1,1,6
AHEAVL,0,0,0,1,1,6
HEAVLD,0,0,0,1,1,6
EAVLDF,0,0,0,1,1,6
AVLDFL,0,0,0,1,1,6
VLDFLT,0,0,0,1,1,6
LDFLTG,0,0,0,1,1,6
DFLTGR,0,0,0,1,1,6
FLTGRV,0,0,0,1,1,6
LTGRVE,0,0,0,1,1,6
TGRVEV,0,0,0,1,1,6
GRVEVF,0,0,0,1,1,6
RVEVFT,0,0,0,1,1,6
TAKQIQ,0,0,0,1,1,6
AKQIQA,0,0,0,1,1,6
KQIQAA,0,0,0,1,1,6
QIQAAY,0,0,0,1,1,6
IQAAYL,0,0,0,1,1,6
QAAYLL,0,0,0,1,1,6
AAYLLV,0,0,0,1,1,6
AYLLVE,0,0,0,1,1,6
YLLVEN,0,0,0,1,1,6
LLVENE,0,0,0,1,1,6
LVENEL,0,0,0,1,1,6
VENELM,0,0,0,1,1,6
TAPEMT,0,0,0,1,1,6
APEMTA,0,0,0,1,1,6
PEMTAL,0,0,0,1,1,6
EMTALV,0,0,0,1,1,6
MTALVG,0,0,0,1,1,6
TALVGG,0,0,0,1,1,6
ALVGGM,0,0,0,1,1,6
LVGGMR,0,0,0,1,1,6
VGGMRV,0,0,0,1,1,6
GGMRVL,0,0,0,1,1,6
GMRVLG,0,0,0,1,1,6
TDAEAK,0,0,0,1,1,6
DAEAKQ,0,0,0,1,1,6
AEAKQL,0,0,0,1,1,6
EAKQLA,0,0,0,1,1,6
AKQLAQ,0,0,0,1,1,6
KQLAQW,0,0,0,1,1,6
QLAQWI,0,0,0,1,1,6
LAQWIL,0,0,0,1,1,6
AQWILS,0,0,0,1,1,6
TDKQFE,0,0,0,1,1,6
DKQFEN,0,0,0,1,1,6
KQFENR,0,0,0,1,1,6
QFENRL,0,0,0,1,1,6
FENRLN,0,0,0,1,1,6
ENRLND,0,0,0,1,1,6
NRLNDN,0,0,0,1,1,6
RLNDNL,0,0,0,1,1,6
LNDNLE,0,0,0,1,1,6
NDNLEE,0,0,0,1,1,6
DNLEEL,0,0,0,1,1,6
NLEELI,0,0,0,1,1,6
LEELIQ,0,0,0,1,1,6
TDLEIL,0,0,0,1,1,6
DLEILA,0,0,0,1,1,6
LEILAL,0,0,0,1,1,6
EILALL,0,0,0,1,1,6
ILALLI,0,0,0,1,1,6
LALLIA,0,0,0,1,1,6
ALLIAA,0,0,0,1,1,6
LLIAAL,0,0,0,1,1,6
LIAALS,0,0,0,1,1,6
IAALSH,0,0,0,1,1,6
TDQQKV,0,0,0,1,1,6
DQQKVS,0,0,0,1,1,6
QQKVSE,0,0,0,1,1,6
QKVSEI,0,0,0,1,1,6
KVSEIF,0,0,0,1,1,6
VSEIFQ,0,0,0,1,1,6
SEIFQS,0,0,0,1,1,6
EIFQSS,0,0,0,1,1,6
IFQSSK,0,0,0,1,1,6
FQSSKE,0,0,0,1,1,6
QSSKEK,0,0,0,1,1,6
SSKEKL,0,0,0,1,1,6
SKEKLQ,0,0,0,1,1,6
KEKLQG,0,0,0,1,1,6
EKLQGD,0,0,0,1,1,6
KLQGDA,0,0,0,1,1,6
LQGDAK,0,0,0,1,1,6
QGDAKV,0,0,0,1,1,6
GDAKVV,0,0,0,1,1,6
DAKVVS,0,0,0,1,1,6
AKVVSD,0,0,0,1,1,6
KVVSDA,0,0,0,1,1,6
VVSDAF,0,0,0,1,1,6
VSDAFK,0,0,0,1,1,6
TEAKKE,0,0,0,1,1,6
EAKKEE,0,0,0,1,1,6
AKKEEL,0,0,0,1,1,6
KKEELL,0,0,0,1,1,6
KEELLR,0,0,0,1,1,6
EELLRK,0,0,0,1,1,6
ELLRKL,0,0,0,1,1,6
LLRKLN,0,0,0,1,1,6
LRKLNI,0,0,0,1,1,6
RKLNIL,0,0,0,1,1,6
KLNILE,0,0,0,1,1,6
LNILEV,0,0,0,1,1,6
NILEVF,0,0,0,1,1,6
TEEEML,0,0,0,1,1,6
EEEMLQ,0,0,0,1,1,6
EEMLQA,0,0,0,1,1,6
EMLQAA,0,0,0,1,1,6
MLQAAH,0,0,0,1,1,6
LQAAHI,0,0,0,1,1,6
QAAHIT,0,0,0,1,1,6
AAHITA,0,0,0,1,1,6
AHITAK,0,0,0,1,1,6
HITAKL,0,0,0,1,1,6
ITAKLA,0,0,0,1,1,6
TAKLAQ,0,0,0,1,1,6
AKLAQA,0,0,0,1,1,6
KLAQAA,0,0,0,1,1,6
LAQAAE,0,0,0,1,1,6
AQAAET,0,0,0,1,1,6
TEKGKE,0,0,0,1,1,6
EKGKEI,0,0,0,1,1,6
KGKEIF,0,0,0,1,1,6
GKEIFG,0,0,0,1,1,6
KEIFGE,0,0,0,1,1,6
EIFGEI,0,0,0,1,1,6
IFGEIL,0,0,0,1,1,6
FGEILS,0,0,0,1,1,6
GEILSN,0,0,0,1,1,6
EILSNF,0,0,0,1,1,6
ILSNFE,0,0,0,1,1,6
LSNFES,0,0,0,1,1,6
SNFESL,0,0,0,1,1,6
NFESLL,0,0,0,1,1,6
FESLLK,0,0,0,1,1,6
ESLLKS,0,0,0,1,1,6
SLLKSV,0,0,0,1,1,6
LLKSVL,0,0,0,1,1,6
LKSVLE,0,0,0,1,1,6
KSVLEK,0,0,0,1,1,6
TEQDII,0,0,0,1,1,6
EQDIID,0,0,0,1,1,6
QDIIDL,0,0,0,1,1,6
DIIDLK,0,0,0,1,1,6
IIDLKF,0,0,0,1,1,6
IDLKFA,0,0,0,1,1,6
DLKFAI,0,0,0,1,1,6
LKFAIA,0,0,0,1,1,6
KFAIAD,0,0,0,1,1,6
TEQNFQ,0,0,0,1,1,6
EQNFQL,0,0,0,1,1,6
QNFQLA,0,0,0,1,1,6
NFQLAK,0,0,0,1,1,6
FQLAKQ,0,0,0,1,1,6
QLAKQI,0,0,0,1,1,6
LAKQIQ,0,0,0,1,1,6
AKQIQS,0,0,0,1,1,6
KQIQSQ,0,0,0,1,1,6
QIQSQW,0,0,0,1,1,6
IQSQWK,0,0,0,1,1,6
QSQWKE,0,0,0,1,1,6
SQWKEF,0,0,0,1,1,6
QWKEFG,0,0,0,1,1,6
TEREQA,0,0,0,1,1,6
EREQAL,0,0,0,1,1,6
REQALA,0,0,0,1,1,6
EQALAA,0,0,0,1,1,6
QALAAY,0,0,0,1,1,6
ALAAYA,0,0,0,1,1,6
LAAYAE,0,0,0,1,1,6
AAYAEK,0,0,0,1,1,6
AYAEKL,0,0,0,1,1,6
YAEKLT,0,0,0,1,1,6
AEKLTR,0,0,0,1,1,6
EKLTRH,0,0,0,1,1,6
TESMKT,0,0,0,1,1,6
ESMKTV,0,0,0,1,1,6
SMKTVR,0,0,0,1,1,6
MKTVRI,0,0,0,1,1,6
KTVRIR,0,0,0,1,1,6
TVRIRE,0,0,0,1,1,6
VRIREK,0,0,0,1,1,6
RIREKI,0,0,0,1,1,6
IREKIK,0,0,0,1,1,6
REKIKK,0,0,0,1,1,6
EKIKKF,0,0,0,1,1,6
KIKKFL,0,0,0,1,1,6
TETQIR,0,0,0,1,1,6
ETQIRE,0,0,0,1,1,6
TQIREL,0,0,0,1,1,6
QIRELL,0,0,0,1,1,6
IRELLF,0,0,0,1,1,6
RELLFD,0,0,0,1,1,6
ELLFDL,0,0,0,1,1,6
LLFDLE,0,0,0,1,1,6
LFDLEL,0,0,0,1,1,6
FDLELA,0,0,0,1,1,6
DLELAY,0,0,0,1,1,6
LELAYK,0,0,0,1,1,6
ELAYKS,0,0,0,1,1,6
LAYKSF,0,0,0,1,1,6
AYKSFY,0,0,0,1,1,6
YKSFYA,0,0,0,1,1,6
KSFYAL,0,0,0,1,1,6
SFYALL,0,0,0,1,1,6
TEVYQI,0,0,0,1,1,6
EVYQIL,0,0,0,1,1,6
VYQILN,0,0,0,1,1,6
YQILNR,0,0,0,1,1,6
QILNRV,0,0,0,1,1,6
ILNRVS,0,0,0,1,1,6
TFPDKA,0,0,0,1,1,6
FPDKAL,0,0,0,1,1,6
PDKALK,0,0,0,1,1,6
DKALKG,0,0,0,1,1,6
KALKGK,0,0,0,1,1,6
ALKGKK,0,0,0,1,1,6
LKGKKS,0,0,0,1,1,6
KGKKSI,0,0,0,1,1,6
GKKSIE,0,0,0,1,1,6
KKSIEN,0,0,0,1,1,6
KSIENI,0,0,0,1,1,6
SIENIV,0,0,0,1,1,6
IENIVV,0,0,0,1,1,6
TFPEWH,0,0,0,1,1,6
FPEWHR,0,0,0,1,1,6
PEWHRL,0,0,0,1,1,6
EWHRLY,0,0,0,1,1,6
WHRLYT,0,0,0,1,1,6
HRLYTV,0,0,0,1,1,6
RLYTVQ,0,0,0,1,1,6
LYTVQF,0,0,0,1,1,6
YTVQFE,0,0,0,1,1,6
TVQFED,0,0,0,1,1,6
VQFEDA,0,0,0,1,1,6
QFEDAL,0,0,0,1,1,6
FEDALR,0,0,0,1,1,6
EDALRR,0,0,0,1,1,6
DALRRH,0,0,0,1,1,6
TFPNWH,0,0,0,1,1,6
FPNWHR,0,0,0,1,1,6
PNWHRL,0,0,0,1,1,6
NWHRLL,0,0,0,1,1,6
WHRLLT,0,0,0,1,1,6
HRLLTK,0,0,0,1,1,6
RLLTKQ,0,0,0,1,1,6
LLTKQM,0,0,0,1,1,6
LTKQME,0,0,0,1,1,6
TKQMED,0,0,0,1,1,6
KQMEDA,0,0,0,1,1,6
QMEDAL,0,0,0,1,1,6
MEDALV,0,0,0,1,1,6
EDALVA,0,0,0,1,1,6
DALVAK,0,0,0,1,1,6
TFSQVL,0,0,0,1,1,6
FSQVLD,0,0,0,1,1,6
SQVLDD,0,0,0,1,1,6
QVLDDL,0,0,0,1,1,6
VLDDLS,0,0,0,1,1,6
LDDLSA,0,0,0,1,1,6
DDLSAR,0,0,0,1,1,6
DLSARF,0,0,0,1,1,6
LSARFI,0,0,0,1,1,6
TGALRT,0,0,0,1,1,6
GALRTQ,0,0,0,1,1,6
ALRTQY,0,0,0,1,1,6
LRTQYD,0,0,0,1,1,6
RTQYDV,0,0,0,1,1,6
TQYDVS,0,0,0,1,1,6
QYDVSL,0,0,0,1,1,6
YDVSLM,0,0,0,1,1,6
DVSLMT,0,0,0,1,1,6
VSLMTV,0,0,0,1,1,6
SLMTVK,0,0,0,1,1,6
LMTVKS,0,0,0,1,1,6
THAEML,0,0,0,1,1,6
HAEMLH,0,0,0,1,1,6
AEMLHA,0,0,0,1,1,6
EMLHAL,0,0,0,1,1,6
MLHALK,0,0,0,1,1,6
LHALKE,0,0,0,1,1,6
HALKER,0,0,0,1,1,6
ALKERY,0,0,0,1,1,6
THNKLL,0,0,0,1,1,6
HNKLLK,0,0,0,1,1,6
NKLLKN,0,0,0,1,1,6
KLLKNV,0,0,0,1,1,6
LLKNVA,0,0,0,1,1,6
LKNVAF,0,0,0,1,1,6
KNVAFM,0,0,0,1,1,6
NVAFMK,0,0,0,1,1,6
VAFMKS,0,0,0,1,1,6
AFMKSY,0,0,0,1,1,6
FMKSYI,0,0,0,1,1,6
MKSYIL,0,0,0,1,1,6
KSYILE,0,0,0,1,1,6
SYILEK,0,0,0,1,1,6
YILEKV,0,0,0,1,1,6
ILEKVK,0,0,0,1,1,6
LEKVKE,0,0,0,1,1,6
EKVKEH,0,0,0,1,1,6
KVKEHQ,0,0,0,1,1,6
VKEHQE,0,0,0,1,1,6
KEHQES,0,0,0,1,1,6
TIEEFH,0,0,0,1,1,6
IEEFHS,0,0,0,1,1,6
EEFHSK,0,0,0,1,1,6
EFHSKL,0,0,0,1,1,6
FHSKLQ,0,0,0,1,1,6
HSKLQE,0,0,0,1,1,6
SKLQEA,0,0,0,1,1,6
KLQEAT,0,0,0,1,1,6
LQEATN,0,0,0,1,1,6
TIQSRF,0,0,0,1,1,6
IQSRFN,0,0,0,1,1,6
QSRFNY,0,0,0,1,1,6
SRFNYA,0,0,0,1,1,6
RFNYAW,0,0,0,1,1,6
FNYAWG,0,0,0,1,1,6
NYAWGL,0,0,0,1,1,6
YAWGLI,0,0,0,1,1,6
AWGLIK,0,0,0,1,1,6
WGLIKS,0,0,0,1,1,6
TISLGV,0,0,0,1,1,6
ISLGVS,0,0,0,1,1,6
SLGVSI,0,0,0,1,1,6
LGVSIA,0,0,0,1,1,6
GVSIAH,0,0,0,1,1,6
VSIAHV,0,0,0,1,1,6
SIAHVM,0,0,0,1,1,6
IAHVME,0,0,0,1,1,6
AHVMEA,0,0,0,1,1,6
HVMEAV,0,0,0,1,1,6
VMEAVE,0,0,0,1,1,6
TITEMV,0,0,0,1,1,6
ITEMVF,0,0,0,1,1,6
TEMVFL,0,0,0,1,1,6
EMVFLA,0,0,0,1,1,6
MVFLAE,0,0,0,1,1,6
VFLAEV,0,0,0,1,1,6
FLAEVY,0,0,0,1,1,6
LAEVYK,0,0,0,1,1,6
AEVYKS,0,0,0,1,1,6
EVYKSG,0,0,0,1,1,6
VYKSGG,0,0,0,1,1,6
TIVELV,0,0,0,1,1,6
IVELVV,0,0,0,1,1,6
VELVVR,0,0,0,1,1,6
ELVVRV,0,0,0,1,1,6
LVVRVW,0,0,0,1,1,6
VVRVWR,0,0,0,1,1,6
VRVWRW,0,0,0,1,1,6
RVWRWF,0,0,0,1,1,6
VWRWFL,0,0,0,1,1,6
WRWFLV,0,0,0,1,1,6
RWFLVI,0,0,0,1,1,6
WFLVIW,0,0,0,1,1,6
FLVIWV,0,0,0,1,1,6
LVIWVL,0,0,0,1,1,6
VIWVLW,0,0,0,1,1,6
TKDEFM,0,0,0,1,1,6
KDEFMS,0,0,0,1,1,6
DEFMSG,0,0,0,1,1,6
EFMSGE,0,0,0,1,1,6
FMSGEP,0,0,0,1,1,6
MSGEPI,0,0,0,1,1,6
SGEPIF,0,0,0,1,1,6
GEPIFT,0,0,0,1,1,6
EPIFTK,0,0,0,1,1,6
PIFTKY,0,0,0,1,1,6
IFTKYF,0,0,0,1,1,6
FTKYFQ,0,0,0,1,1,6
TKYFQN,0,0,0,1,1,6
KYFQNL,0,0,0,1,1,6
YFQNLV,0,0,0,1,1,6
TKDEQV,0,0,0,1,1,6
KDEQVE,0,0,0,1,1,6
DEQVEG,0,0,0,1,1,6
EQVEGL,0,0,0,1,1,6
QVEGLL,0,0,0,1,1,6
VEGLLA,0,0,0,1,1,6
TKGERE,0,0,0,1,1,6
KGEREM,0,0,0,1,1,6
GEREMI,0,0,0,1,1,6
EREMIV,0,0,0,1,1,6
REMIVV,0,0,0,1,1,6
EMIVVA,0,0,0,1,1,6
MIVVAT,0,0,0,1,1,6
IVVATS,0,0,0,1,1,6
VVATSA,0,0,0,1,1,6
VATSAA,0,0,0,1,1,6
ATSAAN,0,0,0,1,1,6
TKIWLN,0,0,0,1,1,6
KIWLNA,0,0,0,1,1,6
IWLNAA,0,0,0,1,1,6
WLNAAR,0,0,0,1,1,6
LNAARR,0,0,0,1,1,6
NAARRT,0,0,0,1,1,6
AARRTG,0,0,0,1,1,6
ARRTGK,0,0,0,1,1,6
RRTGKV,0,0,0,1,1,6
RTGKVP,0,0,0,1,1,6
TGKVPA,0,0,0,1,1,6
GKVPAR,0,0,0,1,1,6
KVPARI,0,0,0,1,1,6
VPARIR,0,0,0,1,1,6
PARIRK,0,0,0,1,1,6
ARIRKL,0,0,0,1,1,6
TLDQMR,0,0,0,1,1,6
LDQMRS,0,0,0,1,1,6
DQMRSR,0,0,0,1,1,6
QMRSRL,0,0,0,1,1,6
MRSRLA,0,0,0,1,1,6
RSRLAY,0,0,0,1,1,6
SRLAYD,0,0,0,1,1,6
RLAYDG,0,0,0,1,1,6
TLEDYV,0,0,0,1,1,6
LEDYVR,0,0,0,1,1,6
EDYVRY,0,0,0,1,1,6
DYVRYV,0,0,0,1,1,6
YVRYVT,0,0,0,1,1,6
VRYVTL,0,0,0,1,1,6
RYVTLD,0,0,0,1,1,6
YVTLDM,0,0,0,1,1,6
TLIREW,0,0,0,1,1,6
LIREWG,0,0,0,1,1,6
IREWGD,0,0,0,1,1,6
REWGDA,0,0,0,1,1,6
EWGDAV,0,0,0,1,1,6
WGDAVF,0,0,0,1,1,6
GDAVFD,0,0,0,1,1,6
DAVFDI,0,0,0,1,1,6
AVFDIF,0,0,0,1,1,6
TMEGKF,0,0,0,1,1,6
MEGKFK,0,0,0,1,1,6
EGKFKA,0,0,0,1,1,6
GKFKAV,0,0,0,1,1,6
KFKAVA,0,0,0,1,1,6
FKAVAE,0,0,0,1,1,6
KAVAED,0,0,0,1,1,6
AVAEDV,0,0,0,1,1,6
VAEDVA,0,0,0,1,1,6
AEDVAQ,0,0,0,1,1,6
EDVAQR,0,0,0,1,1,6
DVAQRY,0,0,0,1,1,6
VAQRYM,0,0,0,1,1,6
AQRYMT,0,0,0,1,1,6
TMVQAI,0,0,0,1,1,6
MVQAIT,0,0,0,1,1,6
VQAITD,0,0,0,1,1,6
QAITDA,0,0,0,1,1,6
AITDAL,0,0,0,1,1,6
ITDALR,0,0,0,1,1,6
TDALRI,0,0,0,1,1,6
DALRIE,0,0,0,1,1,6
ALRIEL,0,0,0,1,1,6
LRIELK,0,0,0,1,1,6
RIELKN,0,0,0,1,1,6
IELKND,0,0,0,1,1,6
TNDEIF,0,0,0,1,1,6
NDEIFS,0,0,0,1,1,6
DEIFSI,0,0,0,1,1,6
EIFSIL,0,0,0,1,1,6
IFSILK,0,0,0,1,1,6
FSILKD,0,0,0,1,1,6
TPAKAL,0,0,0,1,1,6
PAKALK,0,0,0,1,1,6
AKALKS,0,0,0,1,1,6
KALKSA,0,0,0,1,1,6
ALKSAI,0,0,0,1,1,6
LKSAIH,0,0,0,1,1,6
KSAIHV,0,0,0,1,1,6
SAIHVA,0,0,0,1,1,6
AIHVAY,0,0,0,1,1,6
IHVAYI,0,0,0,1,1,6
HVAYIL,0,0,0,1,1,6
VAYILK,0,0,0,1,1,6
AYILKK,0,0,0,1,1,6
TPDQQT,0,0,0,1,1,6
PDQQTL,0,0,0,1,1,6
DQQTLL,0,0,0,1,1,6
QQTLLH,0,0,0,1,1,6
QTLLHF,0,0,0,1,1,6
TLLHFI,0,0,0,1,1,6
LLHFIM,0,0,0,1,1,6
LHFIMD,0,0,0,1,1,6
HFIMDS,0,0,0,1,1,6
FIMDSY,0,0,0,1,1,6
IMDSYN,0,0,0,1,1,6
TPEEVK,0,0,0,1,1,6
PEEVKK,0,0,0,1,1,6
EVKKHY,0,0,0,1,1,6
VKKHYE,0,0,0,1,1,6
KKHYEI,0,0,0,1,1,6
KHYEIL,0,0,0,1,1,6
HYEILV,0,0,0,1,1,6
YEILVE,0,0,0,1,1,6
EILVED,0,0,0,1,1,6
ILVEDI,0,0,0,1,1,6
LVEDIK,0,0,0,1,1,6
VEDIKY,0,0,0,1,1,6
EDIKYI,0,0,0,1,1,6
DIKYIE,0,0,0,1,1,6
IKYIES,0,0,0,1,1,6
KYIESG,0,0,0,1,1,6
TPEEYQ,0,0,0,1,1,6
PEEYQT,0,0,0,1,1,6
EEYQTY,0,0,0,1,1,6
EYQTYV,0,0,0,1,1,6
YQTYVA,0,0,0,1,1,6
QTYVAQ,0,0,0,1,1,6
TYVAQV,0,0,0,1,1,6
YVAQVD,0,0,0,1,1,6
VAQVDK,0,0,0,1,1,6
TPEKMG,0,0,0,1,1,6
PEKMGE,0,0,0,1,1,6
EKMGEM,0,0,0,1,1,6
KMGEMA,0,0,0,1,1,6
MGEMAQ,0,0,0,1,1,6
GEMAQK,0,0,0,1,1,6
EMAQKF,0,0,0,1,1,6
MAQKFR,0,0,0,1,1,6
AQKFRE,0,0,0,1,1,6
TPEKRV,0,0,0,1,1,6
PEKRVD,0,0,0,1,1,6
EKRVDR,0,0,0,1,1,6
KRVDRI,0,0,0,1,1,6
RVDRIF,0,0,0,1,1,6
VDRIFA,0,0,0,1,1,6
DRIFAM,0,0,0,1,1,6
RIFAMM,0,0,0,1,1,6
IFAMMD,0,0,0,1,1,6
TPERLE,0,0,0,1,1,6
PERLEK,0,0,0,1,1,6
ERLEKL,0,0,0,1,1,6
RLEKLV,0,0,0,1,1,6
LEKLVK,0,0,0,1,1,6
EKLVKE,0,0,0,1,1,6
KLVKEV,0,0,0,1,1,6
LVKEVL,0,0,0,1,1,6
TPETIT,0,0,0,1,1,6
PETITH,0,0,0,1,1,6
ETITHY,0,0,0,1,1,6
TITHYL,0,0,0,1,1,6
ITHYLE,0,0,0,1,1,6
THYLET,0,0,0,1,1,6
HYLETV,0,0,0,1,1,6
YLETVN,0,0,0,1,1,6
LETVNH,0,0,0,1,1,6
ETVNHA,0,0,0,1,1,6
TVNHAM,0,0,0,1,1,6
TPEVVK,0,0,0,1,1,6
PEVVKE,0,0,0,1,1,6
EVVKER,0,0,0,1,1,6
VVKERL,0,0,0,1,1,6
VKERLL,0,0,0,1,1,6
KERLLS,0,0,0,1,1,6
TPLGIG,0,0,0,1,1,6
PLGIGI,0,0,0,1,1,6
LGIGIT,0,0,0,1,1,6
GIGITD,0,0,0,1,1,6
IGITDY,0,0,0,1,1,6
GITDYY,0,0,0,1,1,6
ITDYYI,0,0,0,1,1,6
TDYYIR,0,0,0,1,1,6
TPQDIA,0,0,0,1,1,6
PQDIAD,0,0,0,1,1,6
QDIADR,0,0,0,1,1,6
DIADRE,0,0,0,1,1,6
IADRER,0,0,0,1,1,6
ADRERI,0,0,0,1,1,6
DRERIF,0,0,0,1,1,6
RERIFK,0,0,0,1,1,6
ERIFKR,0,0,0,1,1,6
RIFKRF,0,0,0,1,1,6
IFKRFD,0,0,0,1,1,6
TPSDIK,0,0,0,1,1,6
PSDIKE,0,0,0,1,1,6
SDIKEL,0,0,0,1,1,6
DIKELR,0,0,0,1,1,6
IKELRD,0,0,0,1,1,6
KELRDA,0,0,0,1,1,6
ELRDAM,0,0,0,1,1,6
LRDAMA,0,0,0,1,1,6
RDAMAK,0,0,0,1,1,6
DAMAKV,0,0,0,1,1,6
AMAKVQ,0,0,0,1,1,6
MAKVQA,0,0,0,1,1,6
AKVQAD,0,0,0,1,1,6
TPVYRT,0,0,0,1,1,6
PVYRTA,0,0,0,1,1,6
VYRTAI,0,0,0,1,1,6
YRTAIR,0,0,0,1,1,6
RTAIRY,0,0,0,1,1,6
TAIRYY,0,0,0,1,1,6
AIRYYL,0,0,0,1,1,6
IRYYLQ,0,0,0,1,1,6
RYYLQM,0,0,0,1,1,6
YYLQML,0,0,0,1,1,6
YLQMLF,0,0,0,1,1,6
TPWSKG,0,0,0,1,1,6
PWSKGF,0,0,0,1,1,6
WSKGFL,0,0,0,1,1,6
SKGFLA,0,0,0,1,1,6
KGFLAS,0,0,0,1,1,6
GFLASS,0,0,0,1,1,6
FLASSY,0,0,0,1,1,6
LASSYA,0,0,0,1,1,6
ASSYAS,0,0,0,1,1,6
SSYASR,0,0,0,1,1,6
TPYDAK,0,0,0,1,1,6
PYDAKG,0,0,0,1,1,6
YDAKGL,0,0,0,1,1,6
DAKGLL,0,0,0,1,1,6
AKGLLI,0,0,0,1,1,6
KGLLIS,0,0,0,1,1,6
GLLISA,0,0,0,1,1,6
LLISAI,0,0,0,1,1,6
LISAIR,0,0,0,1,1,6
ISAIRD,0,0,0,1,1,6
TQAQET,0,0,0,1,1,6
QAQETQ,0,0,0,1,1,6
AQETQG,0,0,0,1,1,6
QETQGQ,0,0,0,1,1,6
ETQGQA,0,0,0,1,1,6
TQGQAA,0,0,0,1,1,6
QGQAAA,0,0,0,1,1,6
GQAAAR,0,0,0,1,1,6
QAAARA,0,0,0,1,1,6
AAARAA,0,0,0,1,1,6
AARAAA,0,0,0,1,1,6
ARAAAA,0,0,0,1,1,6
RAAAAD,0,0,0,1,1,6
AAAADL,0,0,0,1,1,6
AAADLA,0,0,0,1,1,6
AADLAA,0,0,0,1,1,6
ADLAAG,0,0,0,1,1,6
TQDLRS,0,0,0,1,1,6
QDLRSH,0,0,0,1,1,6
DLRSHL,0,0,0,1,1,6
LRSHLV,0,0,0,1,1,6
RSHLVH,0,0,0,1,1,6
SHLVHK,0,0,0,1,1,6
HLVHKL,0,0,0,1,1,6
LVHKLV,0,0,0,1,1,6
VHKLVQ,0,0,0,1,1,6
HKLVQA,0,0,0,1,1,6
KLVQAI,0,0,0,1,1,6
LVQAIF,0,0,0,1,1,6
TQGLLS,0,0,0,1,1,6
QGLLSE,0,0,0,1,1,6
GLLSEI,0,0,0,1,1,6
LLSEIL,0,0,0,1,1,6
LSEILR,0,0,0,1,1,6
SEILRK,0,0,0,1,1,6
TQGMQN,0,0,0,1,1,6
QGMQNA,0,0,0,1,1,6
GMQNAM,0,0,0,1,1,6
MQNAMG,0,0,0,1,1,6
QNAMGE,0,0,0,1,1,6
NAMGER,0,0,0,1,1,6
AMGERF,0,0,0,1,1,6
MGERFA,0,0,0,1,1,6
GERFAQ,0,0,0,1,1,6
ERFAQY,0,0,0,1,1,6
RFAQYA,0,0,0,1,1,6
FAQYAL,0,0,0,1,1,6
AQYALS,0,0,0,1,1,6
QYALSS,0,0,0,1,1,6
YALSSE,0,0,0,1,1,6
ALSSEK,0,0,0,1,1,6
LSSEKL,0,0,0,1,1,6
SSEKLY,0,0,0,1,1,6
TQSDVY,0,0,0,1,1,6
QSDVYA,0,0,0,1,1,6
SDVYAM,0,0,0,1,1,6
DVYAMV,0,0,0,1,1,6
VYAMVG,0,0,0,1,1,6
YAMVGY,0,0,0,1,1,6
AMVGYI,0,0,0,1,1,6
MVGYIH,0,0,0,1,1,6
VGYIHE,0,0,0,1,1,6
GYIHEL,0,0,0,1,1,6
YIHELW,0,0,0,1,1,6
TRELAY,0,0,0,1,1,6
RELAYM,0,0,0,1,1,6
ELAYMI,0,0,0,1,1,6
LAYMIK,0,0,0,1,1,6
AYMIKK,0,0,0,1,1,6
YMIKKA,0,0,0,1,1,6
TRTQRR,0,0,0,1,1,6
RTQRRI,0,0,0,1,1,6
TQRRIA,0,0,0,1,1,6
QRRIAV,0,0,0,1,1,6
RRIAVV,0,0,0,1,1,6
RIAVVE,0,0,0,1,1,6
IAVVEF,0,0,0,1,1,6
AVVEFI,0,0,0,1,1,6
VVEFIF,0,0,0,1,1,6
VEFIFS,0,0,0,1,1,6
EFIFSL,0,0,0,1,1,6
FIFSLL,0,0,0,1,1,6
TSAQTK,0,0,0,1,1,6
SAQTKV,0,0,0,1,1,6
AQTKVV,0,0,0,1,1,6
QTKVVV,0,0,0,1,1,6
TKVVVD,0,0,0,1,1,6
KVVVDA,0,0,0,1,1,6
TSFDEY,0,0,0,1,1,6
SFDEYV,0,0,0,1,1,6
FDEYVA,0,0,0,1,1,6
DEYVAE,0,0,0,1,1,6
EYVAEL,0,0,0,1,1,6
YVAELD,0,0,0,1,1,6
VAELDS,0,0,0,1,1,6
AELDSK,0,0,0,1,1,6
TSHLMG,0,0,0,1,1,6
SHLMGM,0,0,0,1,1,6
HLMGMF,0,0,0,1,1,6
LMGMFY,0,0,0,1,1,6
MGMFYR,0,0,0,1,1,6
GMFYRT,0,0,0,1,1,6
MFYRTI,0,0,0,1,1,6
FYRTIR,0,0,0,1,1,6
YRTIRM,0,0,0,1,1,6
RTIRMM,0,0,0,1,1,6
TIRMME,0,0,0,1,1,6
IRMMEN,0,0,0,1,1,6
TTDEIN,0,0,0,1,1,6
TDEINA,0,0,0,1,1,6
DEINAM,0,0,0,1,1,6
EINAMD,0,0,0,1,1,6
INAMDK,0,0,0,1,1,6
NAMDKA,0,0,0,1,1,6
AMDKAL,0,0,0,1,1,6
MDKALI,0,0,0,1,1,6
DKALIL,0,0,0,1,1,6
KALILY,0,0,0,1,1,6
ALILYT,0,0,0,1,1,6
TTGNFE,0,0,0,1,1,6
TGNFEK,0,0,0,1,1,6
GNFEKL,0,0,0,1,1,6
NFEKLF,0,0,0,1,1,6
FEKLFV,0,0,0,1,1,6
EKLFVA,0,0,0,1,1,6
KLFVAL,0,0,0,1,1,6
LFVALV,0,0,0,1,1,6
FVALVE,0,0,0,1,1,6
VALVEY,0,0,0,1,1,6
ALVEYM,0,0,0,1,1,6
LVEYMR,0,0,0,1,1,6
VEYMRA,0,0,0,1,1,6
EYMRAS,0,0,0,1,1,6
TVEEVN,0,0,0,1,1,6
VEEVNA,0,0,0,1,1,6
EEVNAL,0,0,0,1,1,6
EVNALK,0,0,0,1,1,6
VNALKN,0,0,0,1,1,6
NALKNE,0,0,0,1,1,6
ALKNEI,0,0,0,1,1,6
LKNEIL,0,0,0,1,1,6
KNEILK,0,0,0,1,1,6
NEILKA,0,0,0,1,1,6
EILKAH,0,0,0,1,1,6
ILKAHA,0,0,0,1,1,6
TVFGTA,0,0,0,1,1,6
VFGTAL,0,0,0,1,1,6
FGTALN,0,0,0,1,1,6
GTALNY,0,0,0,1,1,6
TALNYV,0,0,0,1,1,6
ALNYVS,0,0,0,1,1,6
LNYVSL,0,0,0,1,1,6
NYVSLR,0,0,0,1,1,6
YVSLRI,0,0,0,1,1,6
VSLRIL,0,0,0,1,1,6
TVLAAL,0,0,0,1,1,6
VLAALF,0,0,0,1,1,6
LAALFL,0,0,0,1,1,6
AALFLA,0,0,0,1,1,6
ALFLAG,0,0,0,1,1,6
LFLAGS,0,0,0,1,1,6
TYYAKD,0,0,0,1,1,6
YYAKDI,0,0,0,1,1,6
YAKDIA,0,0,0,1,1,6
AKDIAF,0,0,0,1,1,6
KDIAFQ,0,0,0,1,1,6
DIAFQF,0,0,0,1,1,6
IAFQFW,0,0,0,1,1,6
AFQFWK,0,0,0,1,1,6
FQFWKM,0,0,0,1,1,6
VADIAK,0,0,0,1,1,6
ADIAKL,0,0,0,1,1,6
DIAKLK,0,0,0,1,1,6
IAKLKV,0,0,0,1,1,6
AKLKVN,0,0,0,1,1,6
KLKVNI,0,0,0,1,1,6
LKVNII,0,0,0,1,1,6
KVNIIK,0,0,0,1,1,6
VNIIKN,0,0,0,1,1,6
NIIKNV,0,0,0,1,1,6
IIKNVR,0,0,0,1,1,6
IKNVRI,0,0,0,1,1,6
KNVRII,0,0,0,1,1,6
VADPVA,0,0,0,1,1,6
ADPVAA,0,0,0,1,1,6
DPVAAF,0,0,0,1,1,6
PVAAFK,0,0,0,1,1,6
VAAFKW,0,0,0,1,1,6
AAFKWR,0,0,0,1,1,6
AFKWRA,0,0,0,1,1,6
FKWRAQ,0,0,0,1,1,6
VDDNLY,0,0,0,1,1,6
DDNLYP,0,0,0,1,1,6
DNLYPQ,0,0,0,1,1,6
NLYPQL,0,0,0,1,1,6
LYPQLE,0,0,0,1,1,6
YPQLER,0,0,0,1,1,6
PQLERA,0,0,0,1,1,6
QLERAS,0,0,0,1,1,6
LERASR,0,0,0,1,1,6
ERASRK,0,0,0,1,1,6
RASRKI,0,0,0,1,1,6
ASRKIF,0,0,0,1,1,6
SRKIFE,0,0,0,1,1,6
RKIFEF,0,0,0,1,1,6
KIFEFL,0,0,0,1,1,6
IFEFLE,0,0,0,1,1,6
FEFLER,0,0,0,1,1,6
EFLERE,0,0,0,1,1,6
VEAIEA,0,0,0,1,1,6
AIEALL,0,0,0,1,1,6
IEALLK,0,0,0,1,1,6
EALLKG,0,0,0,1,1,6
ALLKGN,0,0,0,1,1,6
VFWPTM,0,0,0,1,1,6
FWPTML,0,0,0,1,1,6
WPTMLK,0,0,0,1,1,6
PTMLKA,0,0,0,1,1,6
TMLKAA,0,0,0,1,1,6
MLKAAG,0,0,0,1,1,6
VGVLLQ,0,0,0,1,1,6
GVLLQL,0,0,0,1,1,6
VLLQLL,0,0,0,1,1,6
LLQLLV,0,0,0,1,1,6
LQLLVQ,0,0,0,1,1,6
QLLVQA,0,0,0,1,1,6
VGYETA,0,0,0,1,1,6
GYETAA,0,0,0,1,1,6
YETAAK,0,0,0,1,1,6
ETAAKL,0,0,0,1,1,6
TAAKLA,0,0,0,1,1,6
AAKLAR,0,0,0,1,1,6
AKLARE,0,0,0,1,1,6
KLAREA,0,0,0,1,1,6
LAREAY,0,0,0,1,1,6
AREAYL,0,0,0,1,1,6
REAYLT,0,0,0,1,1,6
EAYLTG,0,0,0,1,1,6
VHVLAD,0,0,0,1,1,6
HVLADA,0,0,0,1,1,6
VLADAF,0,0,0,1,1,6
LADAFK,0,0,0,1,1,6
ADAFKR,0,0,0,1,1,6
DAFKRY,0,0,0,1,1,6
AFKRYL,0,0,0,1,1,6
FKRYLL,0,0,0,1,1,6
KRYLLD,0,0,0,1,1,6
VIDPLH,0,0,0,1,1,6
IDPLHT,0,0,0,1,1,6
DPLHTH,0,0,0,1,1,6
PLHTHL,0,0,0,1,1,6
LHTHLT,0,0,0,1,1,6
HTHLTR,0,0,0,1,1,6
THLTRL,0,0,0,1,1,6
HLTRLV,0,0,0,1,1,6
LTRLVA,0,0,0,1,1,6
TRLVAA,0,0,0,1,1,6
RLVAAY,0,0,0,1,1,6
LVAAYT,0,0,0,1,1,6
VAAYTG,0,0,0,1,1,6
VKYAVF,0,0,0,1,1,6
KYAVFE,0,0,0,1,1,6
YAVFEA,0,0,0,1,1,6
AVFEAA,0,0,0,1,1,6
VFEAAL,0,0,0,1,1,6
FEAALT,0,0,0,1,1,6
EAALTK,0,0,0,1,1,6
AALTKA,0,0,0,1,1,6
ALTKAI,0,0,0,1,1,6
LTKAIT,0,0,0,1,1,6
TKAITA,0,0,0,1,1,6
KAITAM,0,0,0,1,1,6
AITAMS,0,0,0,1,1,6
ITAMSE,0,0,0,1,1,6
TAMSEV,0,0,0,1,1,6
AMSEVQ,0,0,0,1,1,6
MSEVQK,0,0,0,1,1,6
SEVQKV,0,0,0,1,1,6
EVQKVS,0,0,0,1,1,6
VQKVSQ,0,0,0,1,1,6
VLSFKT,0,0,0,1,1,6
LSFKTG,0,0,0,1,1,6
SFKTGI,0,0,0,1,1,6
FKTGII,0,0,0,1,1,6
KTGIIS,0,0,0,1,1,6
TGIISL,0,0,0,1,1,6
VMELLT,0,0,0,1,1,6
MELLTK,0,0,0,1,1,6
ELLTKT,0,0,0,1,1,6
LLTKTL,0,0,0,1,1,6
LTKTLG,0,0,0,1,1,6
TKTLGW,0,0,0,1,1,6
KTLGWD,0,0,0,1,1,6
TLGWDI,0,0,0,1,1,6
LGWDIQ,0,0,0,1,1,6
GWDIQE,0,0,0,1,1,6
WDIQEE,0,0,0,1,1,6
DIQEEL,0,0,0,1,1,6
IQEELN,0,0,0,1,1,6
QEELNK,0,0,0,1,1,6
EELNKL,0,0,0,1,1,6
ELNKLT,0,0,0,1,1,6
VMGQNL,0,0,0,1,1,6
MGQNLI,0,0,0,1,1,6
GQNLIL,0,0,0,1,1,6
QNLILN,0,0,0,1,1,6
NLILNM,0,0,0,1,1,6
LILNMN,0,0,0,1,1,6
ILNMND,0,0,0,1,1,6
VMPSLL,0,0,0,1,1,6
MPSLLQ,0,0,0,1,1,6
PSLLQA,0,0,0,1,1,6
SLLQAF,0,0,0,1,1,6
LLQAFD,0,0,0,1,1,6
LQAFDL,0,0,0,1,1,6
QAFDLT,0,0,0,1,1,6
AFDLTA,0,0,0,1,1,6
VMQWVI,0,0,0,1,1,6
MQWVIR,0,0,0,1,1,6
QWVIRI,0,0,0,1,1,6
WVIRIL,0,0,0,1,1,6
VIRILG,0,0,0,1,1,6
IRILGG,0,0,0,1,1,6
RILGGG,0,0,0,1,1,6
ILGGGL,0,0,0,1,1,6
LGGGLQ,0,0,0,1,1,6
GGGLQK,0,0,0,1,1,6
GGLQKA,0,0,0,1,1,6
GLQKAL,0,0,0,1,1,6
VNFLVA,0,0,0,1,1,6
NFLVAD,0,0,0,1,1,6
FLVADA,0,0,0,1,1,6
LVADAL,0,0,0,1,1,6
VADALK,0,0,0,1,1,6
ADALKQ,0,0,0,1,1,6
DALKQH,0,0,0,1,1,6
ALKQHR,0,0,0,1,1,6
LKQHRH,0,0,0,1,1,6
KQHRHR,0,0,0,1,1,6
QHRHRR,0,0,0,1,1,6
HRHRRD,0,0,0,1,1,6
RHRRDD,0,0,0,1,1,6
HRRDDV,0,0,0,1,1,6
RRDDVI,0,0,0,1,1,6
RDDVIV,0,0,0,1,1,6
DDVIVM,0,0,0,1,1,6
DVIVML,0,0,0,1,1,6
VIVMLS,0,0,0,1,1,6
IVMLSA,0,0,0,1,1,6
VMLSAR,0,0,0,1,1,6
VNQFLD,0,0,0,1,1,6
NQFLDY,0,0,0,1,1,6
QFLDYL,0,0,0,1,1,6
FLDYLQ,0,0,0,1,1,6
LDYLQE,0,0,0,1,1,6
DYLQEF,0,0,0,1,1,6
YLQEFL,0,0,0,1,1,6
LQEFLG,0,0,0,1,1,6
QEFLGV,0,0,0,1,1,6
EFLGVM,0,0,0,1,1,6
FLGVMN,0,0,0,1,1,6
LGVMNT,0,0,0,1,1,6
VPMQRV,0,0,0,1,1,6
PMQRVL,0,0,0,1,1,6
MQRVLK,0,0,0,1,1,6
QRVLKY,0,0,0,1,1,6
RVLKYH,0,0,0,1,1,6
VLKYHL,0,0,0,1,1,6
LKYHLL,0,0,0,1,1,6
KYHLLL,0,0,0,1,1,6
YHLLLQ,0,0,0,1,1,6
HLLLQE,0,0,0,1,1,6
LLLQEL,0,0,0,1,1,6
LLQELV,0,0,0,1,1,6
LQELVK,0,0,0,1,1,6
VQEVNR,0,0,0,1,1,6
QEVNRF,0,0,0,1,1,6
EVNRFI,0,0,0,1,1,6
VNRFIK,0,0,0,1,1,6
NRFIKA,0,0,0,1,1,6
RFIKAF,0,0,0,1,1,6
FIKAFE,0,0,0,1,1,6
IKAFEE,0,0,0,1,1,6
KAFEEM,0,0,0,1,1,6
AFEEMK,0,0,0,1,1,6
FEEMKA,0,0,0,1,1,6
EEMKAL,0,0,0,1,1,6
EMKALM,0,0,0,1,1,6
MKALMK,0,0,0,1,1,6
KALMKS,0,0,0,1,1,6
ALMKSL,0,0,0,1,1,6
VSDARS,0,0,0,1,1,6
SDARSA,0,0,0,1,1,6
DARSAI,0,0,0,1,1,6
ARSAIT,0,0,0,1,1,6
RSAITS,0,0,0,1,1,6
SAITSA,0,0,0,1,1,6
AITSAQ,0,0,0,1,1,6
ITSAQE,0,0,0,1,1,6
TSAQEL,0,0,0,1,1,6
SAQELL,0,0,0,1,1,6
AQELLD,0,0,0,1,1,6
QELLDS,0,0,0,1,1,6
VWHYAL,0,0,0,1,1,6
WHYALW,0,0,0,1,1,6
HYALWS,0,0,0,1,1,6
YALWSL,0,0,0,1,1,6
ALWSLI,0,0,0,1,1,6
LWSLIQ,0,0,0,1,1,6
WSLIQQ,0,0,0,1,1,6
SLIQQS,0,0,0,1,1,6
LIQQSE,0,0,0,1,1,6
IQQSEI,0,0,0,1,1,6
QQSEIL,0,0,0,1,1,6
QSEILF,0,0,0,1,1,6
SEILFA,0,0,0,1,1,6
EILFAQ,0,0,0,1,1,6
VYGPFW,0,0,0,1,1,6
YGPFWK,0,0,0,1,1,6
GPFWKN,0,0,0,1,1,6
PFWKNW,0,0,0,1,1,6
FWKNWQ,0,0,0,1,1,6
WKNWQA,0,0,0,1,1,6
KNWQAQ,0,0,0,1,1,6
WATLLA,0,0,0,1,1,6
ATLLAQ,0,0,0,1,1,6
TLLAQW,0,0,0,1,1,6
LLAQWA,0,0,0,1,1,6
LAQWAD,0,0,0,1,1,6
AQWADR,0,0,0,1,1,6
QWADRA,0,0,0,1,1,6
WADRAL,0,0,0,1,1,6
WDDIRN,0,0,0,1,1,6
DDIRND,0,0,0,1,1,6
DIRNDL,0,0,0,1,1,6
IRNDLF,0,0,0,1,1,6
RNDLFR,0,0,0,1,1,6
NDLFRI,0,0,0,1,1,6
DLFRIQ,0,0,0,1,1,6
LFRIQN,0,0,0,1,1,6
FRIQND,0,0,0,1,1,6
RIQNDL,0,0,0,1,1,6
IQNDLF,0,0,0,1,1,6
QNDLFV,0,0,0,1,1,6
NDLFVL,0,0,0,1,1,6
DLFVLG,0,0,0,1,1,6
LFVLGE,0,0,0,1,1,6
FVLGED,0,0,0,1,1,6
VLGEDV,0,0,0,1,1,6
LGEDVS,0,0,0,1,1,6
GEDVST,0,0,0,1,1,6
YAKGAL,0,0,0,1,1,6
AKGALQ,0,0,0,1,1,6
KGALQY,0,0,0,1,1,6
GALQYL,0,0,0,1,1,6
ALQYLV,0,0,0,1,1,6
LQYLVP,0,0,0,1,1,6
QYLVPI,0,0,0,1,1,6
YLVPIL,0,0,0,1,1,6
LVPILT,0,0,0,1,1,6
VPILTQ,0,0,0,1,1,6
PILTQT,0,0,0,1,1,6
ILTQTL,0,0,0,1,1,6
LTQTLT,0,0,0,1,1,6
YDDIIE,0,0,0,1,1,6
DDIIEA,0,0,0,1,1,6
DIIEAA,0,0,0,1,1,6
IIEAAG,0,0,0,1,1,6
IEAAGE,0,0,0,1,1,6
EAAGEL,0,0,0,1,1,6
AAGELG,0,0,0,1,1,6
YDLLKD,0,0,0,1,1,6
DLLKDL,0,0,0,1,1,6
LLKDLE,0,0,0,1,1,6
LKDLEE,0,0,0,1,1,6
KDLEEG,0,0,0,1,1,6
DLEEGI,0,0,0,1,1,6
LEEGIQ,0,0,0,1,1,6
EEGIQT,0,0,0,1,1,6
EGIQTL,0,0,0,1,1,6
GIQTLM,0,0,0,1,1,6
IQTLMG,0,0,0,1,1,6
QTLMGR,0,0,0,1,1,6
TLMGRL,0,0,0,1,1,6
YEDKAV,0,0,0,1,1,6
EDKAVE,0,0,0,1,1,6
DKAVEL,0,0,0,1,1,6
KAVELY,0,0,0,1,1,6
AVELYS,0,0,0,1,1,6
VELYSR,0,0,0,1,1,6
ELYSRT,0,0,0,1,1,6
LYSRTA,0,0,0,1,1,6
YSRTAR,0,0,0,1,1,6
YETLEF,0,0,0,1,1,6
ETLEFL,0,0,0,1,1,6
TLEFLG,0,0,0,1,1,6
LEFLGD,0,0,0,1,1,6
EFLGDA,0,0,0,1,1,6
FLGDAL,0,0,0,1,1,6
LGDALV,0,0,0,1,1,6
GDALVN,0,0,0,1,1,6
DALVNF,0,0,0,1,1,6
ALVNFF,0,0,0,1,1,6
LVNFFI,0,0,0,1,1,6
VNFFIV,0,0,0,1,1,6
NFFIVD,0,0,0,1,1,6
FFIVDL,0,0,0,1,1,6
FIVDLL,0,0,0,1,1,6
IVDLLV,0,0,0,1,1,6
VDLLVQ,0,0,0,1,1,6
DLLVQY,0,0,0,1,1,6
LLVQYS,0,0,0,1,1,6
YFSKGI,0,0,0,1,1,6
FSKGIP,0,0,0,1,1,6
SKGIPN,0,0,0,1,1,6
KGIPNV,0,0,0,1,1,6
GIPNVL,0,0,0,1,1,6
IPNVLR,0,0,0,1,1,6
PNVLRR,0,0,0,1,1,6
YGSIGL,0,0,0,1,1,6
GSIGLT,0,0,0,1,1,6
SIGLTN,0,0,0,1,1,6
IGLTNF,0,0,0,1,1,6
GLTNFG,0,0,0,1,1,6
LTNFGY,0,0,0,1,1,6
TNFGYL,0,0,0,1,1,6
NFGYLD,0,0,0,1,1,6
FGYLDK,0,0,0,1,1,6
GYLDKE,0,0,0,1,1,6
YKEPLK,0,0,0,1,1,6
KEPLKA,0,0,0,1,1,6
EPLKAV,0,0,0,1,1,6
PLKAVV,0,0,0,1,1,6
LKAVVK,0,0,0,1,1,6
KAVVKK,0,0,0,1,1,6
AVVKKL,0,0,0,1,1,6
VVKKLL,0,0,0,1,1,6
VKKLLE,0,0,0,1,1,6
KKLLEK,0,0,0,1,1,6
KLLEKE,0,0,0,1,1,6
YKKFRQ,0,0,0,1,1,6
KKFRQL,0,0,0,1,1,6
KFRQLI,0,0,0,1,1,6
FRQLIQ,0,0,0,1,1,6
RQLIQV,0,0,0,1,1,6
QLIQVN,0,0,0,1,1,6
YLADLF,0,0,0,1,1,6
LADLFL,0,0,0,1,1,6
ADLFLA,0,0,0,1,1,6
DLFLAP,0,0,0,1,1,6
LFLAPQ,0,0,0,1,1,6
FLAPQI,0,0,0,1,1,6
LAPQIH,0,0,0,1,1,6
APQIHG,0,0,0,1,1,6
PQIHGA,0,0,0,1,1,6
QIHGAI,0,0,0,1,1,6
IHGAIN,0,0,0,1,1,6
HGAINR,0,0,0,1,1,6
GAINRF,0,0,0,1,1,6
AINRFQ,0,0,0,1,1,6
YLDKEV,0,0,0,1,1,6
LDKEVK,0,0,0,1,1,6
DKEVKL,0,0,0,1,1,6
KEVKLI,0,0,0,1,1,6
EVKLIK,0,0,0,1,1,6
VKLIKK,0,0,0,1,1,6
KLIKKM,0,0,0,1,1,6
LIKKMG,0,0,0,1,1,6
IKKMGN,0,0,0,1,1,6
KKMGNH,0,0,0,1,1,6
KMGNHL,0,0,0,1,1,6
MGNHLT,0,0,0,1,1,6
GNHLTN,0,0,0,1,1,6
NHLTNL,0,0,0,1,1,6
HLTNLR,0,0,0,1,1,6
LTNLRR,0,0,0,1,1,6
TNLRRV,0,0,0,1,1,6
NLRRVA,0,0,0,1,1,6
YLSESV,0,0,0,1,1,6
LSESVE,0,0,0,1,1,6
SESVET,0,0,0,1,1,6
ESVETI,0,0,0,1,1,6
SVETIK,0,0,0,1,1,6
VETIKK,0,0,0,1,1,6
ETIKKL,0,0,0,1,1,6
TIKKLG,0,0,0,1,1,6
IKKLGD,0,0,0,1,1,6
KKLGDH,0,0,0,1,1,6
KLGDHI,0,0,0,1,1,6
LGDHIT,0,0,0,1,1,6
GDHITS,0,0,0,1,1,6
DHITSL,0,0,0,1,1,6
HITSLK,0,0,0,1,1,6
ITSLKK,0,0,0,1,1,6
TSLKKL,0,0,0,1,1,6
SLKKLW,0,0,0,1,1,6
YPIVDA,0,0,0,1,1,6
PIVDAA,0,0,0,1,1,6
IVDAAM,0,0,0,1,1,6
VDAAMR,0,0,0,1,1,6
DAAMRQ,0,0,0,1,1,6
AAMRQL,0,0,0,1,1,6
AMRQLT,0,0,0,1,1,6
MRQLTE,0,0,0,1,1,6
RQLTET,0,0,0,1,1,6
QLTETG,0,0,0,1,1,6
YQNIVK,0,0,0,1,1,6
QNIVKA,0,0,0,1,1,6
NIVKAV,0,0,0,1,1,6
IVKAVQ,0,0,0,1,1,6
VKAVQY,0,0,0,1,1,6
KAVQYA,0,0,0,1,1,6
AVQYAA,0,0,0,1,1,6
VQYAAR,0,0,0,1,1,6
QYAARK,0,0,0,1,1,6
YAARKL,0,0,0,1,1,6
AARKLQ,0,0,0,1,1,6
YQQQKK,0,0,0,1,1,6
QQQKKY,0,0,0,1,1,6
QQKKYL,0,0,0,1,1,6
QKKYLG,0,0,0,1,1,6
KKYLGR,0,0,0,1,1,6
KYLGRM,0,0,0,1,1,6
YLGRMT,0,0,0,1,1,6
LGRMTE,0,0,0,1,1,6
